##-##-##-##-##-##-##-##-##-##-
------------------------------
------------------------------
##-##-##-##-##-##-##-##-##-##-
------------------------------
------------------------------
##-##-##-##-##-##-##-##-##-##-
------------------------------
------------------------------
##-##-##-##-##-##-##-##-##-##-
------------------------------
------------------------------
##-##-##-##-##-##-##-##-##-##-
------------------------------
------------------------------
##-##-##-##-##-##-##-##-##-##-
------------------------------
------------------------------
##-##-##-##-##-##-##-##-##-##-
------------------------------
------------------------------
##-##-##-##-##-##-##-##-##-##-
-----------------S------------
---E--------------------------
##-##-##-##-##-##-##-##-##-##-
------------------------------
------------------------------
##-##-##-##-##-##-##-##-##-##-
------------------------------
------------------------------