-##-#--###---#--#--#-#----#----#-----#---#--##-###-----###---####-#---
-##-#--#-##-------##-###-#####-----##-#-#--#-##--###--#---#-#######--#
-#--#---#--#-###----#-----#----##-##----#-##---##--#-#####----####----
#----#---#-#-#-##-#--##--####----#--##--##----##-##-#--#-------######-
#----##-###-------#--##--##---#--#-##-#----##---##--###-#---#-#--##---
--#####-#--#---------###----#--###-#-##---##--#-######-#--#---#---####
--##-----#--------#####-#-#-#-####----#-#---######-##--#----#--#-###--
#-#---##-#---#----------###-#---#-#####-#-#-###-#--#----##--##-##-#-##
-#-#-####------------#----#-#--#-#---#--#-#--#-#-#---#----#-#---#----#
#--##--#-#-##---#-#-#--#--###--###-##--#-###--#----##-#-##----#---#---
##-##----#-##--####-----#-##-#--##--#-##--#---#--#-#-#----#--###---#--
--------#--#--##-----####----##---##----#-###-#-##-#-#-#-----##--#---#
----#--#-##-##------###----##-#--#---#--------#--#-#-##-##--#----###--
--###-----#----#-##-#-###----#--###-##-#-##--#-----##-#---##-##-#--#-#
---##--#-#-###-####-#------##--##-------###-####--##--###--###-#-###-#
--#--#--####---#-#----##--#-----##-#--##-#-#--##----#####--##--#-#----
#----#-#-----#----#----##-####----#--#--####-#--#-#-#--#------#-###--#
#--------------##--#-#--##--#---###---####-####-#----#--#---##-#-#--#-
#----#--#-#-#---#-#----#-#---#-####-##-#---#-##---#-#---#-##----#-----
-####--####----#-##--#---------###-#------#-------#---#---#-#-###-#-#-
-#-------###--#-#--------##-#-----##-----##----###--#-#-##---##-#-#-##
#-##-----#--###---#-----##-#-##--#--####-##--#--#--####-#--##-####-##-
--------##-##--#----##--#-##----####-##--#####----###-#-----##-###----
--####------##----##-#-----##-#-#--##--#---##---------##-----#--##-###
#-##--#-#-##--#-#--#--####--#--#-#-#-#-#-###-#---#--###---#---#---##--
------#--##--#-#--#----#--#--#--#-#---##--#-#---##----#-----##-#-##-#-
-##-#-######----#--#-##-##-#----####------##-#-----##------#--##-#----
##--#----##---#----####---#--##-#-#-------#-#--#--#-----#---#-#-------
-###-#--#--##-#-----#-##-#---####------#---#-##-------###--#--#-####--
--#--#----#------#---#-------#-##--##-##-----#--#--#--##-#--#-----#-##
###-#--#-#-#---------#----#-#--#------#--##-#--###----#--#####-----#--
#------#-##-#---#--#---#-#-#####-#--###----#---#----###---##-#------#-
--#-#--###---#--####----##--#----#-----#-----###-#-##-##-#--#-###-##-#
#--##-##----#-#---#-#-#-##-##-##----#---#---#-#-------#-#--#--##-#-#--
---####-##-#######-#--#-#----#-#-#-###------#-###--##----##------#--##
-#--##-------#-#-#-###--###------#-##-#-----#--#------###-#--#--#-##--
----#-#-#-#-###----#---###--#-#-#-##-----#----#--#---------#---#--###-
-##--#-------###--##----#-----S####---###-#-#----###---#-#--#####-#--#
##---##-#-----##--------#--#-##---------##--#---#-----#--###--###----#
-###--#--#-----###-----##-#---##---##-----#--####-#---#-###-#---------
-##------#-#-##--#-##-##-#---#--------#-#------##-----#---##--##--#---
#---#########---##-------#-##-#---##---##---#-######-##---------#-##-#
-----#--#--------#-####-------##-#------#--#--#-#-------#-------#-----
-------#-----#---###-#---#-##-------###---#-#--#-##--#-#-####----##-##
##--#------###---##--#-#--###--#--#-####-----###---#---###-#---#----##
------#---#---##--#----#-#-----##---#------#--##-#--##----##---#------
---#-----#-#--#--#--#---#-##---#---##-#-####-###-#-#-####--####-##--#-
#-#-##--########--##-#-##--#----#----#---#-##-#---##--------#--#-####-
###--#------#-##-##--#-#-#---#-#-#-----###-#-#---#---#---###--#--#--##
---#----#----#----#---###---#-------#---###---#--#-#-----##-#----##-#-
----##-##E-##-#--#--##--###---#---#-##---###-----##-#---##---#-#----#-
--##--#-##-#-------#-#-#-----#--#--#----##-##---#--#-##--#-----#----##
-#--##-###----##--##-##----#--##-#-#--##-##---#-####------#----#-##---
####-#####--#--###-#-###---#---#-###-----##--###-###--#-##-##-###-----
-####-##--#--#---#------##-----#---###--#---#----#-#--#---####---####-
-##-#-####-#--##--##-#-#---#-#---#---#-##-##-#--#--#---#-#--#--##-----
-#-#--##-------#-#--####-###-#--#-##-#-##--#------#---##-#-----#--#--#
-##-###--#---##-###---#------##-##--#-------##--##-#-#-##--##--#-#-#-#
#-------#--#----##-##--#-##-###---#---#--#-#--###--#--#---#-#---#-#-#-
#--##-#-#-##----##-----#-----#----#-#--###-##--#--#--#--#-#---#--#-#--
-####------#-####--##-#--###---#----##--#----------#--###---#-#-##----
------#--#--#-#-####---#-#-##-##---#-##-##-#-#-##-#---#---####------##
-#------#--#-#--##--##-------##-----###---------#-##---##-#---#---#---
-----#-#--#--#-----#-#-------#-#-##-------###---#--##-###--#--#-####--
#-#-#---##--#-#---##-----#-#--#---#-#-#----#----##---#--##-#--##-#----
--##-##------#--#-#-#-##---#-#--#----###--#--##--##--#-#--##---#------
#####----#--#######-###---#####----#-#-##------##--###-#--#-#--####---
###--##---#--#-#-#---#-##-------##-----##---##--#---#---###--##---#-#-
-##-#-#-#-------#---#-###--###-#---#-#-#-#--##-----#--#-#---##--------
-##-----###-##-#-#--####-#---#--##-#---###-##--##--##-#--#--##-#---#-#