?diagonal=Always;
-#---#-##-#---#-----#-#-----#----#----#-----##---#-----#----#--#-#---#-#-#-##-###-###----------#--#-
--#-----------#-----#----#----#-#--#---#-#----------##------#---#--###-#----------##---#-----#-----#
-##-#-------#---##-----------#----#--#--#-##------#----#--#-###-----#-----#------------------#-#-#--
---------#--------------###---##--#--#-#----#-----##-----##-#-----#-------------#-#-------#----#-#-#
-#-#-----#-###-#--------#-#----------##-#---#-#----------##-#--#-#--#-#-#--####-#---#-------#-#--#--
------#--##-#---#--####------#--#---#----##-----#--##-#-#-#---#--#----#--------#-#---##---------##-#
-----#--#-##-----#-#-#-----#---##---#-----#-##-----#----#-##-#-------#--##---------#-----#--#------#
-#-#-#---#-#------##--#---------#-#-###-------#---#----#--##---##-#--#----------#--#-----#--#---##-#
-#--------#-#-####----#--#-#--#-#------###--#-#----#-##----#--###----###---#--###-#-#-#####-#---#---
---#--#--#-#--##---#---#----#####-#--------#----#---#-#---#------#---#-#--##--###---#-#----#-#------
-#--#-#---#---###--#---###----#-#--##-#-#--#------#--###--##-----------#----------##---##--#-#-#-#--
#-#-#--#--------#-----##-#--------#-#-#-##-------#-##----#------#------#-##--#-###--#-#--#--#---#---
---##--#-----#-#--##--#-#-----####---------------#--#--##--###--#--#--#---##--#---#-----------#----#
----#--####---##-#-##-#---------###---------#---------##--#-#-------------##-##--#-##---##--#-------
---------#--#-#--#-######-#-#---------#-----#--------##----------##----#-#---#----##-##-#--###---#--
---#---#-#-----#--##-#---#-------------###-#--#-#--##--#--#----#-#-------#--#--------#---#--##-----#
#--###-----###-#---#--##-#------##-----#-----#-#--#-#--#---#------#-##-----#--####-#---##-------####
-#--#---------###-#--#-#---#--##--##---#--------#-#-----#-----##---#----#---#---#--###--------##-###
#-#--#--#---------#-------#--#-------#---#-----------###-#--#---------#-##----#-#----####-#-----#---
---##--------#-#---#---##-------#--------#-----#---------##------#--------#---#-#----##-#-#--#-##---
--#---#-#---#------#--------#-----------#---#--#----#---#--------#-#----#----##------####---#--#-##-
-----#--##---#--#-#----------###---#-##---#----##-------##--#--###-#---#-------#-#-#-##--#--#-#-#---
#---#-#-#-#-###----#-#---#--#--###-------###-#---#--###-#--##-##-#---------##---------##--####--###-
-####-##----#----------#---#-----#-#--------------##-#-----####--#---##-#-#-----##---###-###-#----#-
-#-###-#----------###-#----##------#-##--#---------#-#-#-----##---#-#--#-#-------##-#--#---###--#---
-#--##-#----#-#----##--#----#----#---#----##---#--#---###-----##-##--##---#-##-#####-#--#--#-#-#-##-
##--#-##-----#####-#----###-----#---------##------#---#-#-#----#-----#-##-#------##-----#--------#-#
-#----#---#-###-#-------#-----#-----#-##----#-----------#-#----#-#---#--#---###----------#-----#--##
---#-----#----##--#----#-#--#---#-#-#---#----------##-#----###-##---##---##-#--##---S#------##-#---#
-#-------#-#-#-###-#-------#--#--####---#---###-##----------#------#---#-##-----#-#-----#----##-###-
----------#---------------#--##-#---#--#-##----###----#-#---##-#-----#-#------#--##---#---##--#---##
##---#----#----#-#--#----#-####-----##----#-##--#--#-###--##-##------#-#-------------##--##-#-------
--#------#--#---#-#-#-#---#--#-#-##--#---#----##-----#-#-###-#-#---------##--###----------#---##--##
#------#####-#-##-----#-------##-#----##----#---###----#---#--#---#---##-#-#-----#-#-------##----#-#
----###-----#-###---------##---##----#-#--#---#-#--#----##-##-----###---#-#-------#-----#--#-#----#-
-#---#-#-##--------#---#-----##---##--#-----------#--#-###-----#E---##-#--#--#-#------#--#-##------#
##-----###------------#---------####--#------------#--------#---##---------#---##---#-#-#---##--#--#
#-#---#--------#-#-#--#----------#----------##----##-#----------##-#-----------#---##-#--##-#-##--##
----###--#-##---##---#-#---------##---####---#------##----------#------#--#----##---##-#-----##-#---
--#----##------#-#-#------##---#-#--##--##--#------##---#--#--#---#--------###--#-#--------#-##-----
-----#----#####-####-##--#----#---#-----##-----#-------####------#---------##---------##---#---##--#
#-#-##---####---#----------------#-#---#-#----#--#---#-----------#--##-#-###--###----#-----#------##
---#-#-##------#---#--#-#--#--##--##--##--#--###--#-----###-#-#----#--###-#-##-##-#------##-------#-
###------------#-#------#####-#-##---#-------##----#--##----###-----#--#--#-#---#--##---##---#---#-#
-##-#--##----#-########----#--#--#--------##---#---#----#-#--#--#---###-#-----#-------##----#####--#
##-#--#--#-#--#---#---#--#-#--#-------------#------#-##--###--#--###--#---#---#-##--###---####---#--
-#--#----#--#--##--##---#-#--------#---#----#-#-----#-#----###------##-#-----#---#---#-##-----##---#
------#-#-------###------------#-----#--#----##-----#-##---#--##---###---#---#--#-----##---#----#--#
###------##-#--##-####---#--------#-##-----##---#---#----##-----#---#---#-----#----#----#-----#-#---
#-----------#-#-##--#--#---------#--##--#--#-#---------##-#---#---#--##-----#---#-##-----#-###-#--#-
#-#-----##----#----###--#--##---#--#-----#--------#-#####-----#-------##-----##-#--#----#-----------
-------#--#-#-##----###----######----#------------#-------------#--#---#-##---##-------#-#-#------#-
-##---#-##------#---#-#--#----##----####---##---#-----#-#--#-#---#-#-----#----####---#--#---#-----#-
---------------------------------------#----#----#-#----##-------#----#--#----##-#-#--#-------#-----
-#------##---##-#-#--##----------#--#--#####-#-##-###--------##-#-----------##--#-#-##-----##-#--#--
##-##--------#-----##------------##----###----#--#--#-##-----#--#-------#-##-------#--------#-----##
---#---###------#-----#---###-------##---#-#-#-#--#------#--------#-#--#--#--##---#----#-#--#-##----
#---#----------##--#-#----#-###-##------#--#--#-#--#-#----#---####--#-##-#-#---#---#-######---------
----------#-#----#-#---##---------#-------##-----#---#-##-----#---#--##---#-#---#--#--####-----##---
-----#-#----#--##-##----##--##--#####-------#-#--#----#-#-#--#--------------##--#--#---#--##-##-#---
--##-###---#-#--#----####---#####-#-----#-------#-#-----#--###--#------#-##---###-------------------
----#-#----#----#---#-#-#----------###------#-#-----#-#-#--#-#--#----###---#-------##------------#-#
---#-----##-----------#---##-#---#----------#--#-#--#-----------##-#------#---------#----#-#--#----#
----##-----#-#-#--------#----###-##----------#--#--#----#####--#------#-----###-----------#---#----#
---#-----####---#---##--#-------#---#---#-#-----------#------#-----#---------##---#--####-#--##-#--#
---##--#----###-#-#-----------#------#----#-----#--##---#--#--#---#-#--#-#-##-#-----------##--------
--#-#-#-#-#--#----#-##-#-------------#--##-#-##-#-#------#-#-##--#-##---------#-#-#--###-###--#-####
-#--#---#---#--#-#-###--------##----------------#-----#------#------#-#-----#-#-##--#--#--##--------
#-#-##-#-------#-------#-###----------#--##---#--##-#----##-###-##-##----#-#--####--#---#---#-----#-
--##-#------#--#-##-###-#----#--#--#-----#----#------#--####--#-##-#------##-#--#-#-##-##-----------
----#--#-#-##-----##-##---####----#-------#---#-#-#---#-#-#-------#-#-#----#--#####----------#--###-
#--#-#------------------##---##---#--#--##----#-------#--#------#--###----#-----#------#----#--#--#-
--#--#-------##---#---#-------#------#---#----------#-----------#--#---#---##--#----#-#------##-----
----##--#----#-#--#------#-----##-#-#--##-----#--#----#----#---#-----##----#-------#--#-#---#-#-#---
#-#--#----##-##-#--##-##--#---#--###--------#--#-#---#--#-#-##-##-##---#-----####-----#--------##---
#-#-##-----####--------#----#------------#--#-----#--------#--##--------#-------#-#-#####---#--#--##
-#-#-#-#-----#--#---#-##---##----#--###-----#----#-#---------#--#-----##---------#---###-----##-#-##
----#--#----##--#---###--#----#----#--#-----#---##-----#-------#--#----------#------##-##---#--#----
---#-#----#-------##-#----##-#--#-#--##-------#------#----#-#---------#--#-##-#--#--#---------#-----
#----#-###--#-##-----##-#---#-##-#-#--#-##---#---#------#-----#--##-##-###---#------#----##-----#--#
---###----###--#-----------#---#-----#--#--------#------##--#---#-#--#---#------##------#---#-------
#---------#-#-#--#------#---##---#-----#--##-#-#-##-##-#-----####-#----#-#----#--#----#--#---#----#-
-#------##----##-----------#------#--#--#----#-##--##-#####--###--##-#---#-##-#--#--#-##---#--------
---#---##--------------#----#---####-#-----#-----#----#--#---###-----#---#-#--#-------------#---#--#
##------#---##------#--###------#---#---#------###--#---#--------#####---##---###---#--#---#------##
#-----------#--#-------#---##--#------##-###-----#----##-#-##--#-####-----####--#-##-#----#---------
-##--##---#--##--#--#------#----#--------------#--#--##---##-##-#-------#-------#--#----#--#-###--##
##-#-#--##--------#-#-----------#--#--##-#-#---##--------###-#-###--######--#-##-##--#-##--###------
----#-#----#-----------##-----#--#-##--#---#---##-##-----#-#-----#--------#-######--###--#--####-##-
#-#-#-------###----#----##-##---#--#-#----#-----##----#----#-----#-#---#---#----##-##--#----#-#--##-
---###----#----##-#-----#-####------#-----#--#-##----##-----#--##--#-------#-----#------##---##---#-
----#-##-#----#--#-#----#-###-------#----------#-----#---###-----###--------------##---#---#---#---#
#------#-------#---#----------#---#---------#--###----######--##-#------#--##-###--#-#-##-------##--
-##-#------#------#----#----#--------#-------#----------##---#------###---#-#####---##------#-##----
----#-#-#-###-----#-#----####-##--##---##--####----------#---##---#-##--#---#--#-#-##-#------#--#---
--------#-#-----#--#----#--##--#-----#-#----#-#-###--#-#--#--#---#---##-#-#-###--#--#-#---#---#-#---
-###-##-----#----##--------#-------#--#------------#----#--##-------#----#----#-------#-------##-#--
#------------#----#------#--#---##-##-##---##-#--#----##--#-#-----#---------#-#-#------##------##---
#----##------#------#---#-#----##---#-#-#-#--#-#--#-----#--#-#-#--#---#--##-##-###-#----#--#-#-#-#-#
----#------#---------#-#--------###---#-##--------#--###--#------###---#-----------##--#--#-##-#----