?diagonal=Always;
----#--#---##-----#-----#--#------##-#-#------#--#---#-#--#----#-#------#-------#-------#--#-----#--
----#--#---#-----#--###---#-#----#--#-#----#-#----#----##-----#-#-----#-------#----##----------##---
----------#-#-------#-#----#---#----##------#---#-#-#----#--------#--#-#--#####--#---##---#----#--##
--#---#--#----#----#----#-------#-#-#--#------##---#-#--#-#-#-#--#----##-----#-------##------------#
--#-#-----#-----#------------###--#------##--#----#----#-#-#-------#-#-##---#-----#-##--#-#-#--#---#
---#-####--#--##-##---#-------##--#--------#----######--#-----#-#-#####--#------#-------#---##-#-#--
-##---#-#---###--###---#---#-#-#--#-------##-------#-#--##-##---#--#-##----##--#---#-##---#--#------
----------#-#-----#-----#-#-##------#---#---###---#-###-----#---#-----#-#-#-#---------#--#-#-------#
------#---------##----##----##--#----------#--------#-##---##-#-----###--#######-------#---#------#-
-#-------###---#-#-#-----#-----------#-#####--#-------#----#-#----###-##---#--#--#--#--#-#-------#--
-#-----###------------------#-###-----##-#-#----#-#----#--#-#-#-###--#------##--##-----##-#-------#-
---#----#--##-####--#--#--###-------###---##---#--####----##--#-------#---#-###---#-##-#----#----#--
-------##-#-----#------#-----#--##-####---------------#--###--#---##---#--#-#-----#------#--#--###-#
---#---##--#-#------#----#---###-----#--#-#----#####------##---------#-#------#--#---#--##--###-##--
--#-#--#---#####-#---##---###-----#----------#---------###--#---#--#---#--#-----#-------#---##-#-##-
-#-#-###--##-#--#-#-####---#--##----------#------###-----####---#-----#----#----#------####-#--#---#
-#-----#-#----#------#----#-#-#------#--#-#-#----#-##-----#-------#------###-------###------####--#-
---------------#--#-#--#--------#----#---##----##---------#-#--#----##----##--#--#-##-##--##--##-##-
--#-#-----#------#-###-#-#-###-#------------##----------###----#-#-#####---######-#-##---#-##-#--#--
---#--#-#----#-##---###----------#---##-#-#-#-#----#--#--#---#-----#--##--#-#-#--#-#--#---##-----#--
--####-------#----#-----##---#--#-#--------######-#------#-----------#-#-----#----------#--##-#--##-
-----##--#-##-##--#--##-#-###---###---#-###-#---##-------#-#-----------#---##--#--##----#------#---#
--------#-----#----#--#---#-#-#-------##---------#----#----#----------------#-#-------#----#-----#--
----#----#--#---#------#----#-#----#-##---##--##---##----##---###--##-##------#---#--#---#-###-#----
--#--#----#--------------##-------------#-##---------#-##-#----#-#-###-##-###-#-----#-----#---#---#-
--#----##---###----#--#----------#---#-#--#------##-#-----#-----#---##-#-####--##-#---------##----##
--#--##-#---#--------#-#-#-#---#-###--#----#-----#-------#-##---#--------#------#-#-#-----#-------#-
--#-#-#--#---------#-----------#-######-#--#----##---#-----#--#-#--#-----------------#--##-----##--#
-----#--#--#-#--#--#----##--#--#-#--####-###----#--#---#--##-#--###--#--#--#----##-#--#-#####-------
---#-#-#-#-#-#----#--#--#---------#--#-#---##----####----#---------##---#-#------#-#---#--#----#-###
##---#-##----#--##-##---#----##-----------#---###----#----------#-###--#-#-#---------#------##--##--
#------------#--##-#--##---#--#-###--#----##-##---#-##----#----#--#----###-#-------------#-#-----##-
---------#-###--#---#-#---#------#---#-##--###---####------###---###---------------#-##----#-----#-#
--#-##---##--#------#-#-#-#--#-##---##-#-#-#-##--#----------#----#-------#--#--#---#------#-#-------
----##--#---------##-----#-----#-#-----#----#-------#------###-------#-##--------##--#--------#-----
#-#-----#--#---------##----#-----------##-#---#-#--------#--#-##----###-----#-------##---#-#-#---#-#
####-----#--------#-##----------#-#-###-#--#-#-##----#-###-----#---------##--#--#--#-#----#-#---#---
##---#-###----#-#-#--##----#-----#----###-###--------#-#-#--#-#-----#----#-----##---#----#-#------#-
-#---##----#-##-----#-##---#---#-##----#--#---#-----##-#------#--------------##--#----#-------#--#--
-----#--#--##----#-##-#-#----#----#-###-##---#-----#-####-------#------#-##--------#-##--------###--
----#---#-#------#------##-#----#--###-####--#---####----####-----#-###------####-----#----#-##---#-
-##-------#----#-------#--#------#-----#----#-##-#----##--##-#--##--#------##-----#---------####----
---#----------#---##---#------#--###----#----#---#----------------#---#-----#---------#---##-###----
---####-##-#---#---##---#---#--##--#-------------#-------------#-----#--------------##---#-#------#-
#--##---#---#--##-----#---#-#----##--#--#-------#---------###----##----#-#--#-#-----#-------#--##--#
-------##----#-##---#--#--------#---#--#-#-#-#---#---#------##------#---#---#-##-#---##-#--#---##--#
-#---##-#----#-####----#-#-#-----#---#--#-#-##---#-#--##---------##--#-#----##-#-#-#-#-----#---##---
#-#--#---##-###-#-------##---#---#----#-####----#---#--##---#-####----##--------#--#-----##-#-##----
---##-------#--#--#--###---#--#---#-------#-##-#-#------#-------#-#----###--####-#-#--#--##---------
#-#-#---##-##--#-----#--#-----#####-#--------#----##--###--##----#-#-----###------#------#----#-----
#---#------#---##-----##--#---#----##-#-----##-----###-##--#----#------#---------#---#---##--#--#-##
------#-#---#-#-#--#-##--#-#--##----#--##-----##--#--#----#---###-##----##------#--#----#----#--###-
----#-#--##---#-------#---##---#---------#-------###-##--#---##--#----#------#------#---#-----#-#--#
-#-##-##------##-#-------------###---##-------#----#-#-#---##-#--##-----------#--#-#--#----#-------#
-#-#-------#----#-#--##-#------#--#--#-#-#---##---#-----#--#-#--###--#-##-#-#-#--##--#-##-#---##-##-
#---------#-##--#---#-###-#--#----##-#-###----#---#-#-----###-----#-#--#--#-----#--###-#----##---#--
----##--##--#-#----#-#-#---###--#----#----#-#--#-#-##-#--##---#-----###-#----------#--#--####---#---
-#--#----#---#-#------##---#---#----###--------------#--#------#-----##-----#-----#-###-----#-##--#-
---#----#--##--####--------------#-#-#-------##-##-#-#-#---##---#---#---#-#-##-#-#-#-#-##-#---#-----
#------#-------##-#---#----#---####--#-#--##----#-##-----#---#------#--#-#-#---#--#--#--#-------#-#-
-----------#----#---#--#-#-#---#---------##--#-#----##---#--#-#--#---##-----#----##----------##----#
#---#-------#----#---------------##--#-----#-----#------##-#---#-#---#-----##--#---#-#--##----#--##-
-#-#------#---#---###------------#-###------#--###-#-#-#-----#---###-###--#----------##----####--#--
---#--#-##----#-##-#---#--#------#-#-----##---#-#-#-#-#---###-------#-#---------#---------##-#####--
--###--#--#---#-#-#--##----#--------------#--###----#-------#---##--#-----#-#-#--#----##---#-------#
##-#----#---#-#--###---####--#-----#-----------##---#-------###--#----########--------##-------#----
---------#--#--#-----------#--###-----####-##-#-##---#-#-#----------####-#-#-#--#-##--#-#---#--##---
#------##--##---#-----------#-----#-#-#---#-#-----##-##--------#-#-#---##-##-#---#-#---#--#---#-#---
--#-----##----#-#---#----#-#----#----##-#---##-------#---##-------#---#-##----##-#--#-#----#---##-#-
--------#-----------#--------------#-------------#-#----#----#---#-##--#---#---#--------##--------#-
-#---###----#------#--#-#-#-####-#---#---###-#-------#--#----#--#---#--##-#-#----#-------#----##-#--
-#-----##-#-----#-#-####----#-###-##---#---#--#--#--#-------#--#-#--###---#---##---#---#-#------###-
-#---#--##-#----#-----#----#-#-#---------#-##--###-#---#----#---#---#--#--#------##---###-##---#----
-----#------#---#----##--#-#----#-------##-----#-#---###-#-------##-----#-#-------###---#-#-##-#---#
---#-----#-#-----#--#---####---##--##--###-----------#--##------###-#---#---------#-----##-----#-#--
--------#####-#-#-----#----#--#--#-#---#-#-#--##-#--#-##---------#-----#---#-#-#---#-##---#-###-----
--#-------###---#-#-####-#-#--#---#-##--------###-----#---#----###-----#---###-#---#-#----#--#--#-##
-##-###------------##-###-#-#-----#----#--##-#-----------#--#----#----#----------#----#-#-----#----#
--#-----#--##-##-###---#--#--#---##---#-----#---#----##-##-#----#--##--------#-##-----##--##-#-#-##-
#---#---------##-#-#----#-#-##--#-#-##-------#--#----------#-------#--------#-------#---##----------
#--#-###-##-#----###---------#-##----#-##----#--#-----------#-----#--#---#---#--#---#-####-#--#-----
----#----#--#---------------#---##--#---#-#-#---#---#----#----#------#--#-----#--##-----#-#--#--#--#
-##--#--##-##-#-------------#---##-#-#------#-------#-#--#--#-##--###-##------#-#------------------#
--#-##-###-#-----##-##--##---#----#---#-----#--#-------#-#-----#-#----###--------##---#----##-#-#---
##------#--#--#-------##----#--------#-#-----###-#---###-#---#-#--#--#-----##--##---##-#------------
###---#--------#----#---------#-###--##-##-------#---#--#--#-#---####-#-#--#-#--#-#-#-#--#---#----#-
--#---#-##--#--------#--------#--#------#------#----##-----------##-#-----#-----##-#---##---##-##---
-----------------#-----##-#-#-###---#------#-#-----##---#-#-----------------------#--------##---##--
-#-------#-#-#--#-----#-#---##-----------#---------###----#---#---#-#--#-##----#---#----S--#----#-##
---###---#-#----##-----#-##-----#-------#####---#----##--#---#----##--#------#---#------#####-----#-
----#--##--#-#-#-----###--#---#-#--##-----#-------#-###-##----#-------#--#------##---##-##------#---
-#-#---#-####--#---#-#----###---##E---#------#----#---#-##----------#--###----#---#--##---#-----##--
#---#----#-#-#-#--#--#--------#--#-##--------#-##---##-#----------#-#------#----#---##--#------##---
--#-#-##--#-----#------#------#-----#----##---##---------##---#---#-#------#-#-#--###----##----#---#
-#---###-#-##--##-#--#-####--#---#-------#-##-#---------###----##---#--#-#-#--####--#--------#-#-#--
---#-###-####--#----##-#---#-#-#-----#---##------#----#--------------#-#-##-##-###-##--------#---#--
-#-#-----#-----#--#-#-##---#---#-#-----#----#---##---#------#-###-#---###-##-#----##-#--##-----##---
#-##--##-##-----#---#--##---------#-#-##--#----###-#-#---#--###------------#-#-#---#-###-------#----
##------#---#------##-#------##--##-#------------#-#--#----#-#---#-------#----#---#-#------#--#--###
-----###-#-#---###-#----#-----------#----#--####----##---#-#------------#-#-----#---##-----#-#-#---#