?diagonal=Always;
--#-#-#---------####-#-----#--##-#-#####----#-#--##---#--#---#--##----#-----#-#-#-#-#-#-#---#-#--##-
--#--#-----###----#--------#-------##-##----#----#-#---#-#-----------###-#----#----#----#------#---#
#------#---#-#--##---------#-#--##---#-#--##-#-#----#-#-#---##-#---#-----#-------------#--#-##--##--
-#---#-----#-##-------##---------##-#-#-#-#-------#####---#-------#-#------#-#--#----###---#-#-#----
-#####-#-##---##--#--#--##--#-##-###-#-------#----#-#--------#-#-##--#---#-#-####--#----#-------##-#
--#---#--#-----#---#--#-#--#---#-------#-----#-##-----#---#-#-#----##-#-###-------#-----#-----###-#-
--#-#-------#--#------------#--#---#---#-#----#####-###----#-#-#--#------------#---#--##----#-----#-
-#-------#-##--#-----#-------#-#---#----##-------#-#------#--##-------#-----###---#--#--#---#---#-#-
-###---#---#-#--##------#---#--#----#-#-------#-#--------#--#---#-####-----------#-#-----#------#-#-
-----#---#--------##---------##--#-#--#-#--#----###--#-#-#----#--#--#----##--#---#------#--#-#------
----##--#----------#-------#---------#----#--------------##---#---#---#-###--#-##--#-#-#----#-----##
-#--#-#--###---##----##------#-#-----------#------###----#--#--##-#-##--#---#-----##------#---#--#--
-#---##-##---##--###--------#-----------#---#-#---#-#--#--#-----#----###---#----#---#-##------####-#
-#-#--######-##---##--#----##-#--#--------####-------##-------##--#--#----#-----#----#-----#----#-##
----#----#--------##--##--#---------##--#-------#-----#-------##---#-#-#-##---#----------##---#-##--
-#---#-----###-#--###--###---#-###-#-##--##-----#----#-#-#-#-####---------#-------#------#--###-----
-#---------#-##-###-#-#-##---####-----#---E-------#------#---#---##--#---#-#---#-#---#-#----#-##-#-#
####-##---#-------#-----#--##-----##--##---#-##-#--#---##---##-#--#-##----#-----#-#-------#---------
-#--#-----#--#-----##---##-#---##-##--#--#-#-----#------#--#----#--#----####------##---##-#--------#
-###-----#----#---##-------##--##----##--#-#-----##---------#------###-###---##------------##--#-###
#---#--#-#--#-#---##-------#--##--#-#---#--#-#------#------#------#--#---#---#---#-#-#---#####------
#---------#----------#-#-----#----##--#----#-###---##---------#--#------#####----##------#--#-------
#---#---#--#-#--#---##--#-#---#--###---------#---##-##---#-#---------##--###--#--#--#--####------#-#
--#-----##----#-#------#--#--#-#----##------#--##--------------------#---#----#-----#-##---#---#--#-
---#-#--------##---#-#----#--#-####--#-----#-#-#---#--#-###---#--##--#-#--#---###--S#####-##-##----#
------#-#-#--#-###-----#-------#----##--#----#--#--#-------#-----#----#-------###---#----#----------
--#-----#-###---#---#--#--#-#-###------#----##--##---##-----#---#-##-###----##--------#--#--###----#
##---#--#---#--#----#-----#------##-#----------#-#---------#----##--#-##-------##--#--#--#---#--#-##
-#---#-----#------##-##-#------------###---###-#-#######--#--##--#--#--##---------#---##-##-#--##---
----##--##--##---------#--#------#-#--#---##-##---#--#------#----##-##-#-##-------#--#--------#-##--
-####-##-##-#---#---#----#---#--#---------#------#------#------#--#-##---#--#---#-----###-#-#----#--
---#--#-###---#-----#-#---------#---###---#--#-#-##--------#------#----#-------#--###----#-----#---#
##-#-#-#---#-#-#--##--#---#-----#---#----#---#---##----###--------#-#-#-----#--##-#------##-##-#----
-#-----#-#--##--------##---#-----##--##-------------#-##-#---##-------##----#---##-#-#---------#--#-
#-#-#-#----#-#-#--##-##--##-------------------###-#--#----#--------#-#-##---###-----#--#----#-##----
-#-------##--------#-------##---#----------------#-----#-------#------#----#-----#--------#--#---#--
--#-##-----#-#####-##--------------###-#--##-###-------####------------#---####---------##----#-#-#-
-----#------#--##-#-#--#--#-------#-----#----##----##-#----###-----###-#---##---#--#-####----#------
--#-----#---------#---##--------#--##-##-#-##-##--#-##--#-----#--#-#-#-#----------####--------###---
-#-----###----##---#-#------#---#----------#---#----------------------##--#----##----#-------##--#--
#----------#--#---#-----#---#--------##--#----#--------###-###--#--#--------#--------------#---#-#-#
-#-#-#-##-----#-#----#-#-#----##---####----#---#-#--#--#-#--#-###--#--#--##--------#-##-#--##--#-#--
----##----#--------#--#-####------#--##-##--#-#-----##----#-##--#-#---#-#-#-#---#---##---##--##----#
---------##------#--#--##--#------##-#----###-##--#--#---#----#-------##---#-#-#-#--#####-###-------
#---#-#--#--##-#---#--##--#---##----#--##----#--#--------#-#-##--#---#--#-#--#--#-----#----#--#-----
#---#-----#-------#--######------#-######-#----------##--#--#-#-#------------#-##-----#-----#-#----#
#-#--#---#---####-#-----------#---------#--##--#-##--#--##---#----##-#----#---#------#-###-###-##-#-
-------#---##-#-#-#----#---#--#---#-##-###-----#---#---#--#-#---#-#-#-------###--#-------#----#-#-#-
-##------##----------###-##----#-#-#---##---#----##----#--#--#-##-#-###---#-#---#-----------------#-
--#--------#-----#--####---###--#-#--##--#--#--#-----#-----#--------#---#---#---#--#-#------##-#----
##---------#--#------##--###---##-----------------#------#---##------#-##--------#-#-#----#---#-#---
---------------#-##-#--#-#------#-#--###---##-------------##-#---#-#----#--####------------------###
#---------##----##-##--------##-------#---##-#--#-----#-#-##----#--#-#----#---------#-##-##-#--#-#--
--#--#-----#----------#-#--#----#--#-#--#--#-----#-#------------#------#---#---#--#-----#-------#---
---#--#--##--#-#-##--#--#---##---#--#----##-#--#----------#--------------#---#---#---##----##-##----
----#-#--###---------#-------------#-----###-----#--#-#----#------#-##-##--#----#------#---#--##-#-#
---##------##--#-#--##-#----###-#----#-#-----##-######-#---#-##---#---###---##--#---#-#-----------##
-##--#---#----#----##----##-#-------#-#-#--#----#---##-------------##---------#--###------#--##---##
-----##-##--#-##---#--#------#-------#----#-----###---#--------------#-#------##--#-----#-##-------#
##--#-#--#----#---##-#--#---#---###--------#-------#-----#--#-#-#-----#-#-#-------#-----#-#----##---
#--#--##--#-#---##---#---#----------#---#---------#--#--##-###--#####---#----#---#----#-#####--#----
--##----##--#-###-##---#--#-----##-----##--#--#--#----#-#-----#-#-----------#----#---------##-#-#--#
----#-#--#-#-#-#-#-#-#------------#--#-#---#---##-#--#--#--------##---------##--##-#--#####-#---###-
-----##---#------#------##----###-#-#-#--#---------#----#------#-----##------#---#-#----------###---
#---##-#-##------#---#----#-------#----##--#---#-#----#---#------#-#-#--#-#-#--#--###--#-#----###-#-
-------##-##--------#--#---------###--#-##---#--##-#-##--#----#--##-----##----#---#--##-------#-#--#
-##-------------#-----#-----#---###--------#-#---------#----#---###-#--#--####------#--##---##-#----
#---##-##---#-#--------#-#----#----#--------#----##-#-#--#--####-#-#-----##-#-#---#---#----#--##-##-
------###-------------#--#--#-------#---#-#---------##----#--#-----###----#--#-#------#-#--#-#-----#
-----##-----##---###--##-##-#-----##-#-#---------------##------#----------#------#-------###---##-#-
#-#--#-#-####---#-##----##---#-------#--#-##-----#---##---#---#----#------#---#---#--#---------##-##
#-#-#----#--##---#--#---#-----##-----#-------#--#--------###---#--------##--#--#--------#----#-##---
---------##------##--#--##--##----#-#-------##--#--#--##--#--------#----#-----##--#-#--#---#----##--
#-###------#---------##-------------#----#----#--#----#-#-----##--#--#---##---#-#--#--##----------#-
----#--#---#--#--------##--###--#-#----#--##---#---#-------#-----#--#-##-##----#-#---#-#----#-####--
----##-#-----------##-#---##-----##-#------#-#----#----#-----#------###---#------#----#---#----##-#-
#------#-######----##-###--#---#----######-----#-#--##-----##---#---#-------#-#-#-##---##---------#-
---------#-#-----##-----------------#-----#----#--##---###----#----#---#--##---#-#---#--#-#----#----
-#-#-#-#--#---#-#-#-#-#----#--##--------#-----###----#-###----#---#-#----#-#-#---##--###---#--#---#-
-----#---#-#----#--##--#-#------#--###--#--###----#----###-##----#----##------#-----##----#-##-##---
-#-#-##--##-###---------##--##----##----#--##---#--------#--#-#-###-----#---------#----#--------#---
#-#-#-#---##----#------###---------#-##------###--##------#--------#--#-#-#----#----#--##---#--#----
-#-#-----#------------------#----#-----------#---#---#-##------#------------#--------#--------#---#-
--##-#------#---##--##-####-----#-#-----#-#---#--#----##-#----##-----#-#------#--#----#-#-#-#-#---#-
#---#----#---#-#-----#---#----#-#--###--------#--#---#-#--#-#-#--#--#-#--##----###---##-#------###--
-####-----#--#-----#----##---#---###-###----#-#-#-----#--------##---------##----#-##-##----#------#-
##-------#-----#-##-#-#-#####-#-##-#-#---####-#-#-##---#--##--#---##-----#--#----##--#-#---#---#----
#-##---#-##----#---##------##-###-#-#--#-#-#-##--##-#-#-----------#--#---##-#-#-#-#-##-----#----#---
-#---##-----------#--#---#-#-#-#-------#---#-#-----#-#-#-#-----##--#---##----#----#------###-#-----#
##-###--#--#----##-#-----------#---##----#-------#---#--#--#------#-----#-##-#-#-#------#------#----
#-##----##------#--#----#-#-##---###-----#--#--#---------#--##-#--#----##-##-----##-----#----#-#--#-
-----##---#-------#--#---#-#--####--#-#-#---#-#---#---#-----#-----#--##-#----#-----------#--#-#----#
--------###--------#--#-----###-----------------------#---#-##-#--###---#-#-#--##--#-#####-------#-#
---##-##-#-#-----#--##---#--#-##--#-------#-------#----#---#---#-##-#---#---##-#-------#--##--#--##-
-----##--#--#-##--#---#--#----#---##-#-#--##--#----###--#-#---#-##------------#---#-##---#---#-----#
-#-#-#----------##------#------#--#-------#------#-##-#--#--#-##----#----#---#-#------#---####--##--
---#----#------#-##-###-##-#-------#-#-------##-####----#-#---#-------#----##---##--#-##-----###----
-#-##----##-----#-#---#-###--#----##--#---#-#--#--#-##-----#-#----###-----#-----##--#--###---#---#--
##----#-------##-#---#--#--#--####-#-##---##--##-###----#-#-#-#----#---#----##-#---##---#-#------#--
--------##----#-#-###----#--------###-----##---#---#----#-##-##-#--##--##-----#--#--#-##-#--##------