?diagonal=Always;
#------#----##----###-#----##-----#--#-----#-------#----------##-#----#-###----------#---------###-#
------------#--------#--------#----#--------------#---#-----------#------##-#---###--##-##---#-#----
----------#--##---#--###--#----####--#---##--#--###----#-#---#---#----##-----#---###--#---#---###---
-------#-###---#---#----#----#------#-----#--#-#-#---##---#-##-------#---##--##-#--##-----#-#--##--#
###--#-#-------#-#-##----##-------#-###-----#-----#--#-----#-##-------#----#----#---#-##--#----#----
--###-#-#----#----##-#-###-#-###-##--------#-#---#-###--#-#-##--#-#---#--#-##-#---#---###---##-#----
-----##-#-###---------------##-#--#-------##-#---#-----#-#-#--#----#--#-#--#--#----#-#-####--#------
----#---------##--------####-##-##-##-##-#--#-----#----#-#--#--#----#-----------##------#----#-##-##
-#-###-#-------##---#--#-#-------##-#--###---#--####-----##-#-#-##--###--#-#----#--#-----###---#--#-
-#----#-#---#-#-----#---###--#-#---#------------#--#-------##-----------#------#------#-#------#--##
-##---#--##---------------#---###-#---#--####-----#-#-#-#----##---#--#--#--#--#----####-------###---
----#-#-#-#--#--------------#-------#-###-----#-#-#----#---#-##-#---#--#-##--#-------#----#----#----
--#----#--###-#--------#----##-#-#---#-###----####---##-#--##-#--#-#--##-#-##--##------##---###-###-
#---------#-----------#----#-#----#----#---#-----#---###-#-------##--#--##---#--##----------#-------
------##----#---##--#-###--##--##--#-------------#----------#--#-------##-----#-----------#-#-------
-##-#------#------#--#-----#-#----------#----#--#-##-#####--#-------####---##----#---###---##-------
#-#--#-#--#--#---#-#---#--#---#---##--##-----#---#---#----#-###--------#---#-##---##--#---#-##-----#
-#---###--#----#-----#-#-###-----#----###--####--#-#-#-----#-#-----#--#-----#---#--------#--#-------
----#---#------#------#--#-----#---##----###-#-##-#-###---##---##----#---##---#---#-##-#-##-###-#--#
-#-----##--##-##--------#--------##-----------#-#-##---#------#-##--#--#-------#-----##----###-#----
-#----#-##---------#------#---#-#--##---#-#--###----------##-#-#-----#-#-###--#-----#---#--#-#-##---
----#-#-#------#-#----------#--##-----#---#------#----##----#----#--##---#-----#-#-##---#------#-##-
---#--###---#----##----#---##--##-#-------##-#-----##-------#--#---##----##-#-###---#-#----#####-#--
##--#-#-#------#---#----#----#---#--###-#--------#------#--#-----###----##-#-##----#---------#-#-##-
#-#---#-#----##---#--##-#---##----------#-#--#-#-----#----#-##-##--#----#-#-#---##---##------#---##-
#----------#--##-#-----#-#-#-#-##-##----#-##-#-----#-##----#----#-##-##--##-#-----#-#----------#---#
----------#--#--##-#-#--##---#--#-------#------#--#-#-##-----#---------#-------#--#---------##---#-#
---#--#-##--##---------#--------#----###-##---#-#--------#--#---######-#---##-#--------###--#-------
#-#-#--#--#----##-----##--------#-#-------------#-#--#-#-----##-####-#-------###-#-#######-#-#-#----
--#---##--##---#--#----##---#---##-----##-#----###------####-----#-#-##---##-#---##--#----#-#----#--
#-##---#-----------#-###-------#-#-#---#-----#------###---#----##-----#----#------#--#---#--#-#-----
#-----#-----#---#--#--##-#-----##-----###---------#--##-#----#--##-#-------##---##-----#--#-#-#--#-#
--#--#--#--#-##-#--##-#--#--#-#---#---##---#----#---##-#-----------#------#-------#---##--#-#--#---#
#--#----######--#-#---###------###--#--#---#-##----#-##---##--#--#--####--#-#-##-##-#--#----#-#-----
###---#-###--#-#-----##-#--###-----#--#--#----#-###----#---##-#-#---#-###-#-----#--##--##-#-##-----#
#---#----#------#---##--##--#----##----#---#-#----#-----------##--#----#---------##-#-##-----#--#-##
---#----##---#-#----###--#--####---#-#-----#--#--#---#--------#-------#--#------#----###--##---#----
----#-#-#----#-##--#----#---#-----###-###--------##---#-##---#-#-----###---#-##--#-#---###-#--#-----
----#--#-#--##-#---#--#---------#---#----#-##---#--#--#-------------#--#---#--#-#--##--#-#----##----
---##---------------#-#---#-#--#---------#-#--------##----###---#-#-##--#-----#-----#-----#-#-#-----
#----###-#----#-----#--#-#-------#--#-#------##-#--##-#-#--#-#-##--##-#--####--#----#-#---#---#-#---
#---###----#-##----#---#--#----#------###-#-#--#--#---#---#------#--#-##---#--##--#------#-#-##--#--
#--#--#---#--#----#---#--#--#--------#--##------##-######--#------###----#---#--#---##--#--##--##--#
------##-#-----#-----#------#--#---#--#-##--------#--#----#---#-#--#-#-------##----###---#---##---#-
---#------###--#----###--#--##------#-####-#-----------#---------##--------#-##--#----#-##--#---##--
-----#-#---##-#--#---#-#-##---#----##-----------##-#-------#---##-#-------#-#------##--#--#-#--##--#
---#----#--#---##-----#-#--#-#---#------#-------#-##----###-#-#--#-------#----##------##----##------
#--------------------#---#---#-#-----------###----#-#-#--#---#---#-##---------#-#-------#-#----###-#
--#-#-#------##--##---####-#---#-##-##-----#------#-------#---#--#-#-###-##-#####-#-##----##---#----
-###--#----#---#-###----##----#--#---#-#----###--#-#-#-----##-#---#---------#--##---------#-#-------
#S-----#---##----------#-----#---###-#---##--#-##--##--#-#--------#-###-#--#---#-##-----##-------#-#
----#--#--#--##---###------#---#--#-###--#-#--#--##-#---#--##-#-#-##----#-#-------#-#-----#-#-#----#
#--------#------#---###-#-#------#-#--##--------#--#-###-#------#----#------#-##-##------------###--
#-------#-------#-#------#---###---#----#--#--#--##--##-#-----#--#-##-----#-----#---#-------##------
--###--##-------#----#-#-#--##-----------##--#----##---##----------#---#-#-#-#-#-#-#-#-##-##------##
-##----#---##---#-###-#---##--#---------#------#---#-------##-#-----------#-#----------##--#-#-#---#
#---#------#--------#-##---#-#-----##-------------#-----###---##-#####--#----#-#--#-#--#-##---##---#
----#--##--------#-#--#---#---##-#---#-------#-#-#-----#--#-#--#--#--#--##-----#------#----#----#---
#----#-#-#---#--------#--##--#---#--#-------#--#-#---#---#-#--#-####--#-#----##---####-##-#---###--#
--#-#--#---#------#---#----#----##-#-##-#----#-----------##-----###-##----------#--#-#-#-#--#--##---
--#-#----#-----#-#----##--#---#-------#-##--#-#-------#------#---#-------#----#-----#----###-##-###-
-#--#---#---#-#---#--#---#------#---#------#-----##-###------##---#---##---#--------#--###-#-----#--
--#-----#--##-----#-#-#------------#---#------#---##---#-#--##---#-#-####-##-----#---#---#----##----
-#-#-##------#-#--#-#---#-----##--------#---####--#----###--#-#-####------#------#---#-----#-----#-#
--#------##---#----------##--##-#---#-------###-#---#--#-#-#----##----###-#-###E---#--------#-----##
-----#--##----#---#----##-----------#--#-#--#-----#-----------##-#--#--##-##-#---##------#--###-#--#
--#-------#-----##-#-####------#------------##--##---#-#---------------#--#-----------#--#-#-----#--
-----#-------#--#---#---#-#-------#-#----#------###--#----------##-#---------##-#---#----#-#---##---
------##---#--##----#------##--#-###-----####--------###-------#-#----##--#-------##----#--#-#------
-#-----#-#-----#-#-#-#-##-##-#--------##---#----#-#----------#--#----##---#-----##-#-#--#---#-------
-#------###----#-####---------#-----#-#-##-#-----#----------##----#--####--#-#-----#-#-#----##----#-
-------#-#-#--#-#-------#---##--##-#-#---##-----#-----##-#---#-####-----#-------#--##---#-#--##--#--
-####--#-#----#-#----###---#-##-####---#-------#--#----#--##----#-#--#---#--#-------##--##-##----#--
#----#----#------##-#-#-------##--#------#-##-------#-#-##--#----###-###-#-#--------#---#------##---
--#---##--#---####---####-#---##-------#--##-#-------###----##--##-------##---###-----##---##-#-##--
--##-----------#--#-##---#--#----##---#---------#------##---#--##--#-#--##-----#------##------#-##--
#---##---##--#--###-----------##--#-----#------#---#-##--------##--#----#--------------#-#---------#
#----#-#---#------------#-##---#-#--#---------------#--#--------#----#-----##------##---#--#-##-----
#-#----#----#--####---#--##-------#-#--###-#-#----###-----#----------#--#-----------##----#---#-#---
#--####----#--##--#----#-------###--------#----#-------##--#--#--#-------#-----------------#-----#--
---#-------#-#-----#----#-#-----------##--#-##-##-------------#-----------#-#----##-#-#------#------
#--#--##--#-----#----##-#--##----#-#-#-##----#--#---##-#-#----#--#---####-#----#-#----#------#------
--###-#-#---#-----------####-#-##---#----#----#----------##-----#-#-#------#-#---##-#-#---------#---
--------#-----#------##---#-----#----#------##-#-----#----###------#-#---#-#-#-----##-#-----##--##--
-#------##----#-------#--#-----#-####------#--#--#-------#-#---##-##--#-##---#---#---#--##-#--#-#---
##---#-----------#--##---###-----#--#-----#-----##-------#-#-----##-##--------#-##-#--#--#--#----#-#
#---##---#--#--#-#----##---#---##-###-#--#-----##-----##-#----###---#-#--#---------#--#-##----###---
---##-#-#-##----##-#--#----#-#--##------#--------##--##-#----#--#--------#--##---#-#----#-#---------
##-##-----#####--#---#---##------#--###-#------------------###-#-------#--------#--#-------#--#-----
##--##--------##-##--##---##-##----#---#-#-----#-#---#--#--##------##--##--#--#-----#-#---------#---
#-#-###------------#---#------#-##--#-#----#----------#-###------------###---#---#-#-------#---###--
---#---#----##-------#--------#--##-------#---------##--#-----#---#-------#---#---#---###-----#-#---
------#----#--#-----###------#---#----#-##-#---#-------#--##--#--##--###-----###-#----#-------#---#-
-----##---#-#----#-----###-#-----###-#--##----##---#---####------####-#----#--#-#---------#-#--#-#--
--#--#------##---#-----#---#-#---#--#-#-#-#-----------#-##---###-----#---------##-#-#---##-###--##--
--------##-#---------#---#-#----#----#---------#----#---#----###------##--#-#-##--#---##-------#-#-#
---#--##------------------#-#---#-#--#-##-#--#-##-#---#-#-##---###------#-#-#-##-#---##-------------
#-----#----##-##--#----#----#-#-------#-------#---#----#---#---##----#-#----#-#--#-----#--------#---
####--#-##-----###-----#----#-#--###---#---#----#------#-##---#--#--##-#-----#-#----#--#--####----#-
---##-#--#---#--#-----###-#-----#-###--------------#--#-----#-----------#-#-##-#-##---#---------#--#