?diagonal=Always;
--#-------------#-------##-------#-----#-##-#--##------------------#---#----------#--##--#-###---#--
------#-----#--------##--------------------##--#--#-#---####--#------##-----#-#--#-----#---##----###
---------###-#--#-#-------#----#----##-#--#------#--#----#-#------#--##-----------------####-####-#-
--##----#--------##-#-#----##---##---------#---#---#---##-#---#--#----#-------####--#--------#--###-
-#-#----------#----#-#----#--#-#----#--#------#-##----#####---##-----##-------##--###------##----#-#
#----------####--#--##--##---#--##-----------#-##-------#-#--##---##------#---#-####-#----###---#---
###--#------#------#--#---#-#--##--#------------#--#----##-#---###------##------#---#---#--##-##----
-##---##--##----###----#-#--##-#--#--###---#---#---#-#-##---#-#-#--#-----###---#---##--####---------
#-#-##-#--------#--#------------#----##--####--##---#---##-#-#-#-------#----##--##-------#-##-#--#-#
-#-#--#------#--####---#-#--------#---##--##--------##--####--##-----#-#-------#--#--#-#--#####-#-#-
##---##---#-----#-#-------#----#----------------------#----#------------#-#----#--#---#----#-####---
--#--------#----#--##-#--##-#-#-#-###----#---#---------#---------###----#--##---------#------###-#--
##---####------#----#-####------#---#--####------###---####--#-#-#-----#---##----#----##---##--##-#-
-#---#----##-----##---##-#--#-------#------#----#--------#-#----##-#-#--#------#-#------###---#---#-
#-#----###-----###----##----#--##-----#------##---#----------##-------##-#-----#--#--#----#---#-----
#--##-#---##----##-----#-#-------#--#-#------#--#---##----#--####----#-##--###-----#-##----#--------
--###---#-#--#-#---#-####-#------#----#-------#---#-#-#--##-##--#---##---###-#-----####----###-###--
-----#-#-------#-#---------#----#----####--####--##--#---#---#---##-----#------------#-----------#--
--#-#----#----##-#------#---#-----#####-##-#-#-##--##--#--#--###--#----#--##-----#----##--##-#----#-
------##-#----#-#------#--#-#---#-#---#--#--#--------###-#-----#---#-#-------#------##-#--#--#--#--#
--#-----------#------##--#-##--##---------###-#------##-#---#----#--#--##----#-#--##---#----##----#-
-##-#---#---##--#--------#-##---------------#-####-----------###---#-#-----#----#-----###-#-----#---
-#----#####---------#--#-#-###---#----##-##-#-#--#--##-------#-----####----###-##-----------##----##
#-#--##-###-------##---#--#-#--#-#-#--#------------#--##-#--#-#-#-#----#####-#------#-#-##-####-----
#------#--#-#---#---#-##---#-#--#-##-#---#-#----####----#----#---------#--#--#-#--------#---##---#--
-----##-#----##-#-#-#------#------##-----------#------###--------###-#----#--#-###---#-##----#-#-#--
#-#-----###------#---##-----##-----#--##-###----#-#-#------##-#---#---#-------#-#---##--##-----#--#-
--------#--#---##--##--------#-##-#-#----##------#--#----------#--#--##-#---##-----#-----##--------#
#-------#---------#-------#-#-----##-#------####-#-##-#--------##-----#---##--------#----#--###-#---
#-##----#-##----##--##--#------#---#-#----#-#--####--------#---#-#--#---#----#------#---##--#--#----
-------##--------#-##-#----#----------------#----##--#--#--#-##-#---##----#-#-----##-#--------------
-#--#----------#----###------------#---##----------#-#-##--------##--###----#--#--------#------#---#
##----#-----#-#---#---------#---#-#---------#-#--#-------#--#-##----------#------#----####--##-#---#
---#-----##---#--##--#------#----##-#-------#-------#-#--#------##--#--------#-------##---##--#-##--
-----#-#-#-------#-------#-#------#------#------##-##-----------###---------#-#-------##------#-----
#S#--#----#--#----#-#----##-####--###---##--#------#-#------#----###---#--#--#------------------#-#-
#------#----#--##-#------------##---------------#---#-##-#---#-##----#--#---##--###-###-#-##----##--
--##------#--##-----#---##-#----------------##--#----#----------#--#----#--#----#--#-#--#--#--#-#---
#----##-#-#-----###-#-#-#####-#--------#-------------#-------#------#---#-------#-#--##-##--#---#---
-#-##-----#---------##---#--#---###-#---#----------#-###----#-#--##--#-#--#--###----##---#-##-------
-#---#---#--##--###-----#--###----#--##--#-#-----##--###--#--##------#-----------#-#-#---------#---#
-------#-#---###-#-#-##--#---#--#------#-----------#-----#---####----#------#--#-##---#---#-----##--
-#---------#-##-#-#-#---#----#-###-##-#----#--####--#---#----#-----#----#--------#-----------#--#-#-
-#-##-#-#--##-#--#-###--#----#---#-#-----------##---#-------##--###--#-#--#-#-#---##--##--##--#----#
---##--#---###------#--#-#--#-#--#--------#------#-#----#---------#-#-#---#--#-#-##--#-####-#--#--#-
-##--#-----#-#----##----------------#----#--#--#----#--#-----#---#-#-#-##-------#--#-------------#--
-----------#---#-###-#-#--------##---#-######-----#-#---##---#---#--------------#----#--#--#-#-#---#
----##---#-#---#---#-#----#---######--#-----#---##--###---##---#--#-#---#-#--#---#----##----#-###-##
---#--#----##-###--##-#-#--#----#--#------#---#-#-#--##-#-#--#----##-#-#---###-------------#-###---#
---#-----#-#--#------###-------#--#------###------#-----#--#----##-#----#----#-------#--#-#-#-#-##--
--#---##-#-##-#---##--#-##--------------#--##--#--#-##--#------#-#----###-------#-#------#---#--#--#
--#--#####------------#-#-------------###-------###-#-#------#-#---------#---####--#--##-#-----#----
--------#-----#-#---#-#---#--------#####-----##--#-#-###-#--#-##-#-----##-#----##---##---###-----#--
#-##-#--#---#-#-----------#-----#-##---###-----#-----#-##-#-#-----##--#---#-----#--#--#---#---##----
#---##------------#----#---#---#---##-##-#----#-------#-------##---------###---##---####-----#-#-#--
---#---------#---#--#-----######----#--##-------#-#--#-----#----##--#--#-----#-----------##--#-#----
#------#--#---------#-#-#---------##-#----#------#-##-#-#-#--###---------------##----###-#-#-#--##--
---#--------------#---###---#-#-#####--##---#-#--#--##--#----##--#-#----#-###----#----#--#-#-##---#-
--#--###-##-##-#-##-##---#--#----#-#-##--#----#-#-##--#--#----#-#-----#---##---##--------#----#----#
##---E#----#---#--------------#------###-----#--#-#-------#--#-#-###---------#-#---------##------#--
#----#--#--##--#-----#-----#-----#--------##---##--#---#--#--###--#-----##--#-------#---###--##--#--
---#--##--#-#-###----#-##-------#-##-#--#------#--#----#----#-#-----#--#-------#####-----#-------#-#
#-#-##--#---##-------##--#-#----#-##--#--------#--#------#----#-#--#--#--#---##--#--###--#---#------
------##-----##-----##--##---#----###-##-#-------#---###--#----#-##-#-#-----##---#----#---##-##-----
-----####---#----#--#-#----#--##----------------#----#------#---##-----#--#----#-##----#-#-------#--
--------------####--##-#--------##--#-##---#-#-----#-#--#----#-#---------#--#-#--#-----------#---#--
--#--#-----#-#-----------##----#---#-#--##-------#-------#-#---#---#----###------#--#--#-------#-#-#
----##---##--------#--#--#----#--------------###---#---##-#--###----#-----##--------##-##----#-##---
---####--#------#---#-##-###-#--#--###-#------#--#--#-#--####---#--#--#-#-------#-##----#-----#-##-#
-----#--------#-------#-----#-#--#--##-##-##--##--------#--##--#--#----#--------------##--#----#----
##--#---###-----#--##--#-#-###-#----------------#---------#-#------#---------#---##-#--##---#---#--#
----------------###---#----------#-----##--#------------#-#--#--###-#-#--##-#--#-#---------#----##--
-#-#-##-#-#---#---#-#--###-------#-#-----#-#-#-#-#---#--#--#----#-------#---##--##---#-----##--#----
--#-------###----#-------#-#-----#-##-##--#-----##-#-------#----#--##---#-#-##---#---##----#---#---#
-------#---#----###-##----#---#----###---#-#-#----####----#-###----#-###-#-#--------##----#-#-------
-##----##-#------------#---#----##--##-#-##-##--#--###--------------#--#####--#--#-#----##---#----#-
-##-##--##--#------###---#--#---#---#--#------------#------#-#----#--------###--------#-#-----------
#--#----###---#-#-#####---#-#####----#---##---#--###-#--##--#---#-###----#-#---------#-#---#----#---
#--#-----#----#--#---##--###---#-#----#--##-##-------#----##--#---######---##------#---#--###-#-----
#--#--#----------#----#-------##-----#-----#--###----#--##-#----#-#-#--#-#--------#--#-#-########-#-
---#-##---#-#--##--#-#-----##--#-####-#----#-#--##-#-###----##---#---#-##-#-###--##--------#--#-----
-#--#--#--#-----#-##-#--#-#----#----#--#---#-##---##-#--##-#-#---#----#------#-#-------#-##-##-#--#-
-##--#--#------####----------#----#---------##--#-#--#----#-----#-----#--##--#--#-#-#-#-#--#---#----
-#----##---#----###---#--#-#-------------#-##---##-###------#------#-----#-#---#-#-------##---#-#-#-
------------#---###--##--#--#-#--#-##--#---#--#-----##-----#-#--#-----#-------##----#---#------#--#-
#--#---##---------#----------#----------------#-#----##-#--#----##-#--------#-#-#-#--##--#----#-----
#-#-##-#--#------##----##-#-----#---##--####-#-------##---#-----##-#---#--##-##-------#---#--#------
#--####--#---##-####-#----##--#-##-##-##------#-#-#-#----#-#---##---#--#-#---#-#--#---------#-##-##-
----------#-#-----#-#-#-----#--#---#-----#-#-#-----#--------##-------#-----------#-#--###-#-##-----#
##-###-#---####-----#--#--#-#--------##-------##--##----#-#--#-#-#-----#--#-------#-----##---#---#-#
--#--#----##------##--#-------#-###----#--#---#-----##-----#-#------#---##-----#-----##------##---#-
##-####-#------##-#--#----#--#-#--#-#-#-##-#---#-###---##-------##-----#--##---###-#--##--###-----#-
----------#-------#--###---#-###-----#-#--#-#--#--------#--#---#-----#-##-#------#-----##-#-#--#--#-
------#--------##-#----#--##-##-#---#-----#--#-#--#-----#-###---#-####--#---------#--##--------##---
#----#---------##-#----#-----##-##-------##--#----------###--------#-#--------#--##-#--#-#---#-##---
##-##-#-----#---#------##--#------##----##---------#----#--#-#---#------------------#----#------#---
----#-#-#-##--#----##-----#--#-##-##-#-#-#-#-#-----#--###---#-----##------#-#----#----#--#-#-----#-#
#---###-#-#-##---#-#----#-##--######-#--##--#-----####-------#----###----#--#--#--##----##-#--##-#-#
#--#---#---#-----#-##--#----#-##-----------#-##---#-#---#-----#---#---#-#--#----#-------#-----#-----
#---#--#--#--##--#---------#-##----------####---#-----#-#---------#-----#---##-#-#----#-#---#--#---#