?diagonal=Always;
--------#-#----#----------#-#-#-#-#---#-----#-----#---#-#-#--#-###-#---#-------#-------#-----#----##
###---##--------##-#--#-##----#---------------#-#-----#-####----##----#--#--#---#--#----##--###---#-
#-####-----##-#-#-#--#--###-##---##------#-#------#----#-------##------####-----#-#--#----#-#---#--#
#------##--------###-#---#----#-#-------------#--#-----#--#--#-#-##--------#-#----##--#----#--------
#-###--##-#-------####----#--#-##---#---#-------#-----##-###----#-#-------#------#-#-##---#---------
-#--##---#--##--#------#--##-----#-#-#-#-#-##---------###---#------##--##----------#-#-#--###------#
---#-####--------#----#---#---#-#-#----#--#----#----------------##--------##-----#-#----##-###----#-
---#--##----###---#-#------#--##--#------#---###--##------#-#-##---#-------#-#--##-#----#---#----#--
--#-#-#------##-----#-##----##-----##---#---#----#-#---#-----------#-##-##----#-###---------------#-
-##-##--#-#--------#----#--###-----#--#--------#---------#------#--------#----#---##-----#-#--#-#---
###---#-##--##-#--#-#----#-##-#-------#--#-#-#-#--#------#----#-#----#-#----------#-##--#-#--##-----
---#-#-##-----#--##---------#---#--#-----#-#----#-----##---#-#---#----##----#-----#--#--------#--##-
----#--#------#----#-#-##-#-----##-------##--#----##-##--#----------##-#-------#-----------#--#-#---
#--#-----####--###----#-#-#-#--####--#--#-#-#--------##---#-##-----##--#----#-----#---#-------##-#--
-----#-####----##-#--#---#--##--##---#-#-#-----#--#---#-#----##-##-----##----#---------####-##-#-#-#
##-#------#-#-##-##------#---------------####--#----#---##--##-##--#----#-##------#---#---##--##-#--
-----#-#-----##-------#---#--#--##--###-##--#-##---#----#---#-#--#-------#---#---#--###-#--#----#-##
--##---#-------#--------#-#---------------#---####----#----#-#--#-#---#------#---#---#-----#-#----#-
-----#----#--------#--#---##--##-------#----##-----#--##-#---#-#--#-####------#-----#-----#---#--###
---#-----#--##-##--------#--##-####-#-------#--#----#-#--#-###-#----#--##-------#-#----##---##------
--#-#-----------------##----#--#--#-#-#---##--#--#-###--#--#----##-#----------#-#--------#--#--##-#-
###-#---#-#--#----#-#--##-#-----#-#---##-------#------##--#------------##-#-#---#-#-####-##--####--#
-###-----------#--#-#-##--#---#-##----#---------##--------#-#------#-#-#-------##----##-#---####----
----#---#---------##-#---#----------##-#-#---------#----#---##-#-###------###-#-#-----#--#---------#
-----###----------#-------------#-##-------###--#----###-#--###---#---------####-#----#-##---------#
##--#--------#---#---#---#-#----------#---####-#---#-#-#-##---#---#-------#-----##---#-----------#--
#--#--------##--#---#--###-#-##-----#--#------#--#--#-#------#-#--#--#----#----###-#-###---------#-#
#--#-##-#-----#---#---------#----###--#-#---#---#--##-----##------#--#----#-----#---#--#-##--#----#-
---##----#-##--##---#---#-#---#---##--###--#-#-----#---#---#----##--#-#-##---#-----#---##--##--#-##-
-------###--#--#-#-#---#------#-#-#--#--##-#---#--##--------#---###---##-------------#---#-------#-#
---#------##---#--#--#---######--#------##--####------#---#-----------##-----#------#--#-#--#---#--#
-###--------##---#---###--#-#----#---#####---#-------#-#---#---------#---#-#--------#-##-----##---##
#-#-----#---#---#---##-##--#-----#-#----##-#--#-----#------#--#-#-------#-##-#####-#--#-----######-#
------#--####-----#-#--#----##------------------#--#--#---#----#-----##----#--#-#-#-#-##-----##-----
----------------#-#-#--#--####----#-#---#-##--###-###----##----#-------##--#------#-#----#-#----#---
-----###--#--##-#-----#------#---#------##----#-----#--#-##-#-----#-#-#-----#---#-###-##-------#-##-
#----#---#-##--#-#----##--#-----#------#----------##--#-#-##---#-----#--#--##-#-----#-------##--#--#
------#-#-##-#--##---------#-##--------#-##-#-#--#-----------###--#--#-##----------#-###--##---#----
-#-#-----##----#--#---#-#--#--#-##-----###--#---#---#-#---#-#-#---##-#---##---#-------#----#--##-#--
-####--#-#-#-#----------##--##-##----#---#-------##--#-#--##---#-#-####-#----#---###----#---#----#--
----------#------####----------####----#-#------#-#------##--##---#-#---#---#--------#--#---#-------
------#---#---###-##------##--#------#-###-##--##-----##-#-----------#--##------#------##---#-#---##
------------##-#-#--#--##-#------#---#------#-####-------#-#--##------#-#-#--#----###--------##-#--#
-----##-----#---#-----#-###----#-#---#-#--####-#---#---#----------#--##--------#-#--------##----#--#
-#----#-##--#------##---#-----------##--#--####-#---##----------##-----#-##--#---#--#-#----###------
------###-###-#-##-##-----##----###-###-------##--#-##--#-------------#------#----#---#-##--#-##--#-
----###---#-#-----#--###---#----###----#---#--#----#-#--#-#--------#---###-#----##-#-#---###--------
----#-------#-#-#------#--#-#-#-#-----#--####--#-----###-----#-##----##--#-##----------#---------##-
-##----#-#-----#---#--#-#-#-#-#----###------#----#-####---##-----#-#--####----#-#---------#-#--##-#-
--------#---##-#----#----#-----#-#-#--#--#-#----#-###-------#-----#--#---#-#--#--#----#-#####--##---
--#--##-----#----#---#--#-#-###-##------#----###-#---#####-#-#---##-#-#-----#---#-#-##-----#--------
#--#--###-##-#----#--#-#--##---#-#-----#--#-#-#-#----#--#-#--#-#-----#----#---###-#----#-#---###-#--
##----#-#-#-#--##-#----#-#---#-#-------#---#-------#-#----###-#-#-#---#--#--#------##-----#---------
--#---##--#-##-#---------##-#---#---#--#--#----#------#-#------------#----####----------###--------#
#---#----#---#--####-#------#----##-#---###-#-#---##-#-------------##-###-##-#-#-#--#------#------#-
#--##--#-#--##---##----#----#-----#--#-----------#---##---##---#-----------#---#---------#----##----
------#-------#--#-----##-----#--#--##---#-#-##-#-------####----#--#--#-----#------------#----#-#-#-
-#---#-##-#-#---#--#-#--------##------#------#---#--#----##-----#--#-------#####-----##--#-##-##-#--
#-#---#-----##---##-#---#--#-#--#-#-----------##-------#--#--#----##-##---#---------###-#----#-#-#--
-#----#-#---#---------###---#-#----E-#--###----#-#---###---#-#--------#---##-----##-----###--------#
------#-##----#--#-----#--####--------##--#-#----#----#--####----#-----------##-----#----#----#-###-
--------#--#----#-#-#-----#---#--------------------#-#-----------#--#------##-----------------####--
#-#-----#---#----#-#----#-#--#-#------#----#-#---##-#---#----------#------#-------###-----#---###---
------#--##-##-##-----#--#---#------#----#--###-------#------#---##------#--#-----------#-##----#---
#-#------#-#-----####-##-#--#-----#---#-#---##--#--------##-#-#---#-##-#----##---#-#-----###-#-#----
----#--#--#------#----###-#-------#-------#-##----#-#-##-#----#-#-#---#-##-----#-#----##-##-#--#---#
###-#----#-#---###-#----#-----#---#--##---#-##--##----#-#---#-#--#---#----------#--###--#-#-----#--#
---##---##--#--#---#--#---#--#-#------#---#--------#------#----##----##-##--------#-#---S#---##---#-
#---#----------#-#----#--##--##--#-----##---###--###----#--------#-#----###-#-#-------#----#--##----
----#--#------#-------#-#-----#--#----#-----#-##----#-#-#---#-----#-----#----####-##-##---#-##-#----
----#----###-#-#--------#----##----#-##-----#-#-----##----#--###--#-#-#---#-#-----#--#-#--##-#--#---
----#-#-------#---#----------#--##----#-#-##-#-#-----#---#---###---#--#-#-----###-#-#-#-----#-#-#-##
###----#-#-----##-#-#-##--------##------##-----#----#--------#####--#-#----#---#--------#-----------
-#-####--#-##-###-#--#-----##--##---##--#-------#---#--#-##----#-#------##-#--#-#--#--#-#-###--#----
---##-#---------##--#-#-#-##--------#-##-#---#----##--#--------##--#------------##--#-----#-##--#--#
#------------####--#---###----#-#-----#---####-----####--#-----####---###-----#--#-##-------#-##----
###--#-##-#---#----#-------##------#----#---#--###--#-##-#---#---#------#-#-------------##------####
-#--#-----#--#------#------#-#-----------------#--####-#-#--------------#---#-----##--#--##-----#---
-##----##-##-#-#-------#-#-#---#----###-#--------#-----#---#-#----#---#---#-#--#-#---#---------#---#
##----#-#-##--------##--#----------##--------------#--------------#----#---#----#--------#---#-##---
----#-#---#------###---##---####----#--#-#-##-#---#----#------#-##-#---#---#---#-#--#---#---#-#--#--
##---#--#----##---#-#-###-#--#--#-##---#-#--##-#--##--#-----#--#-##--#-#-##----####-#--###-----##-##
---#-#-----#----#---------#-----##-#-##-----#-----#---#----#-------#-#--#-#--#-----#----------#-----
#---##---#------#-#-#----------#-#--##----#-####-#-----####---##--#--#-##---------###---##--##-###--
---#------#---#-------#-###--###--#----#--#-#----#----#-###-----#--#-##-#---#--#--##-#---#---------#
#--#-###---#---------#--#---#-----#--##--###--#-#---#---#----#---------#--------###---#----#---#----
#-##--------#--#-----------##----#----#------#-#--##---#--------#---------###-----#---#---#--------#
----###---###-##-#----#-----#---#--#--##--##---#----#-#-#-----------#------#-#--#---##---------#----
##---##-----#---------###-##--##-#-----#-#####-------------------#-#---##---#-###-####----#---------
-#-------------#-##--#----------#----##--#-#-##----#------##----##-#----#-#---#-------##---#-#--#-##
---#-#---#-##-#######-#----#--#--#---------#---------#----#---#-#---##--#-------#-------------------
#-#-#----------#-#--#-#-------#####-------#-------#--#--##-#-####---#-#---------##----#--####--#-##-
--##----#--#------#--------##-###--##--#---##--#--##---#---#------##------#----#--#---#-----#--#-#-#
---###----#-#-###-#---#--#-----#--#-###----#--###-----##---##--##--##--------##---------------#--#--
-##-----------#----#--#--####-------#-#--#-#-----####--####-----#---#-----#---#-####--#-----#---##--
#----#####--##--#----------#--#--#-#-####----#-#-#-----#-##---------#------------#---###---------#--
##-------#---#-----#--#----#-#-##-#------#---##--#-##---#-#-##---------------##--###--#----#----##--
-----#-#--###-------#---#---######----#--###---#-#--#--##------##-##-#--##---##----#--------#-----#-
-----##--##------------------------##-#-#-##-#-#--#------#---------###----#--------#----#--#-##--##-
--#----#---#-#-----#--#--##--#------#--#--------#-##----##--#-----#-##--##--#--##-###-#-----#---##-#