?diagonal=Always;
#------##--#-#####-----#-----##-###-#-#----#---#----#----#----##-#-#-##--#-#--#---------------------
##---#-----#-##------##--#-----##--#---##-##-##-#---------#-##--#---------##--------##----#----#--##
#-------#---#--##----#-------###-------##-##-----#----#-##---------#--#-##---#----#---#---#-----#---
--#-----#---##---#---#--##--#-#-#----##--#--#--------#-##-#--###-#-##----##---#---#----##--#--##--##
-#-#------#-#-#-###-#-#----#-###-#-#-#---##-####----#--#-#----#----###-#--#--#-------#-#-#--#--#----
#---#--#----------#--#-##--#----#-#--#-#--##---##-#----#-#----#-------#-#---#--#-------#-----##--#--
----##-------#---##-----#---#-#####-#----##--#---------#-----------#--------#------#--#--#----##--##
###--#---#-#-#------##--##-----##---#-------#--#--------#--##--#--#--------#---------#---#-#--#-----
-##----###--#------###-----#-#--#-#-#-----#---#---##--------#---#----#-----#--##-#--#-#--##-##--#---
#---##-##-#-------#--##-----#---------#-----#---------#----###-#----##-##--#---##----#--------------
----#-------------#--####----#---#-#-#----#-#-##-##-#--##-##--#--#-#-------#-##---#-----#--#---##-#-
#-----#---#-#-##E---#-###-##-##-#--##-##--####---------#---------#------------#-#--#####--#-----#-#-
-##-#---#-#-##-#--#-##-#--#--#---##--#------#------##------##--#####---#--#---#-#--#------#-------#-
##-#----#--##--##-#-------##-##----###-----#-##-----#--------#-------###-#---#--##--#---#--#----#-##
---#--#--------##--#----------#-#----#-------#----##---------#-###--##--#-####----#----#---#-----#--
--------#-----------#--#-#-----#-#-#-#--#-#-#-#---###-#-##-##-#---#---#--#--#-----#--#-#-#-#------#-
-#-----####----#--#---#-----#------#-----#---------##--------------#--#--#----#----#--##-##---------
---#--#--####-----#--#-#-#-#-#--#-----#-----#-#---------#--#----#--#-#------#---#--#-#---#-#---#----
---#-#-##----##---------#######------#---#-#------#---#----#----#--#-----##--#--###----#-#-#-##----#
--##---#---#---#--------##--##-##-#---#-#---####------#----------#-----#--#--#-#------##--#---#---#-
##-#--####------##-####---#--------#-------##-#--#---##-----#---#---------###---#--#-----#-----#--#-
--#-----------##-#-------#-###--#------#-#-#-----#----#-#-###-#--#---#-#---##--#-#-----#--#-#---#-#-
-###-------#--#-#--#-#-##---#-#-#-------#-#---#----#-#-###-----#--##---------#---------##---#-------
-#------#----#----#--#---#----#-##--#---------##-#---#-------#-----##----##-#---##---##-#----##---#-
----#-#----#--##---##-#-#--#--#------------------#-#-##---#----##--##-----##-#-----#-#--#-----#-----
--#---#-----##--##--#--#--#-#--##---#-##---#----#-#-#-----##----#---#---#-##-#-#-##-#---#-##--------
--#---#-----#---####-----###-#--##----#-#---#-##-##-#-#--#-#------#---#--#--##---#-----###----#--#--
----#--##-#--##-#-----#--###---------#---##-------#-#----####--#---##--#--#----#---#-#---#----#---##
---#---##-----###-----#--#--#------------#---#----#-#----#--#-#-#---------#--#-##-#------#---#----#-
##-#---#--###----#-#-#-##-##-------#---#-##------##--#---###-#-#---##-##---##-#---#--#-#---#-#---#--
-##-#------###-#--#---####-##-###----##--------##-----#-#-#---###------------###----#----------#--#-
-#--###------#-##--##-------#---#--##--#--#-----####-------###-#-#--#---------#-----------#-----#---
---------------######---##--------#----#---##-#--#----#----##----#---#---#--#--##-----#---##----#-##
-#--##-----##--##--#------#-----------##-#--------#------#---------###-#-#---------------###--#----#
---#-#----##--#-##--##----#---------#--------#---#---##-------#----#-#--##-----#--#-----#---#--#--#-
----##----#------#-##-###--##------#---------#-#---------#-##------------#-#--##--#----#---#------##
-----------#--#-#-#---##-----###----#-------##--#----#----------#---#-----#-#-#--#-###-------###----
#----#-#-------##------#-----#-##-#-#----------##----#-#---##-#--#-----#--###---#---#-##--------#-#-
-##-##-###-----##-#--#-###-------##-##-#--##-----#--#--##----#-----##-------#----------#-#----------
--------#-----#--###--##-#-#-##-#--##-#-#----#--#----------------#----#--#-----#-#--#--#-#----#-----
--#---#----#-----#----#-#--#--#------------###-#--##-#-----#-###--------##-#-#-##---#---#---#-###--#
----#-##--##----#-----#--###-##--------#--#--##-#------#-##-------#---#---##-#----#####--##-##----#-
#---##-##-##-#----#--#--------------#--#--##--#-----#------#--#---#--#----#----#-#####--#------#-##-
--#----#----#--------#---#----##-#-#---#----##--#-#-####----------##-------#-#-----##--##--#------#-
--#-#--#----##-#---#---#----#-#--#------#-----#-#-----------#----#----#-----##--##---#---#--#-----#-
-#----#---#-##----#--#-#---#--#-#--------#-#---###--#-----#----#--#-#-----#-#--#-----#-#----###--#-#
--##------------#---------#----#-##--#---#-######-------#---#-##-##--###---#-#---#-----#--##-##---##
-##-#-#------#--#----#--#-#-#----####---#--###-------#--#-------#-#---##-#--------#--#--#---##------
-----#--##--#---------#----------#-#-#---#-----#----###-#----####------#------#-##---#---#---###----
-#----------#----#-#-#-----#--------###--##-------#-----###--#------#--#---#-------###-##---#--#----
###-----####--#--#--------##--#---#----##--#--#--##-#--#-##-#-------####-----#----#-#--#----#---##--
---#-#-#--#---------#--#-#---##--#--##---#--#-#--#-#-----#-------#-##--#--#----#-#---#-#---#--------
###--------##----#------##---###-----##-----#--#----#-#------#--#-##----###----------#-------#--#--#
--#--#-------#--#------#--#---#-###----#-##-##-#-----###-###---#--#--#-#--##-#------#--#-#----##-##-
---#--##---#-----##-#-#-----#--##-#-#--#--#--------#-#-------#--#-------#---#-#---#-#--#-#--#--#--#-
------#------#-#----#-#####---#-#-#----#------------#----#----##---#---#-#----###-#-------#--#-----#
##-#--------###-##------------#-#-----#---##--#-#-----#--##-#-##---###----#-##-#--#--#---#-------###
------#-###-##------#---#---#--#---#-###----####-#--#-#---------#--#-##-----#--#-#------#--####-##--
----#----#--####-#--#----#--#-##-#-------------#--#-#-#-----##-#-#--#----####-###-#------------#-#-#
-------##---##--#-----##-#--#-#-#-#------#-----#--#-------#--#-#-##----####------------#--###--##---
------#--#----#--###----#-------#-----#--#-#---#--#--#-----##-#-#--#-#-----##------#-##----#--#-----
--#--###-#-----#--##---#--#-###-##----#-------#-#-#---#----##-##---------#----------#--#---------#--
-----#----#------#----##-----------#---###-----#--------------#---#-----#-------#----#------#-#---#-
##-#---#--#-##-------#---#---------##-----#--#-#--#-#--#-#-##-#-#-#-#-#----##------##-----------#-#-
----#-#----#-#-----#---#----------##-------#-##-###--#-----#---###-----##--#-#-----##----#---#------
#---#----#--##---#----#-------#---#--#--#-#--#--#--#--#-#-#--##------#--#--#-##-------#-#-##-#------
#-#-##----#--##--##--#-#-#----##--------###---#---#---#-----------#-###------#-----#-#----##-----#--
-----##-#--#------#------#----##---#--#-#-------#-#-##--------##---##--##-----------#--##-S-##------
###-#--#--#----#-#---#-##--##----------#-----#----#--##-#--##-#--#--#-------#---##-#-#----##-##---#-
----#------#-----------#----#--##--#--###---#--#-#-##-#-##--#-#----#-#-#----##-----#--#--#--------##
-#------#-#--#------###------#---#--#---#---##-#-#-#--#-#------#-#-----###-###-#---------#-----#--#-
--##-#--#------------#---#---#-##--#-------#-#-#-##--####-###-#---#-------#--##------#---#--#-------
-#---#-#-#---#-#-####--###-------##-#--#--#---###-#---######--#--#---#---##---#--#----#--------#----
#----#----##--###-----#-##---#--##-------#---#-#-#-#-##------#--#--##-----#----#------#-------#-----
#-#---#--#-----------#---#------#----#-----#-#-##--###-#-#-#------#-----##-----#-#--####--#--#----##
#--##-#----#-#--###-#----------##--##-#--##-#---#------#--#---#--#---#----#------#--#--------#------
#-#---#-#-##--#####---##-#--#--#--#-------#----#-#----------#-#-------#----##---#---###--###--------
##-#-#--#--#-##-##---#--------#--##---##----#---#---------#-------#-----#--#----##-#-##-#---##-###-#
-----##---------##----#------#-#---#-------####---#-------#-#--#---#---#-----##--------#-#--#-#-----
-----#-##------#---#--#--#---------#--##-###----##-----#-###-##----#---#-------#--#---------------#-
-##--#-#-##-#------#-------#####--#--------#--#--###-----##--#--#-#------#---#----##--#------#####--
---#----#--#-##----#------####-##-##---#-#----#--#--#--#-------#-###--------------#-----#---##-#----
----#-##---##---####--#-#------#--#-----####-#-#---#-----#----------##---------#---#-#------#----#-#
-#--#-###---#--#-----#-#----#------#-#----#-------##-----------------#---#--#-#--#-----##-----------
----#-#---#-#-###--###-#--#--#----##----#-#---###-#------#-#-#----#--##-#-#---#----#--------#-#---#-
#-#-#-#---####-#-#--##---#----###---------#-----##--#-#-##-#---#----##-#--------#-#------------#---#
#-#-#--#---------#---#-#------------------##--##-##------###--##-#-#----#####--#-#---#--#----###-#--
-----#-###--#-----###--#-##-#-#-------#--------###--#-#-###----#---#--#---###--#------#--#-----#-#--
---#---#----##----------###-##--#-###----##-#--------------#---#---###--#-#---#-#--------#-##-#----#
##-##-#----##--#-----#---#-#-##--#-#-#--#-##-#--#---#-----#-#-##-------------##----##-----#-------##
-----#----------#---#-----##-#-#---#------#--##------#----#--#-#-##-----#-#------------------#-#-#--
##-#-------#--###----#---#------#-#-#-#--------#--------#------#-----------####------------#--#----#
-#-#-----##-#------##----##-----#-----#--#------#---##---#-###-##-#-------##---##---#----#---#----#-
##-#---##----###--#-#----##--#-------###-----#-------##--#------##----#-#----###-#---#--#--##-##--#-
#---####---###-#--#------#---###-----#-#--#---#-------##---#-#-##--------##--##--#--#-#-#-----#--###
#-#-#---#-####--#-#-----##--#####-##-##-----##--###-#---#-###--##----#-#---#--#-##------#---#-------
##-#----#-##-----#----#---#--#----#-##-##---##-------#---#-##-#---###------#--#----#---#-#--------#-
#---#-###---#---#----#--#--#-#--###-#-#--##----#-#-#---#-#--#------#-####--#----#------#-----#---#--
##------#----#-##-#--#-----------#-#-#-#-#--#-#--######-#--#----#--#------#--------------#--#-#-#---
--------#------##--#-#-----------#---#-##----#-#-----#-----#-#-####---#--#-------#---------#--------