?diagonal=Always;
#--#---#----#------#-#-------#-----#####-#-----##-----##-#-#----#--###-#--##-##--#--#-###--#-#--#--#
#----#-----###-#--#-#----------#--#-#--#-#--#-##-#----#--#--###---#--#---#--#-##--------#-#-----##-#
--#---#-#----#-#--------#------#--#------#-#-#-#-----#-#-#--#---####---#--##--#-##--------#-----#---
-#---##-----#-----#---------#--##---#-----#---##--------#------#--#---#----#--------##--------#-----
#--#------##-###-###----#--#####--#---#-#----###-#-----#--##--#-###-#-----#---#--##-##--#--#---#####
-##--------------------##------#-#-##-##------#-#-#-----##-#-------##---#---#-#-#-----#--#---#--#---
---#--#-----#--####-#-----#-------------------#-###-------#-----#--#--#---#-#-#-#-----###-###-#-#--#
---#--------#-#--#--##-##--#---##----##-#------#-----#----#--------#--#----##--#--##--#--#---#----##
--#--##-#--------##-------#---#----#---#---##----#--#-#-#----#---###---#----#--#--#---#--##------#--
-------##---#--#---#-##--#--#----####---#--#-----------###-#-##-#-#----#-#---#--##--#---##-#--------
----#--#--#---##-#----###---------##----#--#---#--#-#-##-#----#---##--------##-----#------#----#----
##-##------#--------#-----#-#----#---#-#---#----####-#-----#-------##--#--------#----##--#-#--#-#-#-
-----#-#--------#--#----------------##--#-#---#-##--------##-##--#----##----##--##--###-#--#--##--#-
#--##-##-#----#--#-#-##-----#-##-#---##--##--#-##----##--###---#--#-#-#---##----#--#-#-----#-##-----
-----E#-#-######--##--##------#######--------#--##-----#--##-#----#---##-#-#----#-------#----#---##-
--#--#--#-#--#-#------#-----#---#---#-#--------#-----#---#-#-#----##-#--#------#------#------##-----
-#---#---#----#--------##---#--------#-#--##------#----------#---#---##----#----#----------------#-#
---#--#-#--#--#-###-##-##-##-###-#------#-----#----##--------#---##--#--#--------------#----#--#---#
-#-#--#---#-------#--#----#--#--###--##-#--------#-##-#-#--#------###----#--#------#-----#----#--#--
-#---##----##----#---#-----------#--#-###-#-###----------#-----#-#---##-##-#--------#-----#-##--#---
#---#-####-----#--#--##-#-#--------#--#-----#-##---------##-#----#-#----##--#--#--------#-#----#---#
---##------##---#--#--#-##-#####----#--#-##------#-------#-#----------##--###---##----#####----##---
#-----#-##-#----#-------#--------------##-####-----##----#-#----#---#-S-----#----#--#-#-#---#--#--#-
-##---#-#-#-----##--#--#--##-#-##-#--##---#----##----#----#-----##--#---##-##----#-#----#---###-#--#
-##-----##--#-------------#-####---#---------#----#-##-###-##-#----#--#-#-#---##-#-#---#--#------#--
-####-##-----#-#-####----------#--#------#-----#--##---#--#-----##----#---##--##-#------#--#---#----
-####-#--#--#---#-----#-------##-#-###---------##-------#---#-#-##----#---------##-#-----##-#-#--##-
####-#-#--------###--#------------##-------##-----#--##---##----#----#-----#------#-##------#----#--
-----#--------##-#-#----#-#--#---------#--#----##-----#--#-----##------##-#----#-###--#--#-#-#-##-#-
-------##----#--#--#-#-#---##--#--##-#---#--#-#--#-###----#---#--#------#-##-##---#---##-#--#-------
##-#-#----#-#--#---#---#-#--#-#--------#--#----#-##--#----#----#-#-##-#---------##----#-#-----##--#-
#-##--#-##-#-#--#-#-------#-#--#--#-#------#----#--------###--#---##-------#-#----#-----#----###--#-
#----#-------##---#-------##-##---#-------#----------#-#-----#-----#-#------####-#------------##-#-#
#--#-#-#--#---##---##-#--#---#--#---#-#-#-------#----#----#-#-#-##-#----#----##---##---#--#------#--
#-----#-#-#---#######---#-----###----#-#-#-##---#---#-----#---#---#---#-----###--#-------#-#---#-###
---##-##--##-#--------------##-#-------#---#----#---------#-#-------------##--------#----###--#-----
---#-#--#--------#-------#-#--#---##---------------##--#-##----#-----#--#-#----#----#------###------
------#-#--#-####--####-#----------#-----#--##-----##---##-#--##--#-##-#--#---#----#----#-----#-----
--#-------##--#-#--##------#####-#-#---#--#------#-#----##-######----###--#----#------#---#-----##--
--------------#---#-----#---------#------#----#----#-----#-------#-#-#-###-#--#---##-#-#---#--#-#---
---#------#----#--#-#-#------#---#------##-#-----##-#---------##--#-#-----#--#----#--##-#-#--#----#-
#--#-##--#---#-#---#####-#------#-----#-#----#-#--#------#--##----#-#####----##-#---#----------#----
--------#------#------#--#-#---###-#-###-#-#--#-#----##--------#-###----#-#-------------#-#--##--#--
--#--#----#--#-#--##--##----#####---#-#-##-##-#---#---###-#--#-#-#--------#----#--#--#------#-------
#----##---------#----#-##--------------#-##---#-#----------#----#----#-----#-#-#---------#----#-##--
#-----#-###-#-#--###-##--------#---#--##-#--###----#------#--##-#-----#---#--##---#---#-#-##--#----#
------------#-#-------#------##-------##-####----###-#-#-#---------#-----##----##-#-###------#-----#
#------#--##---##-#-------#--#----#-#----#-#--#-------#-#-#--#######-#--#--#-#-#----#--#--------#--#
--#-#-#--#------####----#-###--#---#-#----#-#-----------#-##---##---#----#-----#-----#--#-##----#--#
--#--##---#-#---#---#-###-#--#--------##---#----####----##----##---##------#------#-##-#--###-------
------#----#--###--------#---#-----#-##-----##---#----------------#-----####-----####-#--#--#--#----
#---#------#-----##--#----#-##------##----#------#-#--##-----#-------------#-##-#-----#--###--####-#
##------#-#------#-----##--------###---#-#--#--##-#-----#---###---#--#---##--#------#-----#-#------#
---#------##-#----#-------###----------#-#--#------#-#------##--------#----#-#---#---------####-##-#
---------------#--#---##--#---#---------#-----#-#--#-----###-###-----##-#-#---#-----------#-#--#-##-
--#---#--------#--#-####----#-##----#---#-----#-#---##--#---#----#-##---------#-----#--#--#-----#--#
-------#-#----#--#-#-##--#-----#-#-#-#-##--------#--#--#-#----##------#------#------###---------#--#
#----#--##-#-#----#-#------#-##--#-##-#-----#---##-#-#-#----#-#-----###--###----#-#-------#--#------
-##-------##---#-----#---#-#-#--##-#-----#------#-----#-----------#----##--#-#------------##-#--###-
----#---##--#-#-------#-#-#-#------#--#-#-----###----###---##--------#--------#--###----#---#---#---
-----##-----#-------##-#-##---#-#-------#--##--#-#--#--#---#-#-##----------#------###--####----#-#--
#--#-#--#-----------#####-------##------#-#-#----#-----##---#-#--#--####-#-##--#-----##------##---#-
----#-------#--#-----#---#-#-#-#-#--#-----#---#--###---#-#-#--##--#-##--#-----#--##--#---###---#----
--###--#---##-#--#----###-##-----#--#--#--#--###-#---#--##-#---#--###-#----#-##-------####-#-----#-#
--##--#---------#-#----#------#-------#---#-#---#-#-##---#--#-##-----##----##--##-#-----------------
--#---#----##-#--------##----#--#-----##-#---#-#-##--#--##---#-----###---#-----#-------------##---#-
-#------#-#--##--#--##--#-##--#---##-###---#-#---#------#--#--#-#----#--#-------#--------#----------
#------##-#------##---#-#-#--#---#----#---#-----#--#-----------###--#---------#-#-#-###-#---##--####
#--##--#-#-#------#-##--###-#--##-#-##-#--#------#-##----#------#---#--------###----#--##-#-#-#--#--
#---##---#-------#---#------####----#-##-----------#---#--------#---######--#------#----------#-#-#-
#-#--##---####-##---###--#-#--##--#-----#----#--#-#--#---------#-#---#-#------#---#--##--##-###-----
--##--##----####----#-##---#-##----#--#--#---#--#--#-#-##-----#-#----#-#-#--#--#--#--#-####---###-#-
#-##--###----##-#---##-------#-----------#-----#-----#--#-------#------#--#--#-#----#--###---#------
-#-#---###---------##-#-----##-----------#--------##-#-###--#--#---#---##--#-#-------##----------##-
-#---#-#--#-#-------#-#-#--##-#---#-#-##----#---##-#-#-#------#--#----#---##-#---#--####-#--#-----##
-##---------#-#-----#--#----##------#-----#----#-------##---------#-----#-----#--#--------##-------#
--#-#--#------#--#-------------##-#--#-#--##-----##------#---#-##--#-#-#---#-#----##-#-#-----------#
--##--#-#-##-#---#------##-----#---#----#-#-#-##----------#------#-------------##-#----#-#---##-#-##
------#----#---##--#----##-----#----#-----#-#----#--#-#------##-#-#--####----#--#-##-#----##--------
-#-#--#--##---------#------#--###-#----#-##-##--#-##----###-#-#--##----#-###-###---------#--###-----
--#------####----------#------#--#-#-#----------------#--##-#------#-#--##-#------#-#-#--#---#-##---
#-#----#------#---#-----#-#----------------#---#------#-------#-#-#-----#--##------------##----#-#-#
----##--##-#-#---#---#-###--------####--#-------#--#--#-------##-##--##----#---------#-#-####-#-#---
#-##--#--------#------#-#-#---#---#--#------#--##--#---####---#-#--#-#--#-#-####-##-#--#---###------
----#-----#----##---#-----##---#-#--#--------###-#-###----#-###-##--###-------#---##--###--------#-#
-------###---##--#---#------#---#-#--##--##-#----#--------#----#-----###-------------#-------##-----
----#---#-#----#-----#-#--#-#--##-----#--#---##-##-------##-----------##-##---##-#---#----#--#------
-----#---#-----#--#----#--##---##-#------#-#-#-#-##--#-----###----#-----#-#----#--------#---##---#--
-##---#-#-#-#-#----###-#--#---##--##----##-----------#--#----#---#----#----#-----#-#--##-----#--#--#
#--------------#---#------#----#--#-#--##---#---#--#-----###--#-###---##---##-#----#--#----#---#-##-
---##--------#-----#------#-#-#-#-----#--###--#--##--------#-#--###-#------#--#-#-----------#----#--
-####----------##---#-----##-----#-#-##------------#-###-#-#----------------##---#--##-#-------##-#-
--##-###-#---#-----------###-#----#-#---#----#-#----####-#-##-#---#-----#-#-----------#-#-#---#--#--
----#-----#-##---#-------###---#---#--#--###-#-#-#---#--#-#----#-####--#--#--#-#----------------#-#-
###-----------#---#--#-#---#---#-#-#--##-#-#-##--#-##--#---#-----#--#-#-#---##----#---#------#-----#
---------#-#--###--#---##------#---###--#-#--#---------#-##-###-#---#-#--------#---##----#--##---#-#
----##-#--##-#---##-#-----------#-------###-#--#---#----##----#-#----#-------####---#-------##--##--
#-##-#-#----#-#---#---##-#-#-#--#----#-----###---###--------#-----#-##----#----#--#--#--#-#-##--#---
---#--#--#---#--#---#--#----#-#-#--#-#---#-###----------##---#-----#-----#---##---#----------------#
--###---#---#----#-#-----------------##-----#-#---##-#-#-##--##-#--#---##--------#-------#-#-----#--