?diagonal=Always;
---#-#-#--#-----#--###---#---##-##---#-#-###-#---#--------##---###------##-------#---#-----#---#--#-
-----#-#-------##---#--##-##-------#--#--#-##--#-##--#---#--------------##--#--##----------------#--
---------#-##---#---#----#----#-##-------###------##-#---------#--#-#--#--#----##-##--#----#-#-#-#-#
-#--##-------#--##----##--##-#-----#-----##-#-###-#--#--#--#-##------------##--##---##---#--#-#-#---
#-#---##--#-#--#--------------------------#--------------------------#--#---#--#-#-----#--#-------##
------------##---##--##--###---#---#---#-#-----##---#--#---##-----#------#-------#---#---#--------#-
-----##-----#-##--#------#---##---------#------####--#----#-#-#----#----##------#-#-#-#--#-#-----#--
##-#---#--#-#-##----##-#-#----#-##------#-#--#--#-###--###---#-#-##-##-##--#---###---#-----#--#--###
--#-#--#------####---#---#--##--#-#--#--##---#-#-------#--#######--#-####---#-####-##----#--#-##----
#--#-#---###---#--#-#-#------#--##-----###-----------#----#---#-------#-----#-----#--#--##-#-##-##--
#-#--#-#------#--##----###--#-#-#-#--#-#--###---#-#---##-#-------#-------##---------#--#-#-##--#----
--#---#--#---#-#---#---#-#--------#-#--#-#-#-#----#---#-----------##-#-##---##-----#-----#-----###--
----###----###--#-#--#----#-#----#-----#----#----#--#-#-#---#--##-----#-#----#---#-------------#---#
###-----###--#---#-#----------#--------#---#-##--#-#--------##--#-#--####-----------#-##-##-#-------
#-#--#--#-----#---#--#---------#--##-##---##-----#---#-##---#-#----###-------#-#####-#-##-#-----#--#
---#-#-##-###----#-##---------##--#-#-----#--#--------#--###-##----##-------#-#-#--##-----#-----###-
#-#---#---#-##--#---#---#---#-#-----##-#-------------------#--#-------#-#------#--#-#------##------#
#--####----##-####------#----#-##--#-----###-#---#-#-#-#------#-#---#--#---#-#----#-#---#-------#--#
--#-##-#---#-#--#-#-#----#--##----##-----#-----#-####---------#-------##-##--#-----#-----#-##----#--
-----#--#--#--#----##-----------##--#---###--#--#--###---##---##-#-##--##-##--#--#-#-#--#--#----####
#-###---#---------#-#--#---#-----####--###--#-#-##-##--#----###-----------------------#--#-------#-#
-----##--#--#-----#------##------#--#--###-#-###-#--##----#-##-#----#----##-#---------#------------#
#---------#------##-#---#---#-##--#----#------#-#-E---#--#----------####---------##--#--#-##-----##-
---#---####--#---##-----#------#--#---------#---#--#--#---#-###-#--#-##---##----#---#-----------#-#-
#----#-----------#----#--##--#-#------##--##---#-#----###-------------##----####-----#-#------##-#-#
#-----#---#--##---#---#-----#-#-#-#---##----##---------##--##--#-#----#-----------------------#----#
--#---#-#---------##--------#---#####---------#-##--#-----#-----##--#---##-#-----#-#------##----#---
#------#---#-#-#---#--#----#--##--##----##--------#----#--#--------#---#--#---#--#------#--#-#--#---
------#####--#--####---#----#--#-##-##-#----#-#---#-##--####----#--#-----#--#--###--------#-#---#-#-
#--#--##----##---###----#-#--------#------#----#---#-----#--#---##-#-#--------#----##------##-------
---#--##-----#-----------#-###-#-----##--#-#-#-----#-###-#--#-##--##----#--##---#---------##------#-
---##----#----#-###------#--#-#-----#-------#-#-#-----#-----##-#-#-###--####--------#-#--###---#---#
#--##--#-#--##---##---##------##--#-#--------#--##--#--#-#---##---#-----###--#-#-#-#--------###-----
--------#---##-#--#-##-#-#--#####-------#----#-#----#----##-------#-##------#---####-#-----#---##---
#--##---#-#--##-----#----#----#--##----##-----#-###-#--#-----#---##-#-#------##-#--#-#--##-#--##-#-#
-#-------##-----------##--#---##--#-#####------#-------##--#-#-#---#--#-##--#----#-#--#----------#--
---##-#------###---###---##---#---------#---###----------#--------##--#---#-#--##---##-##----#----#-
--##--#-###--------#--##------##--#--#-----#-#-----####--#-##--##-#-#--#---------#---##-#-####--#---
--#####-##--#-----###-#---#------------------###---#-#--##-----##------#-#-#--#-##-#------#---------
-#----#-------##---#--###--##--#--#-###--##-----##------###-----#--#------#-#-#------#-----#-#------
#--##---##--#----------#--#----------#--#--#-##----##---##-#-##-#------##-###--#--#--#-#-#-#-###-#--
---#-#---#-#---------#--#-------#-#-----#--##-##--#-#-#-#--#---#---#----#-----#---#--##--#--#-#--#--
-----####------#-#---#--##--###--------##-----------#--------#-#--#----#-###--##---------------#----
-#----##----------------#-----#---##--##-#-####-------##---#--#--#-------#----####-#-----#-#-----#--
---#--##-#------#-----#-----#----#------------#-#-##--#-------#-#-----#------###-----#--#------#-###
--#---#--#-#----#--#-#----#----###---#-#-#--##---#-----#----#---------##---#--##------##-#-----#----
-#-##--#-#------#-##---#-#####-------#--------#----#------##----########------##-#---#-#--######---#
-##--#-##-----#------##--##-----###-#-#--#----##-##----#---#-#-----#-----------#----#####----#---#--
##----##--#---------#-#-##-###--##-##-----#-#----#--#-#--------#---#-#-#-------#-#-#-#---#--#---#-##
-#--#-###--#-#-###--#--------#-#--##-#--###--#-----#-#--#---#---#-#--###------###-#-#-##------------
-##-#----------#-##---##--#--#---------###----#-#-------------#--#--#----##------##-##--#--#--###---
#---#-----####--##-#---#-#--###--#-#----------#-#-------###---#----#-###-##--#--------#------#--##--
--#-----####---#-#-----#---#---###-#-------#----##----##-#-##----#------------##-#--#---------##-#--
----##---#--------####-------###---#--#---#-##-##--#--####--##----#--#---#-#-##--##-----#--#####----
-#------#--#-------#--------##--#---###---#-#---#-----##-#---#-#-#-#---------#---##--#-#---#---##-#-
#---------#-#-#------#-----#-#-#--###--###-----##----#---###------#-------##----#---#-#--#---#---#--
#-##---#-----------##-#---##---###-------#-#--#----#-#-#-#-###----##---#---#---#-----#--#------##--#
-#-##-##-#---#--#----#-#-#--###-#-#--------#----####-#--#-##-#-#-##--##---##-#--##-----------#-#---#
----#--------------###----##----#-#-----#--#-#-#-----------#--##------#------------------#----------
-###---#--#-------------------------#-#------------#--###-------####-#------#----##----#--------###-
--------#--------#--##-#-#####----###--#-#--#----#------#-#-----------------------##----#-----------
-#---#------#-##----#-#--##-##--###--------#--#-#---------#--#-----#------#-#---#--##-##-#-###---##-
--#--------#---#-#-#-----#-----##--#--------#---#---#-------##-#----#----#-#--------#----------#---#
-###-#--------#-##---##-#---##--#--#--#----#-#-#--##-#-##-##---#---###-##----#-----------##-----#---
----#--------#--#-###-----##-----#-----#-#--#-###---#---#---------###-----###--------#--#------###--
-#-------#----------#-----#---#----#----#--------###--#-#-#--###-##-#--###---#-##---##----#-#-#----#
###----------#-----#----#-##-#-#--#-#---##---#--#------#---------##-##-------##---#-#---------#-----
-#---##-#------------#--------##-##------#-#----#-#---#-#---#-##----###---#-#--##---#####----#----##
-#-----#--##----#-#---##------------#-#--##-#---#-----#-#--#-#-#------#---------#-#---#--#-#-##-----
--#---##-##----##---#----#--#-----####---###------#--#----------#-####-##---------#-#-#---#--#-#-##-
##----#####-----#-#---###-#---#-#------#--#--#---------#---#----##---##--####-----#--#-----#--------
#-----#-##----------#--#------------#-#----#----#---#-----###-----##--#-#-##-#--------#--#----##----
-----#--##------###-------#-#-##---------#-----###--#-----#-#-------#--#---#--#--##----#-#---#------
-#-------##-----#--#---#-#------------#----###----------#---#-----------###-----##---#-#-##-##--##-#
#-#--#----------##-----#-#---##-----#---#--###-##-#------#-#-#---##-##-#----#-###--#---------##--#-#
-##-----#---##--#-##-#--#---##-#--##--#--##------#----------###--------#-----##--#-#----#-------##--
-----###-#---###-#---##--#------#-----##-----##---#--#---###--#--#-----#-#---------#-#-#--##--##----
#---#--#---##----##-#--#--#-#----##------#----#-----------##-##-#-#----##-----##-#-#---#-###-----#-#
-#-#------#----###-#------##----------#-----------#--###-#---##--#-#------#--#-#-#-#--#-##-##-------
-#---##----#-------##--#--#-----#----#--###---#-##-#-------#---##-#-----#-#---#------###--##-#-----#
------------#----##--#--#---#---##--#--------#--#------##----##----#---#--#-#-----------------------
--#-------#-#-#--#--###---#--------#-------------#----#--#-----###----#----#--#-#-#-#-#---##------##
-##--------#--#----#-----#------##-##-#----------#-###-#--#---#--##-#----####--###-----------#----#-
#-----------##---#-#-#------#-#---------##-#--#---##----#---###-##--#----#--------#-##----#---#----#
##----#---#-----#-#---#--#--###--#---#--------#---##---------#-##---------##-######---#---####-###--
-##----##-#-----#---#---------#--#-##---#-#-----#----#-##-#-#-------#-------##---##--#-----#-#--#-#-
#-#-#-#---------###--#-----##-###--##----#----##-#----#----#---#---#---#---#---####-#-#-#-#-#-------
---#-----#-#----#-#-----------###-#--------#--#----------------#---#-#--###-#-###----##------#-#---#
--#-----##-#--#--#-##---#------------------###-#-------###-##---#---#####----#-##---------#-##----#-
--#--#--#-#---##--###-----#-#-----#---#-#-------#-#-------##-##---##----##---#---#-#--#---#------#-#
-----##-#-----#--#-----#-#---#---#-####----#------------#----#--#--#--##-#--#----#-#-#----------#--#
##-#--##---#--###--#-----#----------#-#--#--#--#---#------#--#--#-----------#--#-#------#---#----#--
-#----##-#---#-----##---#--#---#-#-----#--###--------------###---#--####-#-----------#---#---#-#-##-
#--#-##-#-#--##---#----##--#--#-----#------#-#-----#-#-##-----#---##-#---##-#----------#-#----------
##------#--##-####-#----#--###-------##---######--#-------#--#--###--#-#--#--------#---####----#--#-
----#-#--#----#-##----#---------#--###----#---------#--#-#--------------##----#--#---#-#-#---#---#--
--##------#------#--##-#-#-#---#-----#-------------#-##---#-##--#-----#----#----#-##-#----#---------
---#--#-##----#----##--------#--#-#-----##-##-----#-#----#----###-----#----#-----#----#-##----------
--##-##---#-----#---#---#-------#---------#-----##---##S---#-##-#-#------#--##-#----#-----#----#---#
#---##--#-#-#----#---##-#---#-#----####-#-----#---#-#-#---------##-------#-#-----##-##-----#--###---