?diagonal=Always;
-###-##--#---###-----###-----#-#----------#----#-----#----#--#-#-#----#--------#-#-#-#####---#-#--#-
------#------##--#----#---##---###--#----#-#----##---#----##-##---#-----#-#---#-#-##-##-#--#-#------
-##------#---#-##-##----#----#---------#-----#-#-----------#-----------#---#---#-#------###--###-##-
#--#--#-----#--#-#-#-------##-#-------#------##-#-##----#--------#-----#--------------##--#--#-----#
------##--#--#---#-#-#--------------#-####--#------#------#-----#--------#----------####-#---##-###-
#----#-#----#--##----#--##--###-#-------#-#---#-##----#-#---------#------#------##-#--#----#--#--#--
---#--##---#-#--#-#--#----##------------##-#####-#---##-#-#-#-------#-----#-#----#-------------#-#--
#--#----#--#-#----##-------##-#-#------#--#----###----##-##-#------#-#--##-----##--###----#----#--#-
------------#-----#---#--#-###---#---#---#------#-------##--------#--##---#-----#--#-----#--#-#-----
-----#--#-#-----#--##-#----#---#--#-#----#---#--#--#--S-----##--##--#---#----#--##---#----##------#-
----#---#--#----#----#--####---#--#-#-----####--#----##-#---###-----##--------#---------#--#--#---#-
-#---#--#---#-----##-#-#-#---#-#--#--#----#-#--##--#-----#-----#-----##-#---##----#-#---#-#---#----#
-#-#-#-#--#---####----##-##---#-------##--##--#---#----########--#---#---------------#-#-###--##-#--
-#-#---###----#----#---#----#------#-#---#-------#--#---#------#-##-----#--##-##---#--------##-----#
#--#--##-##--#--##-#-#-#-#---#-#--###------#---#-----##-##-##------#---#-------------#-----##-#-----
--#-----#--##--#--#------#----#-#-##------##--#-----#--------#-#------------#---#--#----------#----#
---#------###----#---#---------####----##---#--##------#---#-###-#---#-#--##--#---#----------##----#
##---##----##-####-#-------#---#-#---##-#--###---##--#-####-####-----#-------###------###-##-#--#---
-#----------###--#-##-#--#-------#-----#-#-------#----#-#-#--#-------##----#--#---#--------#-##---##
#--#----##---#-##-#-##------##----##---##---#--#--#--#-##--#######------#------#---#--#---##--------
---####-####-----#-#---#-----------#-##-#-#--#--#----##--#----#----#--#-#--#--#--#-##-----------#---
#-------##---#-------###-##----------#--##------#------##----#----#-#-#---------#--#-##----#--##----
---#-#-#-#-#---#----##-##-----###--#--##-#----#--#---#--#-#---##--#---#----#-#-#-#--------###-------
------#-#----#---#-#--##------####-##-------#---#-------------##-----##-##-##-##--------###---#-----
-#-----##--###------#----###--#----####------##-#---#-#-#---#----#-#--###------##--##-###---##-#----
#-#-#--#--#-------##-----------##---#-#----#----------#--#--------#---#------#--##----------#--#----
--#-#--#-------------#-#---#-#---#--#-###--#-----#---#-----------#----#----###------#---#--#---#-#--
#-#--##-#--#----#---##-------###--#-#-###---#--#----#-----#-----#-#--##-----#--#--------------#-----
-----#---#-##---##-#-----#-##-------------#-##-------#--#--------##------#---#-#-#--#---#------##-#-
#---#-----#-####---#-#-----#---#-###--##--##--#--#-#--#---#--#-----#-##---#-----#--------#-#----#--#
---##-------#--#---#-#--#--#---#-#-#-#-----#--##-#-----##---#-#-------#-#----#-###--##-------#----#-
#--#----#---#----##---#---#--------#-#----#-#---#-#-##---#-#--#-##-----------#--#-#--#-----#--#---#-
#-#-----#---#----------#--###---------#-#-------#---####---#---#--#-###---#---#----#--------------#-
#-------#------#-#--#----------------#------#-----##---#--#---#----#-#-#---#-#-#-##-------#----##-##
----------#-###------#--#-###-#-#-----#---#-#--#-##--##---###--##--#-#-#-#--#-#-#-#----####--#--#---
--#---------#-#-------#----##--#-#-------######-#-#--#---##---#-#-----#-###-##-#-----##-----#-#--#--
---#---#-----#--------#----###-#-------###--#-##--#--##---#--#-#---#--##-#--#---#--###-#-#--#----#--
-----------##----#----#-#-#---#------#-#------#-#--#-##----##---####-----#-#-#--------#-####-#-#-#-#
-#-#---#-#-#-#-#----##--#-----------#--#-------#-#---------#------#---##-##------------#-----------#
--###----#---##-------##---##-#--#-------------#---#---###-----##-#-##---#----#---###---#--#--------
--#--#---#---##-----##-----###---#--#-----#-#-#---#--##-----####-#--####-#-------------------#----#-
--#-#-##-#----##--#-#---#---#--#----#------#--#------#--##-------#----##-----#--###-#---#--------#--
#-#--#-##-#----#--##---#-##-#--#--#------##-----##-#---###---#------##--#-##--##-#--#-#--#---#-#---#
---#--##-#----#-----#---------#-----##---#--------#--#---###--------#--####-----#----#-##-#---------
--##-------#---##-#--#---###-#-#----#------#----#-------##-#-------#-#-##--#--#-###-#--#-##-#-------
-------##---#--##----#--#-#-##-#----#----------#-----##-------------#-#----#-##--#-##-#-#--------#--
#-----##-#--#---##-----####-##---#--#-#-#-----#-#------#---##--##-##-#---#-#----#--#-----##---------
--#-----#----##---#-#--#--#-#---####--------#--#--#--#--#----##-#-----#------##----##----#-##-###---
---###-###-----#---#--####--##--#-#-###----##-##-----#---##------#-----#-#----#--#-##---#-----##---#
-#-#-----#--------#---###----##-#------#--#---#----##--#---#--------###--#--#------------#----------
---###-#----#--##----------#--###--#--#-#------#----#---##-#-##-##---##---##---#--####------#-#----#
--##------###-#--##-#------#----------#---#-#---------#-#-----#-----##---#--#-#--##-----#-###-#----#
#-#--####-##------##-#---#--##---#-#--#---#----#-#--##-##----#----#-#--#-------##--#-#-##----#--#---
---#--#---#--#----#-##---#-#----#-----###---------##--##--#-------------#---#--##--#-#-#---------#--
#---------#--###-##--#-#-------#-#---#------------##-------#---#---#-#---#-----##----##-----##--#--#
#-#-----#-#--##----------------#-#-#--##--#--#---------##----#-#---#-------####----#####--#--######-
#--#-#--#--##---#---##---#-#------#----#--#-#---------####----#------##----#---#--##-#-#-#---#----#-
#-#--------#---##----##-##-#--##-##--#----------#-##---##----#-#------#--#----#-------####-------##-
-#-#-------------------##-#---##-------###-#------#---#-#---###--#----------#-#-#-##---###-#-----#--
-------###---##-----#------##-----------###----#-#------##-#---#---##--#------#------#-###---#------
--##-----###-##-#-#--#-##------#-##----###-#--##--#---###-###-------#--------###-###----#-----#-----
#-#---#-----#-------------#--#-----#####-----#--#-#---#--#----#-----#----#--#-----##-##-------#-#-#-
#---#-#------#---#----#---##-#--#-##-#--#---#-----#-#--#----#-#--###---#---#-#-###--#--------------#
##-#-------#-------#---#-#----#-###-#-----#-----#-#-#--#-#---##--###--#--#------#-###------##----###
--#---#-#---##-#-#-#-------##--#--###-------------#-#-------#--#-#-#--#-----##---##------#-###-#-#--
#---##------#--#--------------#-#----#-#-##-##--##--#---#-----###-#-#-##-##-##-----#-----###--#-----
#------#------------#####-#------#--#------------#-#-#-----#--#-###-##----------#-###----#---#------
-------------------#-#---------##-#-----#--###---------###-#--##---##----------###-#--#----#-#--#-#-
#-#------#--#-#--#-###----#-###-#-#------#-#--#-----##---#-#-------#-----#---##--------#----#-##---#
---##---#-------#--------#------#----#----#------#-##-#---#-#--#----###---#---#-------#-#--#--#---#-
#--###--##-------##--#--#--#-----#------#---#-##-#-----##---#---##----####---#--------#--##-#-#-##--
#-#--#-#----#-------#E-#----#--#---#------#----#-#--#-##---###--#-----#-------##-#-#----###--#-#----
#-##---####--##------##------#-#-###--#-#----#-------##--------###-----#--#-#---#----#--#####----#-#
--#----------#-##----------------#--------###--####----#--#--#-----##---#--#-#----#------###-#--#---
--#--##--#--#-----#----#------##--#--#--#-#-----#-#-#----#---#-#-#------###------#-##-----#---#----#
-#-----#--###-#-----###-----#-#----------#----#----##----#-#--#-##-##-#-#--#-#--#-#---#-##-----#----
------#--##-----#---#-------#-----#-#-#-----#-#-##-#--#-##-#--#-#-#-##--###------##-#---#-------#-##
#----##--#---###-#--#--###---##---------#--##---#--#--#-#---##--##----#-#---------#---#--#----#--##-
-----#-######------#-------#----##--------#--------##----#----#------#-##-----#####-##---##------#--
---##---------###---#-##---#-#--#-####---#-----##----#--#-#--------#---##---#-##------------##-#---#
---#-----#--#-------#-#----#-----#-#--#-###--###-----#--#--##---#---#----##---#------#--##-#-------#
-----------#---##-##-#--#------#----#-#---#-----------###--###--------#----###-----------#--#-----#-
--#--###-#--##---------#--#--##--#----#---------#----#---#---#-##-------###-------##-------##--#----
#--#-#--######--##---#-------###----##----###----#-#----#-----#-#--#-#---#-----#--#----##--#--#---#-
---###-##--#------#--#---##--#-#--##--------------##-#------#--#-----#-----###-#---#-#------##-#----
---###---##----------##--###----#-#-#--#------#--#---##---#-#----#-##--#-#---###-------##----------#
#--#--------#------##-#---------#-----#-##--##--###--###-#---#-#-#-#----##-#----#------------######-
-----#-#-##--#--##--#-#----###--###-#-----#---#---------#-#---#-#---#--#-#-##---#-#----------#-##---
--#--#--------###-#--#--##----#-#--#-------###----##----##-#---#----##-##--##--#-##--#-#-#-#---##--#
-#--#--#-----------#---##-#------------#----#-------#-#--#--------#----#--##-##---#-#-#--#----#-#---
-#-#-#-##--##--#-----#------#-#--#-#-#--#--#--##-##---#--#-##--####-#--#-----##-----------##--#-#--#
-#-----#-#------#-##-----##--###-#---##-#-----#------#--------------##---######--#--#####----#------
--###----#-###-#----------------#----------#--#---#-#------#---##-#---#-##---####--#--#-###-#--#-##-
---##---#---#--##-------#----------#-##---#----------------#-##-----#-----###---##------#--#------#-
-------#---#---#---------#----##----#---#-#-###---#---###--#--##--#-----#---#-##---##---#-#---#-#-##
--#---#-###------#-#---#-#-----#-#-#---------#--#--###--#---#---#-##-------##---#-#--#-----#--##-#--
--#--#--#-----------------#---##-#--##--------#----------###-#---#--#-##--#---#-#-----#---#----#----
#-#--###---#--#-----#-###------#---#-#--#--#-#------#----#-#----------#--###--##-#-#---#--#---#----#
----#-----#-----------#-##----------------##-#--##-------##-------###-#---#---#-------###--#-#------
#------------##-##-#------------#---##-#-##-##-###--##-##-----#------#--#--#----#-----#-##----#-----