?diagonal=Always;
#-#--###-------##-------#-----##-------------#-------#-#-----##-##---##-----------------##-#----#--#
--####---------#-----#-#----##--#-#----##--##--##--#-#--#---#---####-#----#--#-----#-----#--##-#-###
--#-#-##--#--##---#------#-#-------#-##--#---#---###-##----------###-----#----#-########-----#--#---
----###-----------##-#-#----#-#-----##------#--##---#--##--#---#-##--###-##--#-----#---#--#---##-#--
------#-#-------------###-----#----#--#---#-----###-#--#-###---#---#-#--#-#--#-#-------#--##--##----
#-##-#---###---#----#--#--#-------------#----#-##----#---#---##--###-#----##-#-#-#-------#---------#
###-###------###-#--------##--#------#-#----#-#-#-#---##-###----##----#-----##-##--#---####---###---
##---#-#-#-----#--------#---#-------#--#--------#--#--#---##--------#----#-----#------#---#-##--##--
-#-#--#--#----#-#---#-#-#-#--#--#----#---#-#-----#---###--#-#--#----#---##----##-#--#---#--##-#--#-#
#-#-#-------##-#---#---------#---#-------------#-------#--------#--#-#-####-#-#--#-----#-#-----#----
-#####----#-----#-#-------#-#--#---#--#---#-----#-##---------------------##----#---------------#----
-------#--#--------#-###-#--##-##---#-##---##-----------#--#--#----###---#####------#--#-###-#-----#
--##--------#-#-#----##--#-#--#----#----#-#-###-##-------##-----#--#-#-#-######-#----#-----#-----##-
------#-##-#-#-#---#-#-----###-#-----#---##-#--##-#-##-##---#--#-##--#---#-###-#-----#--#--###-----#
---#----##---#--------#-#---#--#-----#---#--------#------#---------#------###-#-----##------#--#-#--
--#---#-----##---------##---#-----#--#-#--------#--#---##-##-#-------#-#-#-#--#---------#-#--#-#----
-----###----#---#-#---------###-#-##---------#-###--#-#----#-#--###--#-#--#------##-#-#--#----#--#--
---#-#-#-#------####-#------###--###----------#-##-----#--##------------#---#--#-#-----##-------#---
-#--#--#--##-#--#-#--#---#-#--#-#-#-------##-----#-###--##---#-----#--#--#--#--###---##---#--#-###--
-#-------#---#-----------------#-#----##---#----##---###--##--#-##-#--##-----#--#--##--##------##---
-####--#---##-------##--##----#----#--#-#-------#---#----#-###--#---#----#---#---------------##-#--#
--##--------#-#---##----##---#--##--#--#---------#------#----#----#--#---#--#---##----#-----#------#
---#--##---#-##---#-----#-----------#-----#---#---##------#---####-----#-##-#-----------#-#---#-#--#
##----#---------###-##----#---##-#----#-#-#--#-----#-#---##---##-------#---##--#-#-------------#---#
-------#----#-#----#-----#-#-#-----#---#-#--#--------##-#----#-###-#-#-#--#--##--#---------------#--
---##-#---#--------------#--#-##-#-#---#---#--##-#--#-----------#-----#-##-#-#-#--##-##--#-#--#-#-#-
---#-##--#--####-------#------#---#------#####-E---###-#---#-#-##---##-####------####------#-------#
#----#--------#---##----#-----#--------#---#-##---#--##--##-#-##---------------##-##---------#------
-----#-##--#-#---##-#------#----#-#------#-#-----#--#----#---##---##-###--------#--####----#--##---#
#------#-#-------#--#------####-#-#-#--##--##---#-----------------#-----#-#-####-#S-##-----#--------
-###--#-##-----#-###--###----#------#---------------#-#####-----#-#----#----#----#---#-#------#----#
##----#--#--------#-----#--##-##------#--##--##-#----#------#----#--##--#---------------#---#-------
--------#--#-##---------##---------#-----##-#-##---#-----#-###---##-#-----####------#--##--##-----#-
##--##-#--#-------#---#-###---#----------##------###---#--#--#----#-----#-#-#------------#--####----
-##---------##---###-------#--##--###----#----#--###-----#--#------#-##-------#-----#------#---#-###
##--------#-###-##----#---#-------#--#--##-#-#--#-----#---##-------#-----------#------##-#-#-#---##-
#---###---#--###-#-#----#-##----#-#-----#----##---#-#-##--#--#----#-#-#--#---#---#-##---##---#####--
-----#--##--##-#--##---#---##---##------#-##-#-##----#-##-----#--#--#---#--#-#-#-#--#---##--------##
#--#-----------#-------#-----##--###-#----#-##--------#--#---#-#---####--#-----------###-----#----##
--#--#-#-#-----#--#------#-#---#-#---##----#-#--#--#----#-----#---####----#------##-#------#-#-##---
---#-------#-----#----##---------####-------#---#--##-#----#--###-##---#-#---#-------------#-#---##-
#------#-#-#--##--#---#-----#--#----------------###-#######---###--#--#--#--##-##-#-##---#--#-###---
#-#----#-#-#---#-#---#----##-#-#-#----------#--#-#----#-----------#-#----##---------###------#------
-----------#-#-###-#---#-##-#---#----#------##-#----#-##--#--#-##----#-------#---#----#--------##---
#-----#-------#-#-#---#-#---#----###--#-#-------#-#--#--#----#--#-#--#--#-#---###-#--------##------#
-##-----#######--#--#----#-#-#--###-#--#-#----#----##----------#-#------##-#--#-----#-#-##--#-#-----
#-#---###-#--#----##-#-#-----##-#---#---#-----#-#------##-##---###---##-#-###-##-----#--#-#----#--#-
---#--#-#---#-#------#----##----#-------##---#-#--#-#-##-------#---###-----#-----#--#--#--##-#-#----
#-------------#---#---#---##-#-#-------#---#----#-----#-------#-#---------#--#------#-#-----#----#-#
---##---#-#---#----#-----#-#----##-#--#----#-#--###------#--###-#---#-------###-#-##--#--#--#------#
-#-##------##-------#------#----#-#-#------#-#--#------##-#---##-#-##----#---#-#----#-#-------#-#---
###-#--###-#-#---#--##-#-#----#------#--#----##----##---##-#------#----#---#--#--###-#--------------
-##-----#------##----#---#------------------#---#-------#-----#-#--#-#----#-#---#--------#-#-##-#---
---#-#-----###---#---##---##--#-#-#--#----#-----------##----#---#--#-###-#---##--#-#---#--#----#----
---##-#--##-#--##---#-##-#---#-#------------#-#---#----#---#--#-#-----###---##-#--##---##---##-##---
#-##-##--##--------#--#------###--##-#-#--##------------#--##-#--------##---#-##-#-#---##-#--#----#-
-#---##----#-#----##--#--#----###-----#--------#-#---#------------##-#----#--#---#--##-#---#-#------
-#--###-----#---##-##---#----##--------##---------#-#--#---#--##----###--#-##-#---#---##-#-#-#--#---
--###-------#-#-#-#-----#--#------#--#-------#-----#----#----------#--##-----#--##-#----##--#--#-##-
----#--#--#-##--------#------#-###------#---#---------##---#####------##--------#-#-----#-##-----##-
------#-#---#--###----##--#-#-------##--------#------------#---##--#------#-#-#--###--##---#-#-#----
-----#-#-----##-#-------#-##-#--##-##-##-----#------#--#---------#------##--#--#---##---##--#-#-----
------##-----##-##---##----#--#-----##-#--#-#-######-----#-------#--##--#-#--#-#-#-#----#---#-------
-------#-#-#--#-------##------#-#------------------#--#-####-#-#####------------#--#---#####-#------
--------#--#--#------##---#--#-#--###-#--#----#--##--#-##-#----#-#---#---#---#----#--#--#------#--#-
-----#-#--#-#--------##----###--#-#---#--##-#----#--#----#-##-##-----##------#------###-#-#----#----
#-#---#-------#-####-#----#-#-##--#-#-#-----#---#--##--##--####-------------#--##--#---#--##-#-#--##
-###---#--#--#---#-#-#------------###---------##-#-##----##-----#-##---#------##---#--##--#-------#-
#####---#--#-----------#----------#-#--#-#----#----####------#---#-#---#---#----#----#--###----#-#--
-###---#--##------##-##-----#--###--#---###----------#-#-#---#----##-#-#--#-#---#-----####----------
#---##--#-#------##-#-#-##----###---#-###--------#-#---#-----#-----#------#-##--#------####-#---#---
---#-#-#-#-#-#-#--#-#-##--##---##------#--##-###-#-###-#--#----##---#-#-##-#-----#--#----#--##-#---#
---###--##---------#-#------###---#--#---##---------#-#------#----##-#-#---------##---##------#----#
--------#-#---##---#--#-------##-###-----------#-#-#---#-#-##-##--###-#---#----####---#-------##---#
-###---#-----#-#---#--##--#---#-----##--#-#####-------#--------#-------#---#--#-#--##--#-----#-#--#-
##---##--------------#----------##----#----------#------#--#---##--------#-----#--###-#--#--#----###
-#---#-#-----#--#----#-##---#---------#-------------###-#--#-#-#-----#-###---##-##-##-------------#-
---###--#---##-##----#-##--##---------##---##---#-##---#-----#-#----#--#-#--#-##-#----##--#--#---#-#
-----------#----#--#-#--------#-#-#-----###--#--#-----#--##--#-----##-#--#----#---------#-----#-----
--##------#---#-----#--###-##-#--#-------#--#-#----#----#--#--#-##-#-------##-#-#-##------#---##-#--
---------#--------##--#-#--#-#-#--#--#-----------#--#-------#----##-#--#-#-#-----#----#--##--#-#--#-
#--#-#--##-----##-#-------#-------#------##------#-#-##-------##--##-#----###---#-----###--#-----#-#
----####----##---#-#--#-##--#---#--#-#--##------#--##---#--###--#---------#-###---#---#----#---###--
----#---#-###--#--#-#-##----------#----##--#-#---#-------#------#-###---##-#------##--#---#---#-----
-##-##---#-###-###-#--#-----#--#--#-#----#---#----#---------------#------#----#--------#--#-------##
--#---##---------#---#-#-----##---------#-#------#-----#-------------------------#--#-#-###-#-#---##
-#----##-#------------###-####-#-#-####-#-##--#---#-----#--#-------#-----#-#--------#-----------#-#-
-----#---#-#---###-----#----##--#--#---#--##--#-#---#----#--------##-##--##---#---------#------##---
------#---#---#--#--#-#----#------#----##-------#-#-----#---#----#-##-#------##-----#-#--#----#--#--
##--#--#---#--##-#---###------#-#---#-----#####--#-#---#-----##-#---#--#-------###--###----#----#-#-
------#----#----#--#-#---#--#----#--------------#--#---#-##---#---###-----##-----##-#-#----##--#-##-
------#------#--##--#-#-#---#---#----#--#---#---#----------#-##-#--#----###-#####---#--##-#---###--#
#-#----##----#--#--##------#-#-#-##-------#------------#--##--###--##---##-#----------##---##---##-#
#----#-##------#-####---#-----#--#---#---#--#-#-------#-------#---#-#--#------#------###-----#-#-#--
------#--#-###-#-#-##------##---------------##--#------------##---#--#-#-#-------------#-------##--#
---#-#------#-#--###-#---------#-##---##---##----------##-----##---#-#-#---#------#-------##-------#
#----#----#--#----#----###-#-----#-#--##-#---##---#-#-#------#-#----##-#--#--#--##----#-----#-##-##-
-----#-------#-#-----#-------#-#--##-#--##-#--#-------####---#-#--#--##--#-#----#-----------#------#
------##--#---#---------##-#----#-#---#-------#--##--#-#----#-#-#----#--#-####---##------#-----#--#-
---#---#-#-----#----#----#--##------#-#--##----#--#-------#-#-------#-##-#----#------#--##--#-------