?diagonal=Always;
--##---#-----#------#-##--#--#--#-#--#--#-----#---#-#----#--##-###-#-#-#---#-#-#---##--####----#####
#--##-##---#------#--#--##------#--#--#--#------##--#-#-#------##----#-----------#-#--------#----##-
-#--------#----------#--#----####-#-------##--#--#----#--##-#----#----#-#----#------------#--#----#-
#--#---------##---#-----#--#---#-###--##-#-#---------#--#--#-----#--#--#-----------#--#------#-#----
----###------####-#--##---#---#---##----------------##----#---##--##----#-----#---##-#---#----#--##-
-##-#-#---#-##----#----##-##-#-##-##-#---------#--#-----#---###--------##-------#--#-#----#-#-#---##
---##----#-----#-###--#-#---#-######-##----###-#-----#--#--------#-#---##-##-#-#-------#--##--#---#-
-----##-#---###----##-#--#---#-#-##--#-#------#--------#-##----##---#----#--#--#---#---------#------
--#---#----------##--------#-----#--##-##-#---------#------###--###-#-#-------##----#------#---###-#
#-#----------####---#--#-------##----------------#-###-#--#-#---##-###-#-###---#------------##-----#
--###-####--#####---#---##-##----#----#--#-------#-------#-#--#----#--##-#---#--#-#-----#----#------
#-#------#-##-##---##-###--###-#-#------#-#--##------#----#------#-#-------#---------#-#------#-----
#-###---#-#---#--#-#---#------#-#---------#------#-------#-#--------#--#-#---#--###-##-#####--#-----
-##--#-##-#--##--#--#-##-##--#-##----#---#-##-----#----##------#------#-#--#--##-#-----#--#--##-##-#
-##-----#-----#-#-##---#------#---#-----#-----####-#-#-------##------##---#-------#---#-----#-------
----------##-#------#---#---#------#-#-#---#----##---##---#---#---#----#-------#----------##--------
--------#----#---#-#-#--###---#---###-----###--#---#-#-#--##----#-##--##----------#----#----##---##-
##---###----###-------#-#-##-#----##--#-####--##----##-#---#----#--#-#-#-#-----#---#-----#--#----#--
#----#-#-#----#----##---#####-------#-##-#--#-#---------------#-#-#------##--##-------###-----#-----
-----#---#-#-##----#---#####-----##----###-----#--------#------##--#------#---------#--#-#-#-#------
-#--##-#----##------#-#-#-#-#--#-------#---#---------##------#-----#--#----#---------##--##--###----
-----##-#---#------#-#--#---#-###-#--#---####-#-#---##-----------#--#------##---#-#-##-----#---#----
---##-#-##--#-#-#--#------#-------#-##------#--####------#---#--#--#-#--#--##----#--###--##-#---#---
##--##--------#--#-#-##---------##----------###------#--#-#-#-#-##----#----#-S###----##---##-##-#---
------##--###-#----#------#--#--#--#-#--#-----#---##------#--#--#---###---##-#-##-#--------####---##
#---#---#----#--#-##------####-----#---#--#----#--#--------#-#--------#-----##-#-----#-#------------
#-----#------#-##--#-#---#----#---#--------#-----------#-##---#-###--#-#-#--#---------##----#---##--
---##---------#--------###--#---##----------##---#-#----#--###-----#--------#----#--#-------###---#-
#-#---##-#------#---#--#-------#-#-#---#-----#-##----##-#----#-#---#-#--#--#----##--------##-----#--
-#--#-##--------##---#---##--##---#####---#-----#-##-------##-#----#-#-------#-#####--#-#-#-###-----
---##-----##--------#----###----#-#--#------##----##--##----#---##-----#-#--#--###-#--------#-#-####
##-----------##--###----#--#-----##--##----##-#----#-----##-----##--##-#-#-#--#---#-----##---##--#-#
#---#-------#---------##-##--#-###----#----#-#--#------#-----#--##-####-----#--#-#----#--#---##--#--
---#-#--#-####--------##-#-#--#-#--##-#----###--------#-##-##--#---------#----#-----------#-##----##
----#-##----#--#-#--#----#---#-#---#--###--#---#-#--#---#--##---------#---#--#--#-#-#--#-----#----#-
###---#----#--#-----#-----##----#-----#--#-E------#--#-----#---##-------##-##-----#--#--#-##-#-#-#--
----#-----###--#--#----#-#-----#-------#-------#----------#-##--#-----###----------#-#-###-#---#---#
-----#--#-----#--##---#----####---#-###-----##-------##----#--#-#--#----#--#-#-#-#-------#----------
##---#---##---#-----##-##-----##----#--##----#--#--------------##----#-------###-###-##-#---#---#---
-##----###-#---#-----#--#---#-#----#--#--#------#####-#---###--##--#---#--------##--#---##---#---#--
-#----#--##--#---#-#-#--#--##-#-##-----#---#---#--###-#-----#-#-#-#-###-##-#-------#-------##---#---
-##-###--#---##---###-------#----#-#---------###--##--#-#-------###------#--####-#---#--#---#-------
----#-#-##--#-##--------####-----##---#-------##---##--#-#-#----#-#---#------------#--#----#--------
--#--------------#--#---#--##-----#-#--##----#---------#-##---##---------#-----------#-----#-#-##-#-
-#--#--------#-----#----#------#####----#--#--###-##-#--#--#------------##-----#--#---#----#--##----
--##-#---##---#--#-------#-#-##--#---------------#-#-----##----#-#-#-#-----#---#----###--#----#--##-
----###---#-###-----#-###-#-##-------#-####---###--#---#-#----##--#------#-#-----####-##-#-##-#--#-#
#---------#-#--#-#-----#--##-#----#-----#-#--#---#-----##---------#--##-##---#-##--#-#-#---#-#---#-#
#----##-----#-----##---#-------#-#--##-#----#-#----------#-#-#-#--#---##--##-#----#-----#---#-#---#-
##----#---##---------------##-#---#---#---#-----###-#--------#--#---#-#----##-------#----#--#------#
---#-----#---------#-#-#-###---#-----#-#-##-----#-#------------#--#-#-#--#-------#--#---#------#----
-##-#-###--------#-#--##-##-#-----#--#--------------#-#--------#-#---####-#--###--#-------###---#---
-#-------##-------#--#---##----#-------##-------------#------#-----###--------#-##--------##------##
##-----##----------#----------#------#----#-#-#----#--#-#-----#-####---#--#-##---##--#--#-#---------
##--#-----#----#-#-#---#-#---#--------#---------#-##---#-----#---###--##-###----#---#----###--------
---------#---#-#-#------#####-------#----#------#-#--#-----#-#-####-#---#--------##-#-##---##--#----
##------#------##-----##--#--------#-#-##-#---##---#--------#--#--#---#-#----#--------------#-------
----------#--#----###-#-##----##-#-#-------#-#--#----#-#---------##-##-#--#-##--#---#---####----###-
----##--##------####-----------#-------##--#--##-###-##---------#-#--#---#--#-#----##--#-#-#--------
-----------#---#--##-------#-#-#-------#-#---###-#--------#--##--##--#--#--#--##--##-------##-####--
--------#----------##--#--##--#-#---#-#----##-###-##---#-##-#---------#---##------####-#-#-#-#---##-
-##--#------#--------##-----#--------#--#-----##---#-------#---------##-##----##-#-#-#---#---#--#---
--##----#-----#--###-------#--##-#-----##----#-----###-##-#-----#-##--#----#----#--#-#-#--#---#----#
----#-#-------##-#---#--#----------#-####-#-#------#-#---#-#-------#------#----##--#--#--###-#--#-##
-#--#-----#--###---##-#----#-#-------#--#--#-----#--#------#-------#-----------#------------##--##--
-#--#---#--#---------#--##-#-#---#--#-------#---#-----#--#-#---#-----#---#----#--######-#---##-----#
------##-----#----##-#-------#--#--#----##---#---##-------#-------#----#-#----#-#-#-#---#-#----#--#-
-----#--##--####-#-#---#-----#--#------##-#----##--#---------##--#--------#-#-#--------#--#--#----#-
-#--#-#####-----#----#----------------#--#--##-#-------#--#-#-#----#--##-###--#-#----#---#-##--#--##
#--------##-#--#---#----#---------#---#--#------##---#-##-------#--##----------#--#-----#---#--##-#-
---#-#--#------##------#-----#--##----------#-#------##-----###------##-#----#-#---#--#--#------#-#-
--##------------###--#--#---#-#-----#--------##-##-##----#-#---#----##-#-------#-----##----#--------
#--#-#-#------#-#---#---##-##--#-#---####--------#----------#--###-#--#---#-------#----#-#---###--##
-##-#-------#-##--####---#-#-----------#-#---------###---##--#--#--##------#--##----#----#---######-
#------#--#--#--------#-##--#---------#-#--##------##-#--#--#-#----##-#-----##----#---#---#-------#-
--##----#--#-#-#-----#-#-#-#--##------#------#------#---#--#---------#--###---####-----#----#-----##
#---#---#-#--#-#-#-----#-#-##--##---#-#--#-#----##-#-#-#---------#---##---------##-#-#--#-----#----#
##--#--###--#--###-#-###---#--#--#--------#-#------#-##--##-#-----#--#-###--###--##---#-----#--#--##
##-----###-##---##--#-------------#------#------#-##--#----##------------#--###--#--##-#--#--###--#-
#-----#-#---##--###-#----##--#-------#-#-----##-------#-------#----#-#--####----#----#----#-#------#
-#-#-------------#-#-------##-#-##---#-#####--##--#----------##----#------####----#--#-##--#-------#
-##------###--#----#####--------#-###---#-##--#-----------#---##-#---##----#---#-#-----#-------###-#
--#-#-#--#--#-#-------#-#--#--------###------#---#-#--#-----##-----#---------##--#--#--#------#---#-
#--#-#####---#----#--#-----##---------#---#-#--#------#--#---#----##---#-#-------#--##---#--#-----##
##-##-#----#--#--##-#----###-----#--#-#---#------------#--------##-----#---#-###--##---#--#-##-##---
#-#-#---#-------#-#-#--###------#--#-#-#-##-####-----###--#------#-#-##----#---####-#-------#-##-#-#
------#-#--#--##-#--#-#--##-#---###---#--#---##---#-##-----#---#-----#----#---##--#-#--##-----###--#
----#---#------##--#-#-#---##-#---#---#--####-#-####----------#-#-----###-----#--#----##-#-####--#-#
-------###----##-##------#----------#--------#---###---##---##-----#--------#--####----------#-----#
---#------#-#----#-#---#--#-#---##-----------------#---#####-#----------#----##--------#--####-##--#
---#---#----#-##-------##------####---------#---#---###---#-#-#-#------##-----##----#--#--#-------#-
-#----#-#-#-------###--##--#--------------#--#--#-----#--##---#-#-#-#-#-----------####-##---#-#----#
-##--##--#-#----#--#-#---------#----#--#----#--#--#--#-#-#-#--####--#-##---------##---##--#--##---#-
#----#--##--#-#-####-----##---#--#----##----#---##---#-#---#####--#-#-#---#--##---#--------#-#-###--
-#---#----##-##--#---#----##--##------##---#---#----#--------#-#----#-##--##-#-----------#----#----#
-#--##---#-##--#--###---------#-------#----#-----###--##--#-##-----#-#-###---##-#---#-----##---#--#-
#---------#-##-----#-----##-#----#-----------#------#-------------####-----#------#------------#----
----###------------------#-----#---#--##-----####---###---#----#-#---#--#----#--#-#-#------#-------#
-#-#--##------#----#--#--#####---#--#-###----#-----#-#-##--###----#-----##---#---##------#---#-#-#--
--#-#-#----#--#------------#---#---------#-#--##-----------#-#--#-##-#-----#------#-----##-------#--