?diagonal=Always;
-##---#----#-----#----#--##--#--#-#--#--#----#---#-#--##-------#----#----###-#-#----#----------##-##
----#---#-#----#-#-##-##-#-###---#-#--#-###---#---#---#-#-##-#-#---#---#---------#--#-----##--#-----
----#-#-#-----#-----------#-#--#--#-----#---#----------##--#----#--###-##--#-----#-#-----##-#-------
#-------#-#--##----###------#---#-#--#-##-##------##----#--###--------##------##-------###-###------
#-#-#---#----##--------#---#--#------#---###---#-------#---#------#-#--##---###--#----##----##---##-
-##--##---#--------#---#-----####----#-###------###---------#---#-#-#---#--#--#-------#-###--#--##--
-#--#--##----#--##-#-##------#-------#---#-##-#-#-#-#-----#------------#-#-----###-#-----#-#--#----#
---#-----#-#--##------#---##---#-##----#-#-------#-----------------#---#-----##----###-#-##--#-#-###
------#--#---##---#--------#---#---#--##-#------------###------##--##-#-##-#--##-##-#--#----####----
--#####-------------###---#-#-#------####-#------#-----###-#---#-##-#-----------------#-#-#---#--#--
--###-##-#--#-#----#--#---#--#----##-------#####--#--#--##-----##-#-#-#--#----#--#------------#-#---
-#--#--#----##----#---#--#--#--###---#----#--##---##---#-##-----#--------#----#--#-####-------#-#--#
--##-#-#------------######---#---------#--------###-#-#--#-----#-----#-#---------#-#-----------#--#-
------#---#---#-------#--#--##-#-#-#--#--#--#---##-#-###--#----------#--#-##--#-#####-##---###--##--
---#--#--#----#---##----#-#-----#----##----#-------####-#-#--#---#--#---------------#-#--#-#--------
-#-###--------#-##------#---#-#-----#-##-#-----##----##----#--#--#----##--#-##---#----###---#----#-#
--#---###----------#--#--#--#----#---#---##-----##--------##--##---###-----##--##-##-#------#---##-#
###-#-----#-#--------------##-#-#--#-------#------#--#--#-#---#--#----#-#-----#---------#--#-#---#-#
#-#---#-#-#---#-#-#-#--###-###-#----##--##-###--#-#--#----#----#---#--##-###--#-###-----#---#-#-####
----------#---###---##------#--#---##---#-#--#----#----#----#----#---###-#--#-#-----#--#-------#-##-
--##-#---#--#--#-##-------#-##-#-----####-#----##--#--#-#--##------#------#-----##--#--##-##---##---
--#--#---#----##-------#----#-------#-----#-----#---#--#-----#---#-----#--#---------##---###--#-----
##----##----#----#-##--###-----#-----#---#-#-#-###-#-#-#---#-#-#--#----#---------#####----#----#----
#-#---#-#-#-#--###-----#---#--#-#-#----##-#----#-#--##-#---#---##----###-###------###-----##--###---
--#---#-##---#--#--##--###---##---##-##---#--#--------##-#------#-#-----#-#--#------#-#------#-#--##
----#-#----------#-#----------#-###-----#-#-------#--------#--###-#-###---#----#--####--#--#--------
-#-----------#----#-----#----#---#---##---#-##------#----#--#----#--##----------------#-#-------##-#
---#-#-----------#----#-####-#-----------#--------#----#-##---------#-----#---##-##---##-#####-##---
-###----#--#-#------#--#-#-------#---#------#--##----#----##--####-#--#-#------##--------#----##-###
-----#----###---------#-#---#-------##-##-----#-#-#--##------####-#-###-------#---------##--#---#---
#-----------##------##---#--#-------#-#-----#-##--------##----##---#--###---#####-----##------#----#
-##-#----#----#--#-----##-----#-----#------------#-----#-#-#-#---##-----#---#--------#------#-----##
--#-----##-#-------#---#--####-#------#-#-#---#--#---###----###-#-#--#----#---##-------###-#-#---##-
#-###----##---##--#----------#-#----#-#--#--##-#------#-#-#---#--------------#--#---#--#----##------
------##---##---##-#--------##---#-----##-----###----#-#--#--#-----#-----##-#-#------#-#------##---#
#----##----###--##--------#-#-----#-#--#-#-##----#-#---##---#-#---#-----#---------##-----#---#------
-----###--#-#-###--#--####-#-------###----##---------------##----##----####---#------#-------##---#-
---#--#-#-#---------#-##-##---#-----#--------#-#-#------#----------##-----###--#-###-#--------------
-##--------------##---#-#--#-------#-#-#---#---#--#---##------#--#---#--#---#-#-#-#------#---#-##---
####-#-#-----#-#---#-#--#--##-##-------##------#--###--------#----#-#------##-##---------#--##------
-#-###-#--#-------##-#----#--##-##-#---#--#----#---#---##------#--#-###-##--#---#-#---#-###---#-#-#-
--#----#-------#-#---#--#------#-------##---###---------#-#-----#--------#---##----#-#-##--#-#--#---
--#---#-##--#--##------#--##--##-#-##--###----#--------#-###-#-#--#-----#---##-#####--##-#-----#----
--#-#--##---##-#---------------##-------##-#-#-#-#---###----#--#-------#--#--##---------#-#--#--#-#-
------#-#---#--#--#---#-------#-#--#-##--#---------#-##--------#-----------#-#-#-------#---##-#-#---
----#-#-###---------#-#---#--#-----#--#---#----#--#-#------#-#------#-#-#--######---#---#-#---##-#--
--#--#--#--#-----#-##-###-#-#-#-#-###--#--#-----#-##-#---#----###-#---#--#--------#--#-#---#-#----#-
##-#----#-####-----###----#---##---#---#-#--#----#--##--------##--###---##----#-#----#--#----#--#--#
-#-#---------#----##--------------#---#-#--#---#----#---#-----#------#----##-#-#--##-#-##-----#----#
---------#--###--#--##-#---#---#--------##-----------#--#----#---#---#-##-----#---##-#-#-##--#------
------##----#-----#-------------####---#-----#-------#-#----#-----------#-------#-#-#---#-#-##------
---------####---#-------#---#---##---#----#-----#---#-#-#----##--###---###---#-#------##--------##--
#--#-#-##-##----------------##-------#----##-#-#----#--#-##---------#------#------#------#-##------#
-##--##--#--#--#-#-----#------##--##---#------------------#---##----###--##--###-----#------###-----
#-----#-##-####-#--#---#-----#--#---##------#----#-##----#-----#-##--#--####-----#-#--#----------#--
-#----####--#-###----#----#-#-#-#--#--------##---#--##-#-##-#--##----#----------#---#--#-#---#------
--#---------###-----#--#------#--#--#-----#-#---##-----##--#----#---#-------####--###---#-#-#---###-
--##--#-----##-----#----#--#-##--##-#-###--##-------#---##---##---#---#----##---##-#-#-#-#-#------#-
---------#-#-------#-#---#-#--#-#-----##--#----##---#-#--#-----#----##-------###----##-##-#-#--#--#-
-#----#-##---##---#-#------##-###----##--------#---##-----##-----#---#-----#--#----#-##-------##-##-
--#--------##-#-#---#-----#-------#-#---##-#-##-##-----#--#--##--------#---#--#---#-#-----#-----#---
##-----------#----#----#--##-#-------#------#---------####---##---#-----#--------#--#---#-#-#-##-##-
##-#-----------#--#---#-##-#-#---#-----#-###-#-#---##---#--##----------------#---------###--##------
--#-------------#S--#-------------#--###-#-------##---##----####------#-----#-#--#--##--#--###------
--#-----#---#--###-#-#--##--##-#----#--------###------------#------#--####---#-#-----#-------#---##-
#-#----#---#-#--#-###--#--------###-#--#--##-#--#------###--#---#---#--#----------#--#--#---###--#--
-##---#-#-#--#---#-------#--#--#--------#-------##--#-#----#-##--------#-#-----#-----#-#-----##-#-#-
--------#---#--###--#---###--##---#-##-------###----###----#-----#--#--#--#---------------#----#--#-
----#--#####-###---------#--###----#------#--#--#-#---#-----#---#-##-----#---#-----#---#------#-#-#-
-##-#--#---------#-#--##--##-----#---##-#--#-##-#---##---##----##--##-#-----##-#-###---------#----#-
---###-#-####-----#--#--#---------------------------###--#-----#--#--##---#-#-------#-#--#-----###-#
---#---#-------#-#--------#---#-#-#-------##---------#------######--#-##-----#-#----##---#----#-----
-###--#-#----------#---#--##-------------#-----###-#-##-#------#----#-----##--#--#----#--#-#-#--#--#
-#E-------##-#--#-----##-----------#---#-------###--###--#---#----##-#-----#--------#------##--#----
---------#-##-#--##--##-##---#-##--#-----##-------###--#--#-#----#-##--#-----#------#--##--#-#--#--#
----#-#-----#---#---##--#--##-----##----------#---#--------------#-#--#---#-#-###---#--#--#---#--#-#
-----#--##--#---#-#-------------#------#-#-#---#------#----#--##--#-#-#-------#-#-#--##--##-#--#-##-
----#-###-#---#-##-###---###-#-------###---#--#---#-#-----#---##--##-#----#-#----#--#-----#----#-#-#
--#---#-#------#--#----#--##-#---##-#--###---#---#-----##--#-##---#--#------#---##-#---#-#---#-----#
----#-#--#-#--##-##--#-----------#-----###----#---#-#---###---#-##--#--##--#-#-##----#----------#-##
--####-##--------#---#-#---#-#--#-------#---------#-------##----##---##---#----##---#----##-#---#-##
-#-##----##--#-#-#-#-##-###-#-----#-#---##---------####-##---#-----###----##-#------------##-##----#
--##------##-#--#-------##--#-##-#---------#-#--###------###--#--------#-#----#-----#---------------
#------##--#--#-#--#-#--------##-##--###-#--#--#-#------#-###---#-##-#---#-----##---#-#--#--#-----#-
---######--#-#--#--#----##--------#----------##-#-------##------#---#----#--#-----#-----#--------##-
###-----##--##--#-#------#--###-----#---------#-#--#-#----#-##-#--------#------##-#-#---#-----##-#--
--#---###---#-##-----#------------#----###-#-------------#-#-----##--#--#--#-#-------#---------#---#
-#------#--#-#------#-#--#----#---#--------#---------#---###------#--#--#--##-------#--##----##-##--
--#----#-#-#-#-#---##-###--##--###--##--##-#---#--#-#--#-------------#-#-----##--##-----------#----#
--##----##--------##-##--#-##-#--#--#-#-###---##----#--#--------#-#-#---------###---##-----##-#-#---
--#--------##-##---#---#----#------#---#--#--#-----###---#--#------##-#---#-##------#-----#-----#-#-
-##-----#-#-------##-##-#--#----##-----------#---#-#-----#-----#----#---#--#---#-##-###-#------##---
#-#------#-#-#-##----------#---###----###--####-##--#---#-#--#--##-------#-#-#-------##--#------#---
-#-##---#-##----#-###-#-##----#-#-#-#---#--#---#----#-#---#-###--###---#--#-------#--#------------#-
#--#----###-#--#--#-----###---##---#-##-##-------#-#-#-#---#---#-######----#-----------#-----#---#--
---#--------##-#---#---#-##--#------#--#--------##----#---####-#-#----#---###-------#-----#---#-#-##
-#----#-#--###---####---#----------#---#---###-#-----#-#----#--#--#--#---#--#-#--------#--#--##----#
##---#-#-#---##-#-##--#-----#--------#-#----#--#---------##---#----#---#---------#-#----##-------#--
---#--##-----##------#--#---#-#-#------#-----##-##----##--#-#--#-----#---##-#----##-#---#-#---#-#-##
-#-------#-----#------##--#------#-#----#-##------------#-------##-----#----#----##--#----#--#------