?diagonal=Always;
----------#--#---#-------###----#---#---------#--#--------#-----#---##-------#-#-#--##-#-----#--#---
-###------######----#--#-#----#-----##--#-##--------#------###-###-#-----##------#--#-#-------##-#--
#--#-##------#---###----##-----#-#----#-#--------#----##-#--#-###-----#--#--#-##----#------#-----#--
-#----#--------###--#-----####-----#---##-#---#-----------#--#---#------##--#--#---#-----#######----
#-#---#---##-----#-#---#---#-#--#-----#-#--#-------#----#--##---##---#--#-#---#--#-------#---##---#-
#---#-----#------#--#--###-----##----#-##---#--#-----########----#------#-##----#------------##-#---
##-#----#------#---------##--#---------##----##---#-##------#-------####-##--#-----#--#--#--#-----##
--#-------###------#--#---#----------#----#-----##-----#-#-----#-#--#------##--------#--#####-----#-
-##----#-#-#-------##-----#---###--#------#-#---##--#--------------#--#-##---------#---#-----#-##-##
-##--#----###-#--------##-#-#-#-#--#-------##--------------#---##-#----#-#-#--#--#-#--#---#-----#---
##--#----##----------##---#--###---#------------------##-###-#-------##---#--#----#-#-#------#----#-
--##-#---##--#---##--#-#--#-------##--#---#-#--#-----#-####-----#---#-#--##------#-##---#--##-##-#--
------#----#-#--#--#-------###--#--#-###--#------##-#---#---#-#---#--------#-------##---#----#---#--
---------#---#-#----#--##----#-#-----#-#-------##-----#--#-##--####-#-#---##--#------#-#--#----#---#
--##----#-#--##--------##-##-----#-#---#--#----####--###---##-#-----#---##--#--##-#--#------###-#---
#-#-----#-#--##--------#--#--#------#-------##-------------------#----#-##-------#---------#---#-#--
-#--#-#----#-####----#---##-------##--#---#-#------#---##--##-----##------#-#--#-----#-####--#-#---#
----#-----------#--#--#-#--#-#-#--#---##------##----#--#----##-#---#####-#----##----#---#----------#
##------##----------#------#-----------#----##------#-##-###--##-#-#----#--#-------#-------------#--
-#--#---#---##-----#-##---#---#-###----#---#--#####-#-##-#----##-##-#-----#--#-#----#-#---##---##---
-#-----##-----###-----#---#-#------#--##--#--#---##-#-----#---##-#-##---#--#---##--#--##-#--#------#
-------------#---#------##-#--#------#----###--#----#------#-#------#--------#----#-----##---#-#----
---#--##-#------#-###--#---#-#-#------##-------#---#####-#-----#---#--#-##----#-#-----###---------#-
---##---##------#---------#-#-#-------#-#---###--#--#-----#---#--#--#---#--#-#-#-#---###--#-##---#--
--#--#----------###--#-#--#-###---#-------#-#--#----#--#-#-----#--#----------#--------#--#------##--
#--#------#-#-----#------#----#-----##------#---#-----------#-#--#--##-#-------#-#----#-#--#---#----
---#--#--#----#-#--#---#--#----#-#-##-##--##-#-###-----#--#---------#-------#-###--#--------##-#-###
---#--#--#-#--##-###----##-##---##------##----#-###---#-#--###-##-##-#-----#---#-#----####--##---#-#
-----#----##--##----#--#----#------##--#--------#--#-#-----##--##----##----#---##--------#-#------#-
-#-##-#--#------#------#----------#--##--#---#----#--#---####--#----#-----#---##---#-#---#-----##-##
------#----#---#---#--##-#--###-#------##-#----#----#---##-----#---#-#---#---#-----##--#-#--------#-
-#####-#-##-#--#----#-###-#-------###-----#--#-#-------#--#---#-----------##--#---------#----##-----
##-#--#-##-##------#--#------#-----#--##-----#####----#----#-----#--#----#----#--##-#-----------##--
---###--#------##----#-####--------#--#--#----------##--#--------#---#-------##-#-----###-##-#--#---
##--##-----#----#--#-#-#-#--#---##-#--##--------#-------##------#-#-------------#-#---#--###-##---#-
-----#-##--------#-##----#-#---#-#-----#---####-----#-#-#--#-##--#-#-#----#--#-#----#-####----#-----
---#--#--##--##----#--------###---##-#---####--#-----##---------###-#-#---#-----#-#---#----#------#-
-#----#----#-##--##------##-----#--#-#----#-##--#--------#-------#-#----#-###-#-----#-#------#-----#
##--##------##------#---#-----#-#-#-#--#-----#---###-#--##-----##-#-#--#-#------##-----##--#-#-#---#
-#---###--#----#--#-#--#------##---------------#--#-##-#---##-#--#---#---#--##---#-#---###----#-----
-#------------##-#--###----#-#---#-##-#--#-#--##---------#-##-##-#---#------#---#-----#-##-#--##----
##--#-#---------#-----#--##-------#--##----#-----#-----##------#----#-#-#--------##-##--###--##-----
--##--#--#-#-------#--------#---#------##-#---##--#-#----#-#--#------####---#-###--###--#--#--#---#-
------#-----#------------#---#----###-----------#-##---##--##-##--#------##--#---##----###--#---##--
-#---##----#---#-####--#-----------#--####--##-##----------#----#--------#--###-#--#---##--#------#-
#----#E--#---#-##-##---#-----#-#-#---###-##---#------##----------#-#------##---##-#---#-##---#--#---
##---#-#-#-#--#--#-###--#-##--##-----#---#-#---###--###-##-#------------#----##------#----#--##--###
#-#--#-###--#---#-#---------##-#-----##----###---#-#---#-----#--#--------##-##--#-##-#--#----#-#--#-
--#------#----------#--###----#------#----##-----#---------#---#-#--##---#-#--#--#---##--#---####---
---##------#-----#-##---##--#-#------#--#-#--##----#-###-#--------##-#----########-#-------##--#--##
--------#-##-#--------------#---#-#-#----#--####--##-##-#---#----------#----#-#---S#--#--------####-
---##-----##--#---#--#-----#-##---###---####-####----#--#----------#----###-##--#--##--#-#-#------#-
#-###-##-----#--##-----#---#--#--##-##-##--#------#-#--##-#---#--#--#---#-#----#---#--#--##-#-####--
-#-#-----#-----#--#--#----##--#-##--#-#--#--####--#--#---##-----#-------------#----#-##---#-----#-#-
####---#---#--##----#-----##--#------##--------#-------#--#---#-#-------##--#-##-----------------##-
#----#-------#----#---##----##--------###-#----#-##--##------#--#---##--#-----#---##---#---#--#-#---
--##--####---#-#-#--#-#---------#----#-#-##--#-#----#-#-#------#-#----#---##-#-##-------------#-#---
----#-#-------#-#-##-------#----#---#----#-#-##-----####--#-##-----#--#-----#---##----#---#-##---###
-#-----##-##--#-#---#---##-----#--#--##-------##-###---#------##-#----#--##-#--------------#-----#-#
----#--#---#--#--#---#-##----#-#---------------##-#--#--##-----#-#--###--#------#-#---------#-------
#-----------#-###--###---------##---##-#---#----#--##----##-#--#---------##---##----#-#---#-----##--
------#-------#------#---###---------#--#-##---#--#----#----#-#-----#---------###-----------#-#-----
#-#-----#-----##---#-------#----#-#------##-#--##----##--#-#---#-----#--#-#-------#---###-----#-#---
#-##-------#----#------###---------##------------##---##-#------#-------------#-#-###---##-----#---#
-#-------##-#--#----#--#--##------#---#-##-#-#--------#-#-----#----#---------###----------##--##--#-
#---##-------#------#-#-----###---------##-##-#----##-##-#-##----###------##-#--#----#-##-------#---
-##----##----##--#--#----#-#-#--#-#----##---#--##--------#-##--#----------#----##-##---#--#---###---
------####---#--#----#-------#----#--##----#-#-#-#---##---#--#---###-#----#---#-----##---##----#-#-#
----------####-#--#-----#-#--##---#-##--##-#-#----#---#--------#--------######----###--#------#-##--
--------#-----#----#----#--#-#---------#-#--##-----##--#-#-------#-#--------------#-##---#-#--##-#--
##---------------#--------#-#--##--------#--#---#--#---------#-#--#-##----#-#---##--#-#---##-------#
---#-#------#--#---------#--#-#-###----#-###-----#--###--#-----#---#---####----#-------#------------
------#-###--#-#----##-##-----------#----#-------#----#-#-#-###-#--#------------#---#---------------
----------####---#-##-##---##--#---###--#-###-----##--#--#-#--------##--#-#-----#--#--#----#-#-----#
###-#--------##-#-##-#--------#----#------#--#-#-#------#---#------#--#------------###--####---#-#--
-----------#--------##----#-#--###---#-#--#-#----###----#---#-#-----#-#------#--#----#-#--#----#-#--
#-----------#-##--#-#-#-#-##-----#----------###-#--##---#---#-##---#-##---#------#----#---#--------#
-#-------##-#--#---------#--#-#----#-#-#----#-#-#-##-###----#--##--##-----#-##------#------##-------
---------#--##----##--#-#--#-##-----------#-----#-#----##------#-#-#--#---##-------#------#---------
----#--#---#-------##-###-------##--#------###-#----#------##-#--###-#-##---#-##----#-##-##--#--#--#
--##------#--#--#--#-##-#---------##----#-#-#-----#--#-##--#---##---##--##-#-#----##-------------#-#
-##-##----##--##-#-----#-##-----#-#--####------#-#----##----#---#--##--##----###-------#---##---##--
#-###-#--####----#---#------##---#-----##------####--------#--#-------#----#-#---##-#---#--##-###--#
#-----####--###---#-------#--------------#-------#-------#-#-#-#-----#--#-##---------##------#--#---
##---##------#----#---#-#--##---#----#-------#-----##----#----#-##--#--------#-#-----#---#--##--####
-#----#---######---#--#---#---#------#--#--#---#----###--#---#-------#-#-------#--------#--##-#-#-#-
##----#------------#----#-#-#####---#-#--####-#----#---#-#--------#----#-----------##---------------
##--#---#-#---####---#-#-#---#--#-------###--###-------#-#-#-------##--##--#--#--###----#--#--##---#
#---------###---#------#--#-------------#----#---##-#--##-----##-#-#--#----#----#--##--#--#------##-
#-#-#-----##-#--#-#--#--#-##-------#---#--#-----#-##-#-----#--##--#-##------##-#-#--#-#--#-##--##---
-#-##-###---#--#-----------##--##-#--#-#--#--####------##-#----#--###--------##----#---------#-##---
-#-##----###-#--#--#-#-####-#-#---#-#--##-#--#--#------##-#-------#-###-----##-#---#----------#-#--#
----###--#--#-###-#------#--#------#--------------#-##--#-#-#---------##--#--#--#--###----##--------
--####--#----###-#----##-#---#-#-----##----------###-#----------#----------------#--#--#------------
-#-#--##----#--#-#------##-------#-#-#--###-----#--#--####-#------#---###--##---#---#-----------###-
#---#-------#------#---#---#----#----#-----####---#------#--#-#-#-----##-#----------#-#-#-#-#-#-##--
#--#--#-#-#----###-------#--#-----#---#------#--##------#-#---#----#---##-#----#--#---##--#----#####
----#---###---#----------#-#-----#-#-----#-----#-----#---------------------##-#--------##-##--#--#-#
---##-#--##-#------##--#----##------##--#-------#-######-##--##------##-----######------#-#-#----##-
-#-##-#---#-###-#-#--#--###----##--------#---##--#------#-------#---#-###--#---#----#--#--##---##---