?diagonal=Always;
#---#-#---#-##---##-------#-#---#--#-----#--#-##-###----#-----######-----#---#-#------#------#-#---#
##-----#-#--#--#----###-#-#--##---##-#-----##----#---#-#---#------------#---###--------##----#-#---#
----##--##------#--#--##-#----#------#-#----#----#----#------#------#--#-#------##--#-#-##---#-#-#--
#--#-##--#-##-------#-----------#--#-#---#--#--#-----#--#--#-------#------------#-----#------#------
---#---#-#----#-#-------#-------##--##---##--------##---#-#-------#-#---#-#-------##-#---#-#--#-##--
-#-----#-#---#-------#--#-#-#----#-----#-------#--##--#---###-#-##-#-##-------#-#-#-#---###----#---#
#-----#-#------#--#---------------#-#-##--##-#---#---##----#--#-#-----#----#----------#-#---#-#--##-
##--###-#-##-#-##---#-##----#---#-#-------#-#-#-##--##--#----#-#-##-----#--------##-----#------#----
----#-#----###-##--###----#-#-##--##--#-#----#-#---#-#--#--#-##------##--#------#-#-#-###-#--#--###-
-#--##-###---#-###----#------#-------#-#--#--------#---#-----#--##--#--#-----##--#---##--#-#-------#
##-#----------#-#---#----#----#---#--#--#-#--#--#--###-#-#---#---#-#-#-#----------#---##---#-#-#---#
#--##---------###-#---##----------#----##--#--#--#-#----#-#--#---#--------#---#-#------####-#--#-##-
--#-##-###--#-##--------#-----#---##-----###-#-#--##-----#---#--#-#-#-##-#-----####-----#---#-#--#-#
--#-#---#---###-----#--#---#-#--#--#-#-----#--###--#--##---#--###-#---#--------###----#-##--##------
--#----------##-#-----####---------------##--#--#-###-#----#-##----#-------##------##-##-##-#-------
----#---------#---#--#-#-#-#---##-------##-#--#--#-#-#------#--#--#---#---#-#-#-#---------##-------#
-##---#---#--##--#-#-#----#---##------##--###-------------#-##---##----###---#--#--#---------#-#----
---#--###--#------####-#-----#----#----###---###--#---#-##-###-##--####-###----------##----#------#-
#-#--##--##------#-#--#-#--#--#-#----#------#-###-----#--#----#--#----------#-----##----#-#----####-
--#-##-----##---#--#--##--###-##---###-#---------#--#---------##--#-##-------#----###------#-#-----#
##----#---#--#----#----#-------------#-------##--###--##--#-#-#--------#--#-----------#--#-#-#---##-
--#--#----#---#-----#---#---#--#--##--#-------#-#----------##-###---#----#----#-#------##-##----#---
--####-#---#-#------#---##---#-----#---##---------#---#-------------#---------#-----#-#----#-#-#----
#-----#---#--#-#-#-#--#-###-#---#-####------#-#-##--#---#--###-------------#----#--##------#-##-----
--#-----###----#-#-------#--##-#----#----####----###------#---###------#--#---#--#----#----##-#--#--
#--##----###-#-----#---###-#--#-#-#-----##--#-#-----#--###---###-###-#--#--#-##--------##--#---#----
---#-------------##--#----------------#####-#--#####-##----#####-----##--#-##---#---#-###------#----
--#-----#-#--#--#----##-----#---#-##----#-#-#-----#-#-------#-----------##--#---------#-----#-----#-
#-#-#-##----##------##-##------#----#----##-----#---#---##----#--#-#--#-----#-#---##--##-#--##-----#
-----#-------#-#---#---##---###--#-----####--------#-----#-----######--#--------#---#---#-#-###--#--
-#--#-----------#---##-#--##----#------#-----#---#--#----#-#---#-#------#---------##------------###-
---#------#--##-----#-#-#--#---###-----##-#--##--##--#-#--#---#---#-----#-####----##---###-#-#-##---
-#-#-----#-#------------#--#-#---#-#----#-#-#------------#----#--#-----#------#--#--------#---#-#---
#-#-#--#--#--#--#----#--#-#--##----#-#-#---#--#--------#---------------#-----#-#------#----#----##--
----#--#------##-----#--##--#-------#--#-----#----#-----##----###-#----#-#--#-#--#####--#-##-#-##---
-##--#--#---------##------#-----###-#-#-----#----#---#-----##-----##--###-----####---#------------#-
##---------#--#-------###-#------##---------##--##--##---##-#---###---##-#--#--#--#--#------##----#-
-------------#-###---#---#--------------#-####---#--#---#---##-#---##---#---#-------#--#----#-#-#---
-------#--#---#----##--------#---##-#--##-###---#-#-#-##-----#--##----##----##---#-##--------#--##-#
#--------###-##---------#---##---###-#---##---#-----#--###----##----##---------#-#--####--###-----#-
--#--#-----##--#----#-----#---------#--#-#---#-#--#--###-----#--###----#------##----##----#---##---#
--##---##--#--###-#---##--##-#--#-#--######-##------#-#-#--##--------#####---###---------####-----#-
-#--------#---#-###----#--#---#--####--#-----#----E-----#-#----#------#---####-#--#----------##-----
-#---#-###--#------#----#----#--#-#----#----#-##--#--------###--#-#-#----##--#---#---#--------#-##--
--##----##--#-----##----#--#---#-##---#--#----#---###-##--------##--#--#--------#-------####---#---#
--##---#--#-------------#-#--##---#-#-##---#--#-#-##------------##--#---#----##-##--#----##---------
-#---#-###-----##----##-#----#---#---##--##-####-#-------##-----#--#---#-#----------#---#-#--#-#---#
--------#----#-##--#-####-#-#----#-#---------------##--#-#-##--#-#----#-----#-------#--##--#-#---#-#
#----#----#-##-#----#-##-#----#------#---#-#-##----###---#-##---#----##---##--#----#------###-------
-###-#-#-###-----##---####---#--##----##-#---------##--#--#--#-#---####--##-------###---#-----------
#-##-----------##-#----##------#-#---#---###--#--#-#--#---#-#-##----#------#--#-#------#--------#-##
#---#--#--#--#-#-----------###--------#----#--###-----#----#-##-----------#-#--#---#------##-#-----#
-----##--#-##--#---#-#-----#-##--#-#-#---#-#--------#---##---#-##--#-#-#-#--------------#--#-####---
#-##----------#--#---#---------------##----##----#-#---#-##--#-###---#---#-#------#----#----#---#---
-##-#-###----###--###-#------###--#----#-----#--#-#####-###-#--#--###--#-------##-##--#-#----##-----
#--#-----#---#---#--#--#-###-##----#---------##--#-#--#--###-----------#-----#--#-#--#-#-#--#---##--
--------#------------#-#---#-#-----#-#---##--------------#-----#---##------#--#---#--------#-----###
-#--##--#-##-##---#-#---#----#--------##----#-#---###----#######-----##--##-#-##-----#---###--###-#-
---------#------#----------#-##-#-------#---#-#-#-#-###-------##-----#-###-#--#-----------#---#----#
------###---##--------#-#-----#------####---#-#---##-#-###--#---#-----#----------#-------#----------
----#------------#-##-#--#--#-----#----#-#--#--#-#-###-----#-##---#-##-###--#-#---##-----#-#--------
--#----#--------##--#-----###-####-----#----------#-------#-------#-#------#-##----#-#--#--#-----#--
-#----##---#----#--#--#----#--#-#----------##----##--#--#---#-#----##----#----#----##--##-------#---
-#-----------#-#-----#--#---------#-----#---#----#----#----#----#--##--##-------#-###-#-#----#---#--
-##----------#-##-------------##-#---#----#-#--##--#-#--#-###-#----------#--#--##-##---#-#------#---
#-##-##--##---#-#---#------------#--#---#--#---------##-----#----#--#-#----#-##----##-----###---#-#-
----#--#--#--#--##----#---#--#-----#-#--#---#---------#--#------#--#-------#-##--#---#-##-##-##-#-##
--#-#--#-##-------#--###----#-------#----#---#-----#-------#---#------------#----------#----#-##----
-#---#-------------------#-##--#--#-#-##--##------#---#-------##---#----#--------#---##--#----#-----
##-#--#---#-#-#-#-------#--#--########-###---#-----#-#-#---#--#-------#--##--#-#-##--##-#-#-##----##
-#----##--#------#---##--##--#-#------#--###--------------#---#-#-------#-###----#-##---##-#---#----
--#####----#---#-#-#---------------##----#--#-------#-----------#----#--#------##--#---##---#-##----
--#-#-#---------------#----##-##--#--##--###---#--###--#------#-----#--#------#--#--------#---------
---#--#-#----##----#-#--#-----##---------------#---##--#---#--##-#-#---------#--#---#-----#--#-#-##-
--##----#-----S-#---###-------#--####-----##-#---#-#-#-#----#---------##-###----#-#-----#---##--#---
----##--#------#-#--#-#---------##------#-#--------------#------#-#--#-#-##-#--------##-#----#----#-
#-###-#-----##-##---#---#------#----##--#-#-----#-###-#---#--#----#-#-#-----##-#-----#-##----#---###
#-------#--------##----#----##--#----#--#--#-----#-----#--#---##-#--#-##-#-#-#-----####---####---#--
-#-#-#----------#---#--#---#---#--##-----#-------#-#--#--#-----###-----------##--#---#--##----##----
#--#--#-----#---#-#---#-------##--##---#-#----------#-#----##-###--#--#---#-#------#----#-#-#--#-#-#
-----#----##--##---#-#---#-#--####-#----#-##----#-#---#----#--#-----###-#-#-#--#-#--#----#-#--#----#
---#---------#--------#-#------#-##--##-#-#-###-#--###--#-----#-##-#----#---------#-#-#--#-------##-
#-####----###--#-------#-##----#-##--##--#---#--#----#--#--------#---#-#--#-#--#--#-----------------
----------#--#---#--------#---#---####---##-#-----#-----##-##-#--###----####-#--#-#----#-----#-#-#-#
-----#--##----####-#-###---##--###-#---#-------#-#-#---##--#-##-#------#-#-----##-##---#------------
--#--#--#-#--#--###-#---#------###-#---#-#----#-#------#--#--------#-----#-#-------#-----#--##-##-#-
-##--#-#-#-###--#----#---#-#----#-#---#------------#----------#--##-#--#-#---##-#--##-----#--------#
-------##--#-----#----#-####-#----------##----#-#-#--###--#------##----#-#---------#---#---#---#-##-
----------#--#----#-##---#-#-#-#----####-#--------#-#----#-#---------#------#--#---#-#--#----#---##-
#---##----#--#--#--#-#--#------##--#-#----#---#-----#---------------#-----#--#---#-#-##-----###-----
-##-----------#-----#-#-##-##--##----########----#---#--#-#-#--#-#-#-#----#------#-------------#--#-
##----#-#--#-##---#--#-#---##----------#------#--##-#-----##---#--#---#---------#----#-#-##---#--##-
-##-#---#----#----#-#--#-#-#---#-----#----##--##-#----##-#--###-####----#-----#-----#-#-----#---#-#-
---#----------#--##------#-------#--#--#--##----#-----##---#--#--------#-#-#-##-----#--#------------
--##-----#-#----#---###-----#-#-----#----#-##----#-#--------#-----#---#-##------#--#------##--#-----
#------###-----#---###----#---##-#------#-###---#----##-#-#-#---#----#----#---#-#----#---#-------#--
----##-####-#-#-#-----#--######-----#----#-----#--#-#---------#---#-##----#---#---###--#-----###-#--
----##--#------#----#--#--------##-###----#-##--####--#-------#-------#---#-#--------#-##-##---###--
----#----##-------###--#---#----##-----#-##---#-----#-#----#---------#---#--#-#-------#-----#-----#-
-###---#---###---#-#-#-####-#-##-#-----##-#-#----------#--##----#-##---#------#---#-#----#----#-##--