?diagonal=Always;
----#-----#--#------###--#-#--------##----#-###---#-#-#-#-----#--#-----#-##--#---#-#--###----#------
-#-------##-#---#--------#--#-#----#-#-#--------#--------#--------##------###-###-#####-#------#--#-
-#-#-##------#---#--##----#--###-###-#-##----##----#-----#---##--#-#-------#--#--#-#---###-#----#--#
-#--#-#----#-#--##-----##------#---##----####--------###--------#-#--#--#---##------#----#-#-#------
--#--#-#-#---#----###-#-#-#------#-#------##-#-#----------#----##--#---#-##---##--------###----#---#
#-------#-#------#-#-##--#-------###----####---##----#-----#-##-##--#------##---#----#-----------###
--#---#-------#-----#------#------#---#----#-#-##-#----#--#-##---##---#--#####-#-#--####-#----##-###
-------#---###-#--##--#---#---#E--##-----#--------#-##----#-----##-#-##------------#-----#--------#-
#--##------##--#--##--##-##-#----#---#---#-##------#---#--#--#-#--#-#---------#---#------#-###--#-#-
--#-#--#--##-----#-#---####-----#-###---#--#--------##-----#---------#-#---#-----##---##---#---#----
#-#---##-----#-####--#----#-#--##-#---#-#--#-#-----#------##----#------------###---#--####-----##---
-#----#-----#-----#--#--##----#-----#-#-#-#---#--#--#---#---##---#-#--------------#-#---#-#-------#-
-###-------#-###-#---#------#-#----#----#---####----#--#-#-##-#--#-----#---#----#--#----###------#-#
##-###-##--#-###---#--##--#--------#-------#--#-#-#--###-#-----##-#-##-#-#----#-#----##-----#-----##
-----####-#--#--#--#-----#-##---#----#----#----##-##--#--------#-#--#-##---------#--##------#----#--
----#-#-----#-##-#--#-----##--------####-#-#-#-#------#-----#-#----#---#--##--#--#----#-----------##
--#--#----------#------#--#--#--#----#-#-##--#-##--#--#-##--##---#---#-------#-------#-#--#--#--##--
---###-#--#----##-#-#--#--#--#-#--###----#-------##------------#---#####--------#-#-------##--#-----
#-----#--#---------#-###---#----#-----#-#-##-####--##-----##------------#--#-##------------##----#--
#--####-##---#--#--#-##---#---#-#----#----#-----###----##-----#--------###-#-#--#--#---###---#-#--##
---#-#---#---###---#-#-#---#----------#-###-----------##--###-#----###--------#--#-#-------------#--
------#----#--#-----####-------#---#---#-##------#-##-#--#--###--#-#-##-----#--#-----##--#----------
##-#--#---#--#----##--##---#-----#---#-------#-----##-##--##-----##--###---#-----##-#-------#----#--
#-#--#------#-------##----###-##----##----------#-----#-#-#-----#--#----##--------#--##---#----##---
#---#--##-------####---------#------###-----#-----#------#----#--#---#----#---##-#-#--#-----------#-
#----#-#-----#-------------#---#---#------#--#--#--------#--#-----#--------------#------###-#-###-#-
##-##-##---#---------##-----#---#--#-#--#-----#---#---#--#---#-------#-----#--#----------#----#-#---
-----#----#---#-##---###---##-----###------#--#-----#------###------##--#-#---###-#---#----#--------
-#----#-##---#--#--###-#----##--#----#------------#-#--------##---#------#----#--#---#--#--##-------
-----#----#---#--#------#----#-------##-#-----#--#--#---------------------#---##---#-##--##-#-----#-
----#--##------#--#-#-#----#------------#--#####-----#-----#--#--##---#-----#-----#------#---#-#--#-
#-#-##--#-#----###---#---##-------#-##-#--##-#--#--#------#--#--#-#------------#-#--#------##----#--
-#-----#---------#-#---##----#----#-----------------------#-##--#---------#--#------##--##-##-#----#
--#---------#-##---#---#----#--#-#-#---#------#---#---#---##-#-##-#--##---####--#-#--#-#-----#----#-
-#-#-----##--#----####-----------#-##----#------##---#-###-#---#----###--#-#----#-#-#---------###-#-
--#--##-#----##--#---#-###-##-##----#--#-----#----#---##--##------#-#---#-----##-#----#-#----------#
----#-#-#---#--#------##----#-#--------#-####------###-###--#---##-##-#-----####--#-###---#--##-----
-------##-----##-#--#--#------###--#-##----##------#--##--#---#-####-#---#---#------#--#--##--#-##-#
--------#-----#-#--#--#--###-##------#---------#---#--#-#---#-----#--#-##---------#--##-#--##-#-#--#
##----#---#-##---#-----------#-----###--#----###---#-----#-#----#-###---#----#--#----#---###---#-#--
#-----#-###---#-----##--####---#--#--#---#----#--##----------##--#-#--#--#--#--#-###-#---#-#----#--#
-----#-#--#--#--#---##--#-#---##---##---#-#---##---#----#--------#--###-##------#-#--#--#--#--##--#-
-##---------#-#---##-#---#--####--##--#--#-#-#--#-#-------#----#-----##----#----##--#-#---#--##-##--
---##-#-#-##-#-#---#-#-----------#-#---##--#-#-#-------#-#----#----####---###-#---##----##---##-##--
-----#--#-##-------#-#---#---###------#---#-#--#----#----------#--#---#---#--##---##---##-----#----#
#--#--##-#----#----#------#------#--#---##--#----##---##-##-#---------#--#---#--##----#----#-##-##--
--#-#----###-------#-#-----#----#--##----##-----#######--#--------##-#----#-----#----##-#---#-#--#--
--------###-##--#-###-----#--#-------#-#--##-###--------#----#--#---------#--##-----#--##-------##--
-------##--#--#---##-#----###-----#-#---------#---#------####--------#-#-#----------#--#--#--#----#-
------#---##--#--#--#-##-###---#-#-------#-----#----#--#-###----#---##-#-##-##-#----##-##---##-#----
--##----#------#---#-#-----#-----#---#---#---#-#-#-#-------#------------#-#---#---#-#-----##--#--#-#
#-----###---#---###-#-------#----#-#--#---#--#--#-#------#-##----#--##--#-###-#-#----#---#S#---#-#--
-###-#--#---#--#------#-#-####-#--###--#####--#----#-##-#------#----------------#------#-##-#--#-#--
--#-#--###-----#--###-----#---#----#---###--#--#--#-------#-###---------------#--#----#-#--#-----#--
#-#--#----##-#-#------#--##-#--#-#-#----#--#----------###-#-----#-#-----#--#---#-#---#--#-#--#--#---
#-#-#------#---#--####-#-----##-----------#---#--#----##------##---#-#-####-#--#---##---------##----
--##-----###--##--#-#--##--##-#--##----###-#---##---##-#---#----#----###-----#----#-----#--#--###--#
------------#-###---#-----##-#-#-##------#--##----------#---##-#-------------#---#-----#-##----##---
###--------#------#--###--###---#--#---###--##--#-------#-##-#-##-----##-#-----------###----###---#-
--#---#---#-#-##-#-----#---###-##-##---#--#------------#---#----###---#-##-#------#-----#---#-#--#--
-----------##--##--#----##-#---#------#----#--#------##--#---#-----##----------#-------#-----#--###-
-#-----#-#-------##--#-#-#--###-#---#---#-----------#--#-#---------##----##-------------#-----##----
-------##-##----#-#--------#--#-------#------#-------------#--#---------#######---#--##----#--#-#--#
--####-#--#----#----#-----#######---###--##--#---##-#-#---#####--#-----#-#-#------------##-----##-#-
---#------#----#--#-#-#--###------#--#-----#----##-------#---#--------##-##-------------##---#---##-
------##---#--####-##----##----#--------##-###--###--#------##----#---#--------#--####---#-#-------#
------#-----#------------#---#-#--#--##--#-#-###-#---##---------#-#-----#-----------#---#------#-#-#
-##-##-##-#---##---###-------#-#--------#-##--##----#-##--#-#------#---#---##---------#----#-------#
#-#--##---###----------#-#-#-#---#--#------#-#--#--##-#--#----#-----#--##----------------------##--#
---##--#---#------##---#----#-###-#----##-#--------------#--#--#---------#----#-#---#---#-----##---#
--#-#---#####-#--------##---###---#---------#------#-##---#-##--#------###--#---#--#-##--#--#----#--
---------------#-#--##-#------##--#--##-###-#-#---#----#--##---------------#---#-#-#----#--##-#----#
#-----------###----#-##--#---#-#-#-------#------#----#-#------#-#-##-#----------#----#---#--------#-
--#--#-###-#-#--#-#---#----##--##------------#-#-#-------#-##----##-------#---#------##--#---#--##--
--#--#-#-#---#-#--#----#-#--------#----------##------#-#-##------#--#-#-##---#----------##----##----
#-----#------###--#-----##-----#---------------#------#----#-----#------##---#---#---#--#-----#-----
-##-------#-------#-----#-#-------#--##-#-----#----##----#--#-----------------#-##-#--------##---#--
-------------##------#----------####-#--#--###-----#-------#--#------#------#-------#---#--#--######
##---##---#-#-###-----#--------#----#--#----#----#----------###-#--#-##-###----------#--#--#--------
----#-#-#-----#--#---------####-----##------##-#-#-#--#--------##--#-#--#---####---##------#--#-####
#---#-#-------#--####----##---#----#---#---#---#-----##--#----#---##---#-#--####-------##---#------#
-####-#---#--------#-#----#----###---#-#----##-----#--#---------#--###------###--#---#------###-----
#-##-#---#----------##-------#-----#---##-#-#-####----#--#--#--#------------#--##-#---##-----#------
#---#-#---#------##-#---#-------------#--#-##-#--#-------#------#--#-#--##-#--#--#------##--##-----#
#-----#-##-##---#-------##---#--#--#-------###-#---#-----#-------------#-#---#---##-#--###--#--#--#-
-#--#------#--#----##-#-------#-----##----#-#----#-------##-#--------#-####-#---#-#--##--#-#---#-#--
-#---#--#-##--##-#--------#------------###--#--#-##--#-----##---####-#-#-####--#-#--#-#-#-#-###-#---
##-#-#-#----#--#--##-#-#-#-##-#--#-##-----#####--###-----#------#-##-#---#--#--#-#-##-#----##--##-#-
-----##--#--#----#----###-#-##-#--#-#--##-------##---#-##-###-#-------#--#-#-#-#--#-------###--#-#--
#---#-##--###--#-------###-------#--##-#---#--#---------###---###--------------#-###-#--------------
-----#-#-----#-##----#--##----#----#-##------#------#--#-#--#---#-#---#-----#-#-#--##-##-----#--#--#
#-#-#---#-#-------##--##--#------#--#-----#---#-#---##---------###----#-#----##-#-#------------#---#
##--#--#-#-#--##--##-##---##---#---#-###--#-#-#---##--##-#---#-#-#--------#-------##-------#-###----
#----#--###-#----#---------##-------#---------#--#--#---##-#--##--#--#-#####---####--#-#--##-------#
#----#------#-#------#----#-###-------#-#---#-#-----#-#----#-----#-----#---#-----#--#-#------#------
----###--#-----##-----##-#-#-#---##----------#-#-#-#--------#-###--###--#----#-#------#--#---#---#--
--#-##----#--#-----##---#--------------#-#-#------##---#----#---#------#-#--#----#----#---###-----#-
-----#-###-----##---##------###-#--#--##-#-----#-------#-##----#####----#---#-##------#--#-#--##---#
-----#-#-#-----#--#-----###-#-#-----##----#---#---#-----###----#----###-----#---#-------#-#-#---#---
------##-##-#--#----#----------##-#--#-#--##---##--#----#------#----#-#--#--#-#---#-#-#-#-##---##-#-