?diagonal=Always;
--------#-#-#-##--#--##----#-#-----##------##--------------------##-#-----##-#-#-##--##---#---#-----
-#-------#------#--#-----------###---####-----#-##------##-------------#-------##----##--#-##--##---
##--#-----#-----##-------#----###------#---------##-#-----#-##-#---#-------##------#-#-#---#----#---
--#------------#------#-----#----##-#-##-----####-#----#------##-###----#----------#-----------#----
-------#-##--#--#------------#---###--------#--#---#--###--#--#-------#-#-##---------------#--###--#
-----------#-------#--##-#---#-###------####--#------------#-#----###--#--#-##---##-----#---#-------
---##----###--------#---#---------#-#-##--#----#-#-#---###--#-------#---#-#--#--#--#--#-#--#-#--#---
--#----#-##--#-------####-##-------#-#--------#--##-##-##--###----------#---###------#--#-----------
##--#-#--#-#-#--#--#-#-#--#----#-#----##--#-#------###------------##-###---###-#-#-----#--#-#------#
#-#--#--#----#--------###---##---#-#---#----###-------#-#-----#-#-#---#---#--#-#-#-##---##--#---###-
#--##---#--#-##-##----#--##-------##--#-#-#------##----------#--#-#-#-#-------#-###--------#----##--
#----##----###---#---##--#---#-#----####---#####-####------##--##---------#-----#-----#-###------#--
------#--#--##-------#-#-----#-#-------#--#---#--#----#----##-----#-----#------##-#---##----#-###--#
----------##----#----##-#-#-##---#-##------#-#-#---#-------#---------#-##-----#------------------#--
--###-#-#---#------#--#-------##-----##-#----#-----------#-#-#----##---#--#-####--#--##-##-###--#---
--#--#---#---------##-##---#----------#--##--##---#-----#---###---##--#-##-------#-#-#---#--#------#
--#---#---#----------#-----------------#----##-#-#--#--#--##--#------#-#-#----------#---#--#--------
#--##--#--#---#--###--#---#---#---#-----#-----#-----#-#--#--#-----#----###-#-#--#-#-#----#--#-#-#-#-
------#-#--##-###--#---#-#-#-#-#-----##--#-----##-##-#-#---#--##-#-#-#--#----------####--#---#----#-
-#-#-#-#-----##----#----#--#----#--#------------------#-#-##----------##-----#------###-##--#--##-##
-#--#-#---#----#----#-----###-###--------####-##-#--##--##-----#-----##--------#-###---------#######
-----------#---#-------######---##------##------------------#--#-#-###----------#-----##--#---#-##--
-----#---------#-----###---##----#--##--#---#--#--#---###--#--------##-#---#---#-##--#--##------#-##
#-#------------#####----------##----##-#--#--#--#--###-----###------#-#-----#---#-#-------###--#---#
#-#-#-#------#-#--------#---#-##-#-#----###-##--#--#-##---#-------#-##-#--##-----------###----#-##--
--#-#--#-#---#-#-##--#-----##--####----#-#--#--#-#-###---#####------#-#---##---#-#---#-#-#--##----#-
-##--#-###-#-#-------#---------#-#--#---#-------##-#--#---##---##-##-###-#--#-#-#--#------#-#-##--#-
##---#--##-#-#--#-#-------#-----#----#-#---#----##-#-------##---###---###-#------###-#-###----#-#-#-
--------#-###---##-#-------##--###-#---------##--#--###----#---#---#-#-#---------#--#-----##--------
-#---##----#-----##--#-##------------------#---####-----#----##--##---#--##-###----#--##-##--#--##--
-------##-#--#--##--#-##--#--#------#--------####--#-#-#---##----#--#-##-------####-----#---#-#----#
#---#-#-#------#-###-----#-##-----#---###-#-#-#--#-#-#----##-------#--##--#--##----#-#-##-E#--#---#-
----#---------##--#---##-#####-#-----#---#-----###-------##--##-#-###---##-#---##-#---#----#--#--#--
-#---------###----#---#-#-#-#---#----#-##-#---##-##-#--##-#---#---#-#--#-##-----##-##-#---#---#--#--
##-----##-#------#----##---#--#---#-#-#-#-##-----------#-#----####---#---##-----#-----#---#------#-#
--#---#--#---#-------##----##--#-##-------#--#---###-#-#-----------###-#------###-----#----#-------#
-#-----#----#--#---##----#---#--#---#---#--#-----#---#-###----#----------#-#-----##-###-----------#-
----#-------###--------#-----#---------###--#----------#--##-##---#-#---####-#--#--#-#----#--#-#----
--#-#--#-#--##--#--#----#-#-##---#----#-#--#----#---#---#--------###----#-#S---#--#-###---#---------
--#-#----##--##------#-----#-##---#------###-#----#--------##---#-------#--#----------##--####---#--
-##-----#----#-#---#-#--#-##---#--#-#--#---##--#------#-------#-------###---#-##--#---#---#--------#
-#-##-###-#----------#-#--#-#-#-------#---#-###-#----#-###---###-#--###-----#---#-###------#-----#--
--#-#-##-#---#---#------#-------#-----##----##-#-##-#-#--------#--###--------#--#--#---#-##--------#
#---------#--#-#-------------#-#--------#-------#----#-----#--------#-#-#-#--#-#----####-##------#-#
-#-----------#---#----#--------#--#----###----#-##--#####-##------#-##-----#-##--#-#-------#----##--
--#----#---#--#--##-##-###------##------#------#--#-#-#-##--#-#-----##-----##-#--#------##----#--###
--#---#-#----#------------##--#--#---#-#--#####-----------------##--#------#--------#-----#--#--#-#-
----#--##---#------####-#--#-##------#-#-#----------#-#--#---####----#---#-#-#---###-#-#-----------#
--#--####-#---#-------##-#########---#-------#--#---#--###-----#-#----##------------##-#-###-#----#-
--#-#-#-------###-#--#--#----##-----------#--#---------#-#-##------#----###---#--#--##-------#---##-
-----#-----#-------------#-----#-------------#-----#-#-#-#----#---#----##--#-------##---#---------##
#------#--#------##--#---##----#-----##------#-#----##----#----#-#----##-#------##----------#---#---
#------##----#--####-##--------#-##-#--#-----#--------##---#--#-----#----##--------#-###-#---#------
----#-----#-#--#-#-----#--##-#------------#-------#--#-#--##--#-----#--------#--#---------###-------
-----###----#----#-----#-#---------#-------#-----#-----#---##--#-#-------##-#--#-##--#-##--##-#-#---
#--##--#---#-#-#----#-----##---#-----###--#--#--#--#####----#---------#-#----#-#-----------#-##-##-#
#--#--#-#----#------#-#--##-#-----#--#--------#-##-#-##-----#--#-#-#--#-#--##--#--##----#----#----#-
--##-#---#-#-#-#--------##-##------------#-----------###-#--#-----##-----#------#-------#---#-#-----
----#--#---#---##----#-##--####-#--#-#----#-#--##--#---#------#---#--#--#-##-#--#---#----#-------#--
#-#-#------#--#------#----#--###--###-----######--#-##----#-#-------------#----#-----#---#--#-##-#--
-#----#-#-#---#--#-#---#--#--##-###------#-#--##--##-##---#-#---------####--#---#--#-----#-#------##
------#---##--#--#---#-#-------###----#--#----##----###-#-##--#-----#----#-----#-----------#--###--#
#-#--------#--#--#--##-#------##-#--#####-#--##-----##---##-----#---#-----#--------#---##--##--#-#-#
-#-#--#----#-------#-#-#--##-----##----##------##-------------##---------##------#------------------
#--#-#-#---#-#----#-####-----#-#--##--##-###--#--#---#--#----##------------#-#-##------#--#--------#
--##-##-#----------#---##-#--#-#-----#----------##---#-###-#----##----###-----------##-#-----#-----#
--#--#---#----------##--###---##----#-------##--#---#--#-#---#---#---#----#-##--#-###-##-###----#-#-
--###--####-#---#-##---#---------------#-------#-------##-#--#-------####---####--#-----#--#--#---#-
#-#-#---#--#--#--#--#-#---#--##-#-##------##--#-##----##--#---##--------#-------##-#----#---#--#----
#-##------##-----#-#-#--#----#----#-----------#-#-#--------##--#---##----#---###----#-#--##------###
-##--#----------------#--#---#-###-#--#---------#-#-##--#-#----####--#------#--#-#--#-##----#--#----
--#----#---##---##----#----#-#-----------------##-----#--##-#---#--##-####------#---#-------#---#--#
--#-#---##--#--##-#---#--#-##-----#--#--#--#-----#-#-#---#--#-#-#-#---#--#----##-#----#-----#-#--#--
#--#--#-#----#----###-----#-#-----##-#-#------------#---#----#-#------------#----------#------##----
-#--#---#-##---##--------#-#----##-----#-###---#--#----##--------#-#-#---#--#-##-----##---#-###-----
----#--------#--#-#---#--------------##----#-#---#----#-----------#-#--#--###-#-----####--#--#---##-
------##---##------------###--##--------------#--#-#-#----###---------------#-##---#-#--###-----#---
-#-#--#--#-------------------#--#--------#-------##-#------#----#----##--##-##--------------#---#---
-----#-#-------#--#-#---#----#-##-----------#-------#-------#-#-----####---##--#-#-###------##------
--##-#-##--#--###-###-#-#--#-#----#------#---#-#-#---#--#-#-###--------#--#----------#----#--#------
---#-----#-##---#--##-----#------#---##-----#--------#---------##--#----#---------##-##----#-----##-
###-####--#---#--#------#--###--------##--##-#-##--####-#-#-###--##-----#--##---###------------#-#-#
-#---##--#---#--#----###-#-##---------##-##-###-#-#----#-#-----#-#---##---#--#------#------#-#--#-##
---##--#----##--##--#-#--------------#-##---##-#-#-##--#----##-#-#-#----------##---#-##--#-----##--#
--##-----#---------###--##--#---##----#---#-----#------------#--##-#-----####-----#-----------------
#--#------#------#-#-----#----#-------#--#-#--#-----#--#-###-#-----#-#-----#-----#----##----#-#----#
-###--------#--#-#---####-#--------#---#-#---#------#-#-----##-#----##-####--#--##-#----#----###---#
--#-###---#-----##--#--------###--###-#---#--#-###---#-#-##-#--------#---##----######---------------
---#----##--#-------##----#-#---#-#--#--###----#---#-##-#----#-#---------#--#--#-##---#-#-------#---
#--#------------------#-##--#####---##--#-###-#-#-------#---##-----#--#--#-#--#-------#-------------
-###--##--#------#---#-#-#-##--##------#---#-----###------#---#--#---#-#-##--#----#-----###--#-#----
--#-#---------#------#---#-----#--##---#-------#-##---##-#------------####-----#--#-----#--#-##-##--
----####--#-------##-----#-#-###-#--------#-####--------#---#--------##-##---#--#---##--------##----
--###---#------#-#------##---#---#--#----#---#--#----#----##--#-#-##--##-####-#-----#----###--#-#--#
-###--#-#----##--#-##-#-#--#-#--#---#-#-##-###------####---##-#--------------#-#---###--#----#-#----
--------###--#--#-#---###-----#--#-##--#-##------#-##------#--#--#-------#--#----####--#--#-#---##--
---#-#-------#----#----#-#-#---#-######-#---#---#---#----#---------#---##---------#--##---#--#-#---#
##----------#-#---##-#------------#-##--##---#-------##--#---#-#-#---#-#-#---##----#---#-#----#-----
#-----##-#--##-----#-#---##---##------#----#----#--#-#-----#---##--##--------#---#-------#--#-###-#-
#-----#-#----###---#----#---#--###--#-#-##--#--#-#-##-----#-#----#---#----##--#-------##--------#-#-