?diagonal=Always;
#---#---------#-#------#----#-------------#-###-##--#--S#-####---------#------#-##---##-----#---##--
--##----###-####---#------#---#----#-----#--#-#--#------#-#-##----#----#---#-----#--####--#-#-----#-
-#-----#---#--####--#--#-#---#-----#--#--##--#-#####----#--------#-#-#-----##------#---##-------##-#
#-------#----------#--##--#-------#------###---#-##--#--#-----#---##--##-#-----------#----#-----#---
-------#####-----------##---#---#-#-#---##--#-##--#--#--#----#--#----#--#----##---------------------
---#-#-##-#-##-#-###--#--#-----##------#-#-----#----#--#---------##------#---#-##-----#-#-#-##-##-#-
----#---##----#----#-#----#----##------#--#---##----#--------##-----#-##--##--##----#-#--#--#--####-
----------##---#-##-#------##---##--#-##---##----------#--##-----##-###-#-----###--#------#------#--
--##---##-----------------#-###-----###-##-##--------#--------#-#-----#----#-----##---#----#---#-#--
-#--#---#--##-#--#---#-#-#--##-----#-----##-----#-#-#--#-#---#------##----#---##---#-#-#-###-#--###-
#---#----##-#----#-#-##-#------##----##----#-#----#-###---#--##-####---##-##----#-#--------------###
--#----#--##-#-----------#-----------###---##-###-#---#---#-###---##----------#-#--#--##------#----#
#--#-#--##---##--#--#-##-##--#-##---###---##------##----#--#--#-------#-#---#---#-#-#------###-#----
-------------#----#--##-#--#--##--#-#---##--------##----#----------#-#------#--#--#----------##-#---
#---###--#-------###-##---##-##-#---#----##-------#-##-#---##--#-----####-#-#-#-#-#-#----#-----#---#
--##---##----#---#---#---#---##--#------#----##-#-##----#-#-----#------#-##---#--#-##-----##---#----
----#-#-#-##---##--##------###------#-#---#--###-------#---#--#----#---#--#--##--#-#---#--#---#----#
-#------#--#--#--#-------##----#----#----------#-#---##--##-###---#--#--###--##----##-##-------###-#
##-----#-##-----#--#------#--###------##-#--#----###--------#--#-#---#----##-#----##--------#-###-##
#----###----####-#--#-#----##---#-#####---##--#-#-##---#--#-##--#---#------##------##--#-##--#-##---
##--#--#------##---#-#----#-----#--#---#-------#-#------###-##----##-###-#--#---#-#--#-#-------#----
---------#---#-------##--##-------##----##------##---##---------------#----#--#--#----------##-#----
##---#---#--#------#-----#-------#-#---###---#-#-#--#----#----#-----##--#-#---#----#-##--#-----#----
#-#--##---##---#--#-#-#---------##--#----#-#---#--#----#--##----#-###--###------##-----#------###--#
-##---#-####-----#-#---#-----#-#---##-------#--#-----#---##--#--#-----###---#####---##--#--#----#--#
---------#-##------##--##-##-#---#----#------------###-#---#-##-----##--##---#---------#------------
---#-###-#-###--------------##------#---#-#---------#----#----#-##-#--#------------------#-##--#-###
---------##----#-##-#-##-##-#####--#-#-----###-###------##---#---####----#----#--#------#----#---#--
#---#----#------#----##--------###-#----------#--#--#---#-#-#---#-#--##---#----###-#---##-#--#-#-#--
#-#--#---#--#-#-#-#----#--#-###-#--#---#-##---##---#-#-#-----#-#-#-#----#----#-------#--####----#-#-
-#--##--#--#---------##-----##--###-#------#-#--------#---#-#-#--####-#--##-#-###------#----#---#---
--#-#-#---#-###-###--#----#-##----##---------#---##-#---#---##--#-#----#--#-----#-#----#-#-------##-
----#--##-#-#-#----------#-#-----#--#------#-#---#----##--#--####-#-#--#--------#----#-#-#--##-#-#--
-#----#--------#---#------#--#--##---#-#---#---#-----#---------##--##----#-----------#--##---------#
------#---#--#--###---#---------#---------##-------##--------##-#-#------#---#-#---##-##---#-#-#---#
-##----#----#---#--#------#---#-###-#-----##----#---###--#------------------###---#----##---#-------
----#--####--##------#-#---#--#--#---#-------##----------##-##---#---------##-#-----#---------#--#--
------#-#--##---#-##--------##---#--##---#-----#-#---#------###-##---#----#---##---#--#--##---#--#--
--###-----##------#-###---##-----#--#-#---------##--#--#--#-#-##-----------#-###----#-#--#--#----###
--------#--##-#-#----#------#-#-####-----##---#--##-##---#---##-------#-#---##-###-#--##--#--#----#-
--#--#----#-###-----##-##------#--------#-#---#--##-##----------#----#-------##------###--#----#-##-
--#---##-#---#--###--#-----#------#-----##------#--#-#--#-----##--#---#-------#-##--#-#-------------
#--#--##-----#--#----##-####--##-#-----------------------##--#--###-------##--#-------------###-#--#
##----#-------#-#-#----#-##-#-#-----##----#----#--##---#---#-#-#-#---#---##--------#-----#----#--#--
---#-#---#----#-#-----#----#####-#-------#-##-#-----#----#--#-#------#-#----##-#----------#--#----##
--##--#----###-------#-#--------#------#----------#-------#-#------#---#---###-----###-------------#
---#-##-#--------#-----##--#----###--#------##---###----##--##-----#------#-#--------#-#-#-----##-##
#--#---#---##--#-#-##---#------###---#------#---#---###-#----#-###---##------------------#---##--##-
-------#---#--##----##--#---#-##-----#------------###----#-##--------#-#-##----#--#--#-#-##-----#---
--###----###-------------#####------------#--#-##-#-#------##-##--#-#-#---#-##--------#-#-#----#--##
--##-----#--#--#---#-----#-#-------#----##------##---#------#-------#----#-#-------#----------------
#-#-#---####-#-#---#--#-#----#--#-##-##--#--#------##-----#-#--##-#--------#----##----#---#-----#---
-------#-#----#-----#####-#-#-####-##---#--###-#------#----##-#---#------##----##-##----#-#-#---#-#-
---#-----####--#----#-#-###-#-#----###--##--#--#----#--##--#--##-#-###--##-#-#-###-#-----##-----##--
-#---##-----#-----#-##------#----#---#-----###-----##----#--#---#-##-#--------##--##-#---##-#----##-
----#-##-#----#----#----#---##--##-#--#--###----------#------#-#-#--#------#-#---##----##----##-----
----#-#-------#-#-#-##-##----##------#---##-#----##--#--#--###---###----#-#---#--#--#-##--#--#-----#
---------#####-----#---#-----#-#-##--#-----#-#---------#--###------#----#---#---#-#---------#-------
----#------#-#-#------#---#---##-----##-#---#-------##--#----#----#-#--#-#-#--#-------##----------#-
#-##--#------#######--#---#----##-#----#---#-------##-------#-----#----#-#-#------#--------#-#-#--#-
-#-#-#----------------##---------##------------##--------#---#-##-##---#--#-###-#-----##-#-#---##---
##------#-##-#---##--#-#-#--#---#--###-#---#-----#----#--------#----#-------#-##---#-###---###-#----
--#-#---#--#-------#--#-###--#-##--##------#--#----####--#---####-#-----#---#-#---#-###-----#-------
#-#-#---#--#------#---------#------#-#--##-#---#-##--##--#------#--------###-###--#-#-----#---#--#-#
----#--#-###-##--#-##--#-----#------#-----##----#-----#-----##----#-#-#---------#-##--#-----#--##---
#-#--##------#-#-------##--#----#---#-##----###---#-------#--#---#------#-##-#-##-----#---#--##-##--
##----#-----#-##---#---#-#-----##----------#-#--###-----###---------#-----#------#---##----#--#--##-
-------#-#-##-#---##-----#---#-#-#---#----#----#-##-#-----#----#--##--#--#----------#-#----#-##---#-
#--#--#-#-----#--#--#--#--#--#-#-----#--#---##---#--#---#-#----#----#--##------------##--##--#-----#
----##-#----#-#-----#---##--##--#-#--##-#---#--#-##-----#-##-#-------#-#-#--#-#----#---#-##---###---
-#---------#--#---#--#----##---#----#----#-----#--####-----#-##--##-##-###---#--#-#---#-#--#-----#--
-#---#--------------#----#-#-##------#--#--#-----#-#------##--------#---#---##-#--#-----------#-#-#-
#--#--#-----#------#---#--##---##-------#--#-#####--##------#####----###-----#-#####---------------#
-#-#-##-#--------#--#-#----#-#-#-#-#----##---#----###--###-##---#--#----#-----#-------##-##--#--##--
-------##----------#----#-------#------#---##-##-------#---#-#-#-----#--#-#----##-------------------
-----##---##-#-#-------#-#---##-#---##---#-------------#-#-##-#--#----#---###--##---####-#----#-----
##---#----##--------#------#--#----#---#--#--#-#-##--------#-##--#-##---#-#-------#---#-#--#-#--#---
#---#--###---------#---#---##-----#----##------##-#--##-###------#--##-----#--#--#------##---#-##---
#-#--#-##----#---#--##----------#-----##-----#-#-----##-#-#---#-#----------#--------##-----##---#---
#-----#----#-#-#-##---#-----#-------#----#------#-##--#--#--#-----#-#--#-#-#-#-------####--#----#---
--#--#-###------#-##---#-##--------#---#-##---#-#-----##-----##--#-#---#--#------###-##-----#---#-##
--#--##---#----#---#---##-#--#-###---------##-#-#-#---##---#---#-##-#-##--------#--#--#-#-----------
-##--##------#--#-#--###-#--#-#----##--####-#-------#--#--#---#-------##----##--------#-#---#-##----
#--####----##------#---#--#-#----####----#--#-#--#-###--#-----#--#----#------#-#-----##---##-#-#---#
#-###--#---#---#--#--#--#-------------#-#--#-#--#----#---#--#--#-#-#-#--#----------#---###----------
----###--------##--#-#--#-##------#--#--##-###---#--##-#-#--#-#-#-----#--#-#----#---##-##----#--##--
--#---------#--#---#---#-----#-#--##--#-#--#---#---#-#E#--#-------###--#-----##------#----#--#-#----
--#--#-----------#-----#---#---#-#-#---#-#--#---#---#-###---#-----#------###---#---#--##-#--###---#-
-#-------##---#------#---#-#--#-#------#----------#-#---#-----#-----------#--###-###-----##-------#-
---#----##----##----#-##----------------#---##-------#-#----##-------------#-#-----#--#----#---#----
##-#-#----#--#-----------#-#-------###-#-#-----------#--#----#-------#---##---#--#-#----#---#--#----
-------#-#--------#----##---#----#------##---#-#-----##----#-#---------##-###-#-----#--------------#
---------#--#---##-#-##----#---##---#----------#-----###----##---##--------#-#--###----------##-##-#
-#-#--#-----#-#------#-#-#--###-#----------#--##-------#--##-##--#---##-#------#---#----#--#------##
-#--------#-#--#----#---#---#-------#---#--#-#-###-#--##-#--#-------#-#--#--####---##---#------#----
-#-#--#-------##------#--#--#-##-#---#---#-#--##-#-------##----###--#-#-#----#----#-#--#----#-#-----
-#--#-#---#-----#-----##-#-----#------#----##----#--#-------#----#--#--##-#-##-----##--##-##-#--##--
##-#--#-#--#----##-----#--#---#--------------#--#------#----#--------#--#--#-##-#-##-----#-##--#--##
-------------#-#-#---##--#------#---#-#--#-------#--##-------##----#---#-----##---#--##---#---#----#
---##-#---#-----------#---#----#--#--#-#-##--#-##-----##-------##----#--#---#---#----###---###---#--