?diagonal=Never;
---##---##---##---##---##---##---##---##---##---##---##---##---##---##---##---##---##---##---##---##
-#----#----#----#----#----#----#----#----#----#----#----#----#----#----#----#----#----#----#----#---
--##---##---##---##---##---##---##---##---##---##---##---##---##---##---##---##---##---##---##---##-
---##---##---##---##---##---##---##---##---##---##---##---##---##---##---##---##---##---##---##---##
----------------------------------------------------------------------------------------------------
---##---##---##---##---##---##---##---##---##---##---##---##---##---##---##---##---##---##---##---##
-#----#----#----#----#----#----#----#----#----#----#----#----#----#----#----#----#----#----#----#---
--##---##---##---##---##---##---##---##---##---##---##---##---##---##---##---##---##---##---##---##-
---##---##---##---##---##---##---##---##---##---##---##---##---##---##---##---##---##---##---##---##
----------------------------------------------------------------------------------------------------
---##---##---##---##---##---##---##---##---##---##---##---##---##---##---##---##---##---##---##---##
-#----#----#----#----#----#----#----#----#----#----#----#----#----#----#----#----#----#----#----#---
--##---##---##---##---##---##---##---##---##---##---##---##---##---##---##---##---##---##---##---##-
---##---##---##---##---##---##---##---##---##---##---##---##---##---##---##---##---##---##---##---##
----------------------------------------------------------------------------------------------------
---##---##---##---##---##---##---##---##---##---##---##---##---##---##---##---##---##---##---##---##
-#----#----#----#----#----#----#----#----#----#----#----#----#----#----#----#----#----#----#----#---
--##---##---##---##---##---##---##---##---##---##---##---##---##---##---##---##---##---##---##---##-
---##---##---##---##---##---##---##---##---##---##---##---##---##---##---##---##---##---##---##---##
----------------------------------------------------------------------------------------------------
---##---##---##---##---##---##---##---##---##---##---##---##---##---##---##---##---##---##---##---##
-#----#----#----#----#----#----#----#----#----#----#----#----#----#----#----#----#----#----#----#---
--##---##---##---##---##---##---##---##---##---##---##---##---##---##---##---##---##---##---##---##-
---##---##---##---##---##---##---##---##---##---##---##---##---##---##---##---##---##---##---##---##
----------------------------------------------------------------------------------------------------
---##---##---##---##---##---##---##---##---##---##---##---##---##---##---##---##---##---##---##---##
-#----#----#----#----#----#----#----#----#----#----#----#----#----#----#----#----#----#----#----#---
--##---##---##---##---##---##---##---##---##---##---##---##---##---##---##---##---##---##---##---##-
---##---##---##---##---##---##---##---##---##---##---##---##---##---##---##---##---##---##---##---##
---------------------------------------------------------------------------------------E------------
---##---##---##---##---##---##---##---##---##---##---##---##---##---##---##---##---##---##---##---##
-#----#----#----#----#----#----#----#----#----#----#----#----#----#----#----#----#----#----#----#---
--##---##---##---##---##---##---##---##---##---##---##---##---##---##---##---##---##---##---##---##-
---##---##---##---##---##---##---##---##---##---##---##---##---##---##---##---##---##---##---##---##
----------------------------------------------------------------------------------------------------
---##---##---##---##---##---##---##---##---##---##---##---##---##---##---##---##---##---##---##---##
-#----#----#----#----#----#----#----#----#----#----#----#----#----#----#----#----#----#----#----#---
--##---##---##---##---##---##---##---##---##---##---##---##---##---##---##---##---##---##---##---##-
---##---##---##---##---##---##---##---##---##---##---##---##---##---##---##---##---##---##---##---##
----------------------------------------------------------------------------------------------------
---##---##---##---##---##---##---##---##---##---##---##---##---##---##---##---##---##---##---##---##
-#----#----#----#----#----#----#----#----#----#----#----#----#----#----#----#----#----#----#----#---
--##---##---##---##---##---##---##---##---##---##---##---##---##---##---##---##---##---##---##---##-
---##---##---##---##---##---##---##---##---##---##---##---##---##---##---##---##---##---##---##---##
----------------------------------------------------------------------------------------------------
---##---##---##---##---##---##---##---##---##---##---##---##---##---##---##---##---##---##---##---##
-#----#----#----#----#----#----#----#----#----#----#----#----#----#----#----#----#----#----#----#---
--##---##---##---##---##---##---##---##---##---##---##---##---##---##---##---##---##---##---##---##-
---##---##---##---##---##---##---##---##---##---##---##---##---##---##---##---##---##---##---##---##
----------------------------------------------------------------------------------------------------
---##---##---##---##---##---##---##---##---##---##---##---##---##---##---##---##---##---##---##---##
-#----#----#----#----#----#----#----#----#----#----#----#----#----#----#----#----#----#----#----#---
--##---##---##---##---##---##---##---##---##---##---##---##---##---##---##---##---##---##---##---##-
---##---##---##---##---##---##---##---##---##---##---##---##---##---##---##---##---##---##---##---##
----------------------------------------------------------------------------------------------------
---##---##---##---##---##---##---##---##---##---##---##---##---##---##---##---##---##---##---##---##
-#----#----#----#----#----#----#----#----#----#----#----#----#----#----#----#----#----#----#----#---
--##---##---##---##---##---##---##---##---##---##---##---##---##---##---##---##---##---##---##---##-
---##---##---##---##---##---##---##---##---##---##---##---##---##---##---##---##---##---##---##---##
----------------------------------------------------------------------------------------------------
---##---##---##---##---##---##---##---##---##---##---##---##---##---##---##---##---##---##---##---##
-#----#----#----#----#----#----#----#----#----#----#----#----#----#----#----#----#----#----#----#---
--##---##---##---##---##---##---##---##---##---##---##---##---##---##---##---##---##---##---##---##-
---##---##---##---##---##---##---##---##---##---##---##---##---##---##---##---##---##---##---##---##
----------------------------------------------------------------------------------------------------
---##---##---##---##---##---##---##---##---##---##---##---##---##---##---##---##---##---##---##---##
-#----#----#----#----#----#----#----#----#----#----#----#----#----#----#----#----#----#----#----#---
--##---##---##---##---##---##---##---##---##---##---##---##---##---##---##---##---##---##---##---##-
---##---##---##---##---##---##---##---##---##---##---##---##---##---##---##---##---##---##---##---##
----------------------------------------------------------------------------------------------------
---##---##---##---##---##---##---##---##---##---##---##---##---##---##---##---##---##---##---##---##
-#----#----#----#----#----#----#----#----#----#----#----#----#----#----#----#----#----#----#----#---
--##---##---##---##---##---##---##---##---##---##---##---##---##---##---##---##---##---##---##---##-
---##---##---##---##---##---##---##---##---##---##---##---##---##---##---##---##---##---##---##---##
----------------------------------------------------------------------------------------------------
---##---##---##---##---##---##---##---##---##---##---##---##---##---##---##---##---##---##---##---##
-#----#----#----#----#----#----#----#----#----#----#----#----#----#----#--S-#----#----#----#----#---
--##---##---##---##---##---##---##---##---##---##---##---##---##---##---##---##---##---##---##---##-
---##---##---##---##---##---##---##---##---##---##---##---##---##---##---##---##---##---##---##---##
----------------------------------------------------------------------------------------------------
---##---##---##---##---##---##---##---##---##---##---##---##---##---##---##---##---##---##---##---##
-#----#----#----#----#----#----#----#----#----#----#----#----#----#----#----#----#----#----#----#---
--##---##---##---##---##---##---##---##---##---##---##---##---##---##---##---##---##---##---##---##-
---##---##---##---##---##---##---##---##---##---##---##---##---##---##---##---##---##---##---##---##
----------------------------------------------------------------------------------------------------
---##---##---##---##---##---##---##---##---##---##---##---##---##---##---##---##---##---##---##---##
-#----#----#----#----#----#----#----#----#----#----#----#----#----#----#----#----#----#----#----#---
--##---##---##---##---##---##---##---##---##---##---##---##---##---##---##---##---##---##---##---##-
---##---##---##---##---##---##---##---##---##---##---##---##---##---##---##---##---##---##---##---##
----------------------------------------------------------------------------------------------------
---##---##---##---##---##---##---##---##---##---##---##---##---##---##---##---##---##---##---##---##
-#----#----#----#----#----#----#----#----#----#----#----#----#----#----#----#----#----#----#----#---
--##---##---##---##---##---##---##---##---##---##---##---##---##---##---##---##---##---##---##---##-
---##---##---##---##---##---##---##---##---##---##---##---##---##---##---##---##---##---##---##---##
----------------------------------------------------------------------------------------------------
---##---##---##---##---##---##---##---##---##---##---##---##---##---##---##---##---##---##---##---##
-#----#----#----#----#----#----#----#----#----#----#----#----#----#----#----#----#----#----#----#---
--##---##---##---##---##---##---##---##---##---##---##---##---##---##---##---##---##---##---##---##-
---##---##---##---##---##---##---##---##---##---##---##---##---##---##---##---##---##---##---##---##
----------------------------------------------------------------------------------------------------