?diagonal=Never;
----------------------------------------------------------------------------------------------------
----#----#----#----#----#----#----#----#----#----#----#----#----#----#----#----#----#----#----#----#
##---##---##---##---##---##---##---##---##---##---##---##---##---##---##---##---##---##---##---##---
#--#-#--#-#--#-#--#-#--#-#--#-#--#-#--#-#--#-#--#-#--#-#--#-#--#-#--#-#--#-#--#-#--#-#--#-#--#-#--#-
#----#----#----#----#----#----#----#----#----#----#----#----#----#----#----#----#----#----#----#----
----------------------------------------------------------------------------------------------------
----#----#----#----#----#----#----#----#----#----#----#----#----#----#----#----#----#----#----#----#
##---##---##---##---##---##---##---##---##---##---##---##---##---##---##---##---##---##---##---##---
#--#-#--#-#--#-#--#-#--#-#--#-#--#-#--#-#--#-#--#-#--#-#--#-#--#-#--#-#--#-#--#-#--#-#--#-#--#-#--#-
#----#----#----#----#----#----#----#----#----#----#----#----#----#----#----#----#----#----#----#----
----------------------------------------------------------------------------------------------------
----#----#----#----#----#----#----#----#----#----#----#----#----#----#----#----#----#----#----#----#
##---##---##---##---##---##---##---##---##---##---##---##---##---##---##---##---##---##---##---##---
#--#-#--#-#--#-#--#-#--#-#--#-#--#-#--#-#--#-#--#-#--#-#--#-#--#-#--#-#--#-#--#-#--#-#--#-#--#-#--#-
#----#----#----#----#----#----#----#----#----#----#----#----#----#----#----#----#----#----#----#----
----------------------------------------------------------------------------------------------------
----#----#----#----#----#----#----#----#----#----#----#----#----#----#----#----#----#----#----#----#
##---##---##---##---##---##---##---##---##---##---##---##---##---##---##---##---##---##---##---##---
#--#-#--#-#--#-#--#-#--#-#--#-#--#-#--#-#--#-#--#-#--#-#--#-#--#-#--#-#--#-#--#-#--#-#--#-#--#-#--#-
#----#----#----#----#----#----#----#----#----#----#----#----#----#----#----#----#----#----#----#----
----------------------------------------------------------------------------------------------------
----#----#----#----#----#----#----#----#----#----#----#----#----#----#----#----#----#----#----#----#
##---##---##---##---##---##---##---##---##---##---##---##---##---##---##---##---##---##---##---##---
#--#-#--#-#--#-#--#-#--#-#--#-#--#-#--#-#--#-#--#-#--#-#--#-#--#-#--#-#--#-#--#-#--#-#--#-#--#-#--#-
#----#----#----#----#----#----#----#----#----#----#----#----#----#----#----#----#----#----#----#----
----------------------------------------------------------------------------------------------------
----#----#----#----#----#----#----#----#----#----#----#----#----#----#----#----#----#----#----#----#
##---##---##---##---##---##---##---##---##---##---##---##---##---##---##---##---##---##---##---##---
#--#-#--#-#--#-#--#-#--#-#--#-#--#-#--#-#--#-#--#-#--#-#--#-#--#-#--#-#--#-#--#-#--#-#--#-#--#-#--#-
#----#----#----#----#----#----#----#----#----#----#----#----#----#----#----#----#----#----#----#----
----------------------------------------------------------------------------------------------------
----#----#----#----#----#----#----#----#----#----#----#----#----#----#----#----#----#----#----#----#
##---##---##---##---##---##---##---##---##---##---##---##---##---##---##---##---##---##---##---##---
#--#-#--#-#--#-#--#-#--#-#--#-#--#-#--#-#--#-#--#-#--#-#--#-#--#-#--#-#--#-#--#-#--#-#--#-#--#-#--#-
#----#----#----#----#----#----#----#----#----#----#----#----#----#----#----#----#----#----#----#----
----------------------------------------------------------------------------------------------------
----#----#----#----#----#----#----#----#----#----#----#----#----#----#----#----#----#----#----#----#
##---##---##---##---##---##---##---##---##---##---##---##---##---##---##---##---##---##---##---##---
#--#-#--#-#--#-#--#-#--#-#--#-#--#-#--#-#--#-#--#-#--#-#--#-#--#-#--#-#--#-#--#-#--#-#--#-#--#-#--#-
#----#----#----#----#----#----#----#----#----#----#----#----#----#----#----#----#----#----#----#----
----------------------------------------------------------------------------------------------------
----#----#----#----#-E--#----#----#----#----#----#----#----#----#----#----#----#----#----#----#----#
##---##---##---##---##---##---##---##---##---##---##---##---##---##---##---##---##---##---##---##---
#--#-#--#-#--#-#--#-#--#-#--#-#--#-#--#-#--#-#--#-#--#-#--#-#--#-#--#-#--#-#--#-#--#-#--#-#--#-#--#-
#----#----#----#----#----#----#----#----#----#----#----#----#----#----#----#----#----#----#----#----
----------------------------------------------------------------------------------------------------
----#----#----#----#----#----#----#----#----#----#----#----#----#----#----#----#----#----#----#----#
##---##---##---##---##---##---##---##---##---##---##---##---##---##---##---##---##---##---##---##---
#--#-#--#-#--#-#--#-#--#-#--#-#--#-#--#-#--#-#--#-#--#-#--#-#--#-#--#-#--#-#--#-#--#-#--#-#--#-#--#-
#----#----#----#----#----#----#----#----#----#----#----#----#----#----#----#----#----#----#----#----
----------------------------------------------------------------------------------------------------
----#----#----#----#----#----#----#----#----#----#----#----#----#----#----#----#----#----#----#----#
##---##---##---##---##---##---##---##---##---##---##---##---##---##---##---##---##---##---##---##---
#--#-#--#-#--#-#--#-#--#-#--#-#--#-#--#-#--#-#--#-#--#-#--#-#--#-#--#-#--#-#--#-#--#-#--#-#--#-#--#-
#----#----#----#----#----#----#----#----#----#----#----#----#----#----#----#----#----#----#----#----
----------------------------------------------------------------------------------------------------
----#----#----#----#----#----#----#----#----#----#----#----#----#----#----#----#----#----#----#----#
##---##---##---##---##---##---##---##---##---##---##---##---##---##---##---##---##---##---##---##---
#--#-#--#-#--#-#--#-#--#-#--#-#--#-#--#-#--#-#--#-#--#-#--#-#--#-#--#-#--#-#--#-#--#-#--#-#--#-#--#-
#----#----#----#----#----#----#----#----#----#----#----#----#----#----#----#----#----#----#----#----
----------------------------------------------------------------------------------------------------
----#----#----#----#----#----#----#----#----#----#----#----#----#----#----#----#----#----#----#----#
##---##---##---##---##---##---##---##---##---##---##---##---##---##---##---##---##---##---##---##---
#--#-#--#-#--#-#--#-#--#-#--#-#--#-#--#-#--#-#--#-#--#-#--#-#--#-#--#-#--#-#--#-#--#-#--#-#--#-#--#-
#----#----#----#----#----#----#----#----#----#----#----#----#----#----#----#----#----#----#----#----
----------------------------------------------------------------------------------------------------
----#----#----#----#----#----#----#----#----#----#----#----#----#----#----#----#----#----#----#----#
##---##---##---##---##---##---##---##---##---##---##---##---##---##---##---##---##---##---##---##---
#--#-#--#-#--#-#--#-#--#-#--#-#--#-#--#-#--#-#--#-#--#-#--#-#--#-#--#-#--#-#--#-#--#-#--#-#--#-#--#-
#----#----#----#----#----#----#----#----#----#----#----#----#----#----#----#----#----#----#----#----
----------------------------------------------------------------------------------------------------
----#----#----#----#----#----#----#----#----#----#----#----#----#----#----#----#----#----#----#----#
##---##---##---##S--##---##---##---##---##---##---##---##---##---##---##---##---##---##---##---##---
#--#-#--#-#--#-#--#-#--#-#--#-#--#-#--#-#--#-#--#-#--#-#--#-#--#-#--#-#--#-#--#-#--#-#--#-#--#-#--#-
#----#----#----#----#----#----#----#----#----#----#----#----#----#----#----#----#----#----#----#----
----------------------------------------------------------------------------------------------------
----#----#----#----#----#----#----#----#----#----#----#----#----#----#----#----#----#----#----#----#
##---##---##---##---##---##---##---##---##---##---##---##---##---##---##---##---##---##---##---##---
#--#-#--#-#--#-#--#-#--#-#--#-#--#-#--#-#--#-#--#-#--#-#--#-#--#-#--#-#--#-#--#-#--#-#--#-#--#-#--#-
#----#----#----#----#----#----#----#----#----#----#----#----#----#----#----#----#----#----#----#----
----------------------------------------------------------------------------------------------------
----#----#----#----#----#----#----#----#----#----#----#----#----#----#----#----#----#----#----#----#
##---##---##---##---##---##---##---##---##---##---##---##---##---##---##---##---##---##---##---##---
#--#-#--#-#--#-#--#-#--#-#--#-#--#-#--#-#--#-#--#-#--#-#--#-#--#-#--#-#--#-#--#-#--#-#--#-#--#-#--#-
#----#----#----#----#----#----#----#----#----#----#----#----#----#----#----#----#----#----#----#----
----------------------------------------------------------------------------------------------------
----#----#----#----#----#----#----#----#----#----#----#----#----#----#----#----#----#----#----#----#
##---##---##---##---##---##---##---##---##---##---##---##---##---##---##---##---##---##---##---##---
#--#-#--#-#--#-#--#-#--#-#--#-#--#-#--#-#--#-#--#-#--#-#--#-#--#-#--#-#--#-#--#-#--#-#--#-#--#-#--#-
#----#----#----#----#----#----#----#----#----#----#----#----#----#----#----#----#----#----#----#----
----------------------------------------------------------------------------------------------------
----#----#----#----#----#----#----#----#----#----#----#----#----#----#----#----#----#----#----#----#
##---##---##---##---##---##---##---##---##---##---##---##---##---##---##---##---##---##---##---##---
#--#-#--#-#--#-#--#-#--#-#--#-#--#-#--#-#--#-#--#-#--#-#--#-#--#-#--#-#--#-#--#-#--#-#--#-#--#-#--#-
#----#----#----#----#----#----#----#----#----#----#----#----#----#----#----#----#----#----#----#----
----------------------------------------------------------------------------------------------------
----#----#----#----#----#----#----#----#----#----#----#----#----#----#----#----#----#----#----#----#
##---##---##---##---##---##---##---##---##---##---##---##---##---##---##---##---##---##---##---##---
#--#-#--#-#--#-#--#-#--#-#--#-#--#-#--#-#--#-#--#-#--#-#--#-#--#-#--#-#--#-#--#-#--#-#--#-#--#-#--#-
#----#----#----#----#----#----#----#----#----#----#----#----#----#----#----#----#----#----#----#----