?diagonal=Never;
----#----#----#----#----#----#----#----#----#----#----#----#----#----#----#----#----#----#----#----#
##---##---##---##---##---##---##---##---##---##---##---##---##---##---##---##---##---##---##---##---
----------------------------------------------------------------------------------------------------
----------------------------------------------------------------------------------------------------
--##---##---##---##---##---##---##---##---##---##---##---##---##---##---##---##---##---##---##---##-
----#----#----#----#----#----#----#----#----#----#----#----#----#----#----#----#----#----#----#----#
##---##---##---##---##---##---##---##---##---##---##---##---##---##---##---##---##---##---##---##---
----------------------------------------------------------------------------------------------------
----------------------------------------------------------------------------------------------------
--##---##---##---##---##---##---##---##---##---##---##---##---##---##---##---##---##---##---##---##-
----#----#----#----#----#----#----#----#----#----#----#----#----#----#----#----#----#----#----#----#
##---##---##---##---##---##---##---##---##---##---##---##---##---##---##---##---##---##---##---##---
----------------------------------------------------------------------------------------------------
----------------------------------------------------------------------------------------------------
--##---##---##---##---##---##---##---##---##---##---##---##---##---##---##---##---##---##---##---##-
----#----#----#----#----#----#----#----#----#----#----#----#----#----#----#----#----#----#----#----#
##---##---##---##---##---##---##---##---##---##---##---##---##---##---##---##---##---##---##---##---
--------------------------S-------------------------------------------------------------------------
----------------------------------------------------------------------------------------------------
--##---##---##---##---##---##---##---##---##---##---##---##---##---##---##---##---##---##---##---##-
----#----#----#----#----#----#----#----#----#----#----#----#----#----#----#----#----#----#----#----#
##---##---##---##---##---##---##---##---##---##---##---##---##---##---##---##---##---##---##---##---
----------------------------------------------------------------------------------------------------
----------------------------------------------------------------------------------------------------
--##---##---##---##---##---##---##---##---##---##---##---##---##---##---##---##---##---##---##---##-
----#----#----#----#----#----#----#----#----#----#----#----#----#----#----#----#----#----#----#----#
##---##---##---##---##---##---##---##---##---##---##---##---##---##---##---##---##---##---##---##---
----------------------------------------------------------------------------------------------------
----------------------------------------------------------------------------------------------------
--##---##---##---##---##---##---##---##---##---##---##---##---##---##---##---##---##---##---##---##-
----#----#----#----#----#----#----#----#----#----#----#----#----#----#----#----#----#----#----#----#
##---##---##---##---##---##---##---##---##---##---##---##---##---##---##---##---##---##---##---##---
----------------------------------------------------------------------------------------------------
----------------------------------------------------------------------------------------------------
--##---##---##---##---##---##---##---##---##---##---##---##---##---##---##---##---##---##---##---##-
----#----#----#----#----#----#----#----#----#----#----#----#----#----#----#----#----#----#----#----#
##---##---##---##---##---##---##---##---##---##---##---##---##---##---##---##---##---##---##---##---
----------------------------------------------------------------------------------------------------
----------------------------------------------------------------------------------------------------
--##---##---##---##---##---##---##---##---##---##---##---##---##---##---##---##---##---##---##---##-
----#----#----#----#----#----#----#----#----#----#----#----#----#----#----#----#----#----#----#----#
##---##---##---##---##---##---##---##---##---##---##---##---##---##---##---##---##---##---##---##---
----------------------------------------------------------------------------------------------------
--------------------------------E-------------------------------------------------------------------
--##---##---##---##---##---##---##---##---##---##---##---##---##---##---##---##---##---##---##---##-
----#----#----#----#----#----#----#----#----#----#----#----#----#----#----#----#----#----#----#----#
##---##---##---##---##---##---##---##---##---##---##---##---##---##---##---##---##---##---##---##---
----------------------------------------------------------------------------------------------------
----------------------------------------------------------------------------------------------------
--##---##---##---##---##---##---##---##---##---##---##---##---##---##---##---##---##---##---##---##-
----#----#----#----#----#----#----#----#----#----#----#----#----#----#----#----#----#----#----#----#
##---##---##---##---##---##---##---##---##---##---##---##---##---##---##---##---##---##---##---##---
----------------------------------------------------------------------------------------------------
----------------------------------------------------------------------------------------------------
--##---##---##---##---##---##---##---##---##---##---##---##---##---##---##---##---##---##---##---##-
----#----#----#----#----#----#----#----#----#----#----#----#----#----#----#----#----#----#----#----#
##---##---##---##---##---##---##---##---##---##---##---##---##---##---##---##---##---##---##---##---
----------------------------------------------------------------------------------------------------
----------------------------------------------------------------------------------------------------
--##---##---##---##---##---##---##---##---##---##---##---##---##---##---##---##---##---##---##---##-
----#----#----#----#----#----#----#----#----#----#----#----#----#----#----#----#----#----#----#----#
##---##---##---##---##---##---##---##---##---##---##---##---##---##---##---##---##---##---##---##---
----------------------------------------------------------------------------------------------------
----------------------------------------------------------------------------------------------------
--##---##---##---##---##---##---##---##---##---##---##---##---##---##---##---##---##---##---##---##-
----#----#----#----#----#----#----#----#----#----#----#----#----#----#----#----#----#----#----#----#
##---##---##---##---##---##---##---##---##---##---##---##---##---##---##---##---##---##---##---##---
----------------------------------------------------------------------------------------------------
----------------------------------------------------------------------------------------------------
--##---##---##---##---##---##---##---##---##---##---##---##---##---##---##---##---##---##---##---##-
----#----#----#----#----#----#----#----#----#----#----#----#----#----#----#----#----#----#----#----#
##---##---##---##---##---##---##---##---##---##---##---##---##---##---##---##---##---##---##---##---
----------------------------------------------------------------------------------------------------
----------------------------------------------------------------------------------------------------
--##---##---##---##---##---##---##---##---##---##---##---##---##---##---##---##---##---##---##---##-
----#----#----#----#----#----#----#----#----#----#----#----#----#----#----#----#----#----#----#----#
##---##---##---##---##---##---##---##---##---##---##---##---##---##---##---##---##---##---##---##---
----------------------------------------------------------------------------------------------------
----------------------------------------------------------------------------------------------------
--##---##---##---##---##---##---##---##---##---##---##---##---##---##---##---##---##---##---##---##-
----#----#----#----#----#----#----#----#----#----#----#----#----#----#----#----#----#----#----#----#
##---##---##---##---##---##---##---##---##---##---##---##---##---##---##---##---##---##---##---##---
----------------------------------------------------------------------------------------------------
----------------------------------------------------------------------------------------------------
--##---##---##---##---##---##---##---##---##---##---##---##---##---##---##---##---##---##---##---##-
----#----#----#----#----#----#----#----#----#----#----#----#----#----#----#----#----#----#----#----#
##---##---##---##---##---##---##---##---##---##---##---##---##---##---##---##---##---##---##---##---
----------------------------------------------------------------------------------------------------
----------------------------------------------------------------------------------------------------
--##---##---##---##---##---##---##---##---##---##---##---##---##---##---##---##---##---##---##---##-
----#----#----#----#----#----#----#----#----#----#----#----#----#----#----#----#----#----#----#----#
##---##---##---##---##---##---##---##---##---##---##---##---##---##---##---##---##---##---##---##---
----------------------------------------------------------------------------------------------------
----------------------------------------------------------------------------------------------------
--##---##---##---##---##---##---##---##---##---##---##---##---##---##---##---##---##---##---##---##-
----#----#----#----#----#----#----#----#----#----#----#----#----#----#----#----#----#----#----#----#
##---##---##---##---##---##---##---##---##---##---##---##---##---##---##---##---##---##---##---##---
----------------------------------------------------------------------------------------------------
----------------------------------------------------------------------------------------------------
--##---##---##---##---##---##---##---##---##---##---##---##---##---##---##---##---##---##---##---##-