?diagonal=Never;
--##---##---##---##---##---##---##---##---##---##---##---##---##---##---##---##---##---##---##---##-
----------------------------------------------------------------------------------------------------
##--###--###--###--###--###--###--###--###--###--###--###--###--###--###--###--###--###--###--###--#
----#----#----#----#----#----#----#----#----#----#----#----#----#----#----#----#----#----#----#----#
----------------------------------------------------------------------------------------------------
--##---##---##---##---##---##---##---##---##---##---##---##---##---##---##---##---##---##---##---##-
----------------------------------------------------------------------------------------------------
##--###--###--###--###--###--###--###--###--###--###--###--###--###--###--###--###--###--###--###--#
----#----#----#----#----#----#----#----#----#----#----#----#----#----#----#----#----#----#----#----#
----------------------------------------------------------------------------------------------------
--##---##---##---##---##---##---##---##---##---##---##---##---##---##---##---##---##---##---##---##-
----------------------------------------------------------------------------------------------------
##--###--###--###--###--###--###--###--###--###--###--###--###--###--###--###--###--###--###--###--#
----#----#----#----#----#----#----#----#----#----#----#----#----#----#----#----#----#----#----#----#
----------------------------------------------------------------------------------------------------
--##---##---##---##---##---##---##---##---##---##---##---##---##---##---##---##---##---##---##---##-
----------------------------------------------------------------------------------------------------
##--###--###--###--###--###--###--###--###--###--###--###--###--###--###--###--###--###--###--###--#
----#----#----#----#----#----#----#----#----#----#----#----#----#----#----#----#----#----#----#----#
----------------------------------------------------------------------------------------------------
--##---##---##---##---##---##---##---##---##---##---##---##---##---##---##---##---##---##---##---##-
----------------------------------------------------------------------------------------------------
##--###--###--###--###--###--###--###--###--###--###--###--###--###--###--###--###--###--###--###--#
----#----#----#----#----#----#----#----#----#----#----#----#----#----#----#----#----#----#----#----#
----------------------------------------------------------------------------------------------------
--##---##---##---##---##---##---##---##---##---##---##---##---##---##---##---##---##---##---##---##-
----------------------------------------------------------------------------------------------------
##--###--###--###--###--###--###--###--###--###--###--###--###--###--###--###--###--###--###--###--#
----#----#----#----#----#----#----#----#----#----#----#----#----#----#----#----#----#----#----#----#
----------------------------------------------------------------------------------------------------
--##---##---##---##---##---##---##---##---##---##---##---##---##---##---##---##---##---##---##---##-
----------------------------------------------------------------------------------------------------
##--###--###--###--###--###--###--###--###--###--###--###--###--###--###--###--###--###--###--###--#
----#----#----#----#----#----#----#----#----#----#----#----#----#----#----#----#----#----#----#----#
----------------------------------------------------------------------------------------------------
--##---##---##---##---##---##---##---##---##---##---##---##---##---##---##---##---##---##---##---##-
----------------------------------------------------------------------------------------------------
##--###--###--###--###--###--###--###--###--###--###--###--###--###--###--###--###--###--###--###--#
----#----#----#----#----#----#----#----#----#----#----#----#----#----#----#----#----#----#----#----#
----------------------------------------------------------------------------------------------------
--##---##---##---##---##---##---##---##---##---##---##---##---##---##---##---##---##---##---##---##-
----------------------------------------------------------------------------------------------------
##--###--###--###--###--###--###--###--###--###--###--###--###--###--###--###--###--###--###--###--#
----#----#----#----#----#----#----#----#----#----#----#----#----#----#----#----#----#----#----#----#
----------------------------------------------------------------------------------------------------
--##---##S--##---##---##---##---##---##---##---##---##---##---##---##---##---##---##---##---##---##-
----------------------------------------------------------------------------------------------------
##--###--###--###--###--###--###--###--###--###--###--###--###--###--###--###--###--###--###--###--#
----#----#----#----#----#----#----#----#----#----#----#----#----#----#----#----#----#----#----#----#
----------------------------------------------------------------------------------------------------
--##---##---##---##---##---##---##---##---##---##---##---##---##---##---##---##---##---##---##---##-
----------------------------------------------------------------------------------------------------
##--###--###--###--###--###--###--###--###--###--###--###--###--###--###--###--###--###--###--###--#
----#----#----#----#----#----#----#----#----#----#----#----#----#----#----#----#----#----#----#----#
----------------------------------------------------------------------------------------------------
--##---##---##---##---##---##---##---##---##---##---##---##---##---##---##---##---##---##---##---##-
----------------------------------------------------------------------------------------------------
##--###--###--###--###--###--###--###--###--###--###--###--###--###--###--###--###--###--###--###--#
----#----#----#----#----#----#----#----#----#----#----#----#----#----#----#----#----#----#----#----#
----------------------------------------------------------------------------------------------------
--##---##---##---##---##---##---##---##---##---##---##---##---##---##---##---##---##---##---##---##-
----------------------------------------------------------------------------------------------------
##--###--###--###--###--###--###--###--###--###--###--###--###--###--###--###--###--###--###--###--#
----#----#----#----#----#----#----#----#----#----#----#----#----#----#----#----#----#----#----#----#
----------------------------------------------------------------------------------------------------
--##---##---##---##---##---##---##---##---##---##---##---##---##---##---##---##---##---##---##---##-
----------------------------------------------------------------------------------------------------
##--###--###--###--###--###--###--###--###--###--###--###--###--###--###--###--###--###--###--###--#
----#----#----#----#----#----#----#----#----#----#----#----#----#----#----#----#----#----#----#----#
----------------------------------------------------------------------------------------------------
--##---##---##---##---##---##---##---##---##---##---##---##---##---##---##---##---##---##---##---##-
----------------------------------------------------------------------------------------------------
##--###--###--###--###--###--###--###--###--###--###--###--###--###--###--###--###--###--###--###--#
----#----#----#----#----#----#----#----#----#----#----#----#----#----#----#----#----#----#----#----#
----------------------------------------------------------------------------------------------------
--##---##---##---##---##---##---##---##---##---##---##---##---##---##---##---##---##---##---##---##-
----------------------------------------------------------------------------------------------------
##--###--###--###--###--###--###--###--###--###--###--###--###--###--###--###--###--###--###--###--#
----#----#----#----#----#----#----#----#----#----#----#----#----#----#----#----#----#----#----#----#
----------------------------------------------------------------------------------------------------
--##---##---##---##---##---##---##---##---##---##---##---##---##---##---##---##---##---##---##---##-
----------------------------------------------------------------------------------------------------
##--###--###--###--###--###--###--###--###--###--###--###--###--###--###--###--###--###--###--###--#
----#----#----#----#----#----#----#----#----#----#----#----#----#----#----#----#----#----#----#----#
----------------------------------------------------------------------------------------------------
--##---##---##---##---##---##---##---##---##---##---##---##---##---##---##---##---##---##---##---##-
----------------------------------------------------------------------------------------------------
##--###--###--###--###--###--###--###--###--###--###--###--###--###--###--###--###--###--###--###--#
----#----#----#----#----#----#----#----#----#----#----#----#----#----#----#----#----#----#----#----#
----------------------------------------------------------------------------------------------------
--##---##---##---##---##---##---##---##---##---##---##---##---##---##---##---##---##---##---##---##-
---------------------------------------------------------------E------------------------------------
##--###--###--###--###--###--###--###--###--###--###--###--###--###--###--###--###--###--###--###--#
----#----#----#----#----#----#----#----#----#----#----#----#----#----#----#----#----#----#----#----#
----------------------------------------------------------------------------------------------------
--##---##---##---##---##---##---##---##---##---##---##---##---##---##---##---##---##---##---##---##-
----------------------------------------------------------------------------------------------------
##--###--###--###--###--###--###--###--###--###--###--###--###--###--###--###--###--###--###--###--#
----#----#----#----#----#----#----#----#----#----#----#----#----#----#----#----#----#----#----#----#
----------------------------------------------------------------------------------------------------