?diagonal=Never;
-#----#----#----#----#----#----#----#----#----#----#----#----#----#----#----#----#----#----#----#---
--#-#--#-#--#-#--#-#--#-#--#-#--#-#--#-#--#-#--#-#--#-#--#-#--#-#--#-#--#-#--#-#--#-#--#-#--#-#--#-#
#----#----#----#----#----#----#----#----#----#----#----#----#----#----#----#----#----#----#----#----
----------------------------------------------------------------------------------------------------
##-####-####-####-####-####-####-####-####-####-####-####-####-####-####-####-####-####-####-####-##
-#----#----#----#----#----#----#----#----#----#----#----#----#----#----#----#----#----#----#----#---
--#-#--#-#--#-#--#-#--#-#--#-#--#-#--#-#--#-#--#-#--#-#--#-#--#-#--#-#--#-#--#-#--#-#--#-#--#-#--#-#
#----#----#----#----#----#----#----#----#----#----#----#----#----#----#----#----#----#----#----#----
----------------------------------------------------------------------------------------------------
##-####-####-####-####-####-####-####-####-####-####-####-####-####-####-####-####-####-####-####-##
-#----#----#----#----#----#----#----#----#----#----#----#----#----#----#----#----#----#----#----#---
--#-#--#-#--#-#--#-#--#-#--#-#--#-#--#-#--#-#--#-#--#-#--#-#--#-#--#-#--#-#--#-#--#-#--#-#--#-#--#-#
#----#----#----#----#----#----#----#----#----#----#----#----#----#----#----#----#----#----#----#----
----------------------------------------------------------------------------------------------------
##-####-####-####-####-####-####-####-####-####-####-####-####-####-####-####-####-####-####-####-##
-#----#----#----#----#----#----#----#----#----#----#----#----#----#----#----#----#----#----#----#---
--#-#--#-#--#-#--#-#--#-#--#-#--#-#--#-#--#-#--#-#--#-#--#-#--#-#--#-#--#-#--#-#--#-#--#-#--#-#--#-#
#----#----#----#----#----#----#----#----#----#----#----#----#----#----#----#----#----#----#----#----
--------E-------------------------------------------------------------------------------------------
##-####-####-####-####-####-####-####-####-####-####-####-####-####-####-####-####-####-####-####-##
-#----#----#----#----#----#----#----#----#----#----#----#----#----#----#----#----#----#----#----#---
--#-#--#-#--#-#--#-#--#-#--#-#--#-#--#-#--#-#--#-#--#-#--#-#--#-#--#-#--#-#--#-#--#-#--#-#--#-#--#-#
#----#----#----#----#----#----#----#----#----#----#----#----#----#----#----#----#----#----#----#----
----------------------------------------------------------------------------------------------------
##-####-####-####-####-####-####-####-####-####-####-####-####-####-####-####-####-####-####-####-##
-#----#----#----#----#----#----#----#----#----#----#----#----#----#----#----#----#----#----#----#---
--#-#--#-#--#-#--#-#--#-#--#-#--#-#--#-#--#-#--#-#--#-#--#-#--#-#--#-#--#-#--#-#--#-#--#-#--#-#--#-#
#----#----#----#----#----#----#----#----#----#----#----#----#----#----#----#----#----#----#----#----
----------------------------------------------------------------------------------------------------
##-####-####-####-####-####-####-####-####-####-####-####-####-####-####-####-####-####-####-####-##
-#----#----#----#----#----#----#----#----#----#----#----#----#----#----#----#----#----#----#----#---
--#-#--#-#--#-#--#-#--#-#--#-#--#-#--#-#--#-#--#-#--#-#--#-#--#-#--#-#--#-#--#-#--#-#--#-#--#-#--#-#
#----#----#----#----#----#----#----#----#----#----#----#----#----#----#----#----#----#----#----#----
----------------------------------------------------------------------------------------------------
##-####-####-####-####-####-####-####-####-####-####-####-####-####-####-####-####-####-####-####-##
-#----#----#----#----#----#----#----#----#----#----#----#----#----#----#----#----#----#----#----#---
--#-#--#-#--#-#--#-#--#-#--#-#--#-#--#-#--#-#--#-#--#-#--#-#--#-#--#-#--#-#--#-#--#-#--#-#--#-#--#-#
#----#----#----#----#----#----#----#----#----#----#----#----#----#----#----#----#----#----#----#----
----------------------------------------------------------------------------------------------------
##-####-####-####-####-####-####-####-####-####-####-####-####-####-####-####-####-####-####-####-##
-#----#----#----#----#----#----#----#----#----#----#----#----#----#----#----#----#----#----#----#---
--#-#--#-#--#-#--#-#--#-#--#-#--#-#--#-#--#-#--#-#--#-#--#-#--#-#--#-#--#-#--#-#--#-#--#-#--#-#--#-#
#----#----#----#----#----#----#----#----#----#----#----#----#----#----#----#----#----#----#----#----
----------------------------------------------------------------------------------------------------
##-####-####-####-####-####-####-####-####-####-####-####-####-####-####-####-####-####-####-####-##
-#----#----#----#----#----#----#----#----#----#----#----#----#----#----#----#----#----#----#----#---
--#-#--#-#--#-#--#-#--#-#--#-#--#-#--#-#--#-#--#-#--#-#--#-#--#-#--#-#--#-#--#-#--#-#--#-#--#-#--#-#
#----#----#----#----#----#----#----#----#----#----#----#----#----#----#----#----#----#----#----#----
----------------------------------------------------------------------------------------------------
##-####-####-####-####-####-####-####-####-####-####-####-####-####-####-####-####-####-####-####-##
-#----#----#----#----#----#----#----#----#----#----#----#----#----#----#----#----#----#----#----#---
--#-#--#-#--#-#--#-#--#-#--#-#--#-#--#-#--#-#--#-#--#-#--#-#--#-#--#-#--#-#--#-#--#-#--#-#--#-#--#-#
#----#----#----#----#----#----#----#----#----#----#----#----#----#----#----#----#----#----#----#----
----------------------------------------------------------------------------------------------------
##-####-####-####-####-####-####-####-####-####-####-####-####-####-####-####-####-####-####-####-##
-#----#----#----#----#----#----#----#----#----#----#----#----#----#----#----#----#----#----#----#---
--#-#--#-#--#-#--#-#--#-#--#-#--#-#--#-#--#-#--#-#--#-#--#-#--#-#--#-#--#-#--#-#--#-#--#-#--#-#--#-#
#----#----#----#----#----#----#----#----#----#----#----#----#----#----#----#----#----#----#----#----
----------------------------------------------------------------------------------------------------
##-####-####-####-####-####-####-####-####-####-####-####-####-####-####-####-####-####-####-####-##
-#----#----#---S#----#----#----#----#----#----#----#----#----#----#----#----#----#----#----#----#---
--#-#--#-#--#-#--#-#--#-#--#-#--#-#--#-#--#-#--#-#--#-#--#-#--#-#--#-#--#-#--#-#--#-#--#-#--#-#--#-#
#----#----#----#----#----#----#----#----#----#----#----#----#----#----#----#----#----#----#----#----
----------------------------------------------------------------------------------------------------
##-####-####-####-####-####-####-####-####-####-####-####-####-####-####-####-####-####-####-####-##
-#----#----#----#----#----#----#----#----#----#----#----#----#----#----#----#----#----#----#----#---
--#-#--#-#--#-#--#-#--#-#--#-#--#-#--#-#--#-#--#-#--#-#--#-#--#-#--#-#--#-#--#-#--#-#--#-#--#-#--#-#
#----#----#----#----#----#----#----#----#----#----#----#----#----#----#----#----#----#----#----#----
----------------------------------------------------------------------------------------------------
##-####-####-####-####-####-####-####-####-####-####-####-####-####-####-####-####-####-####-####-##
-#----#----#----#----#----#----#----#----#----#----#----#----#----#----#----#----#----#----#----#---
--#-#--#-#--#-#--#-#--#-#--#-#--#-#--#-#--#-#--#-#--#-#--#-#--#-#--#-#--#-#--#-#--#-#--#-#--#-#--#-#
#----#----#----#----#----#----#----#----#----#----#----#----#----#----#----#----#----#----#----#----
----------------------------------------------------------------------------------------------------
##-####-####-####-####-####-####-####-####-####-####-####-####-####-####-####-####-####-####-####-##
-#----#----#----#----#----#----#----#----#----#----#----#----#----#----#----#----#----#----#----#---
--#-#--#-#--#-#--#-#--#-#--#-#--#-#--#-#--#-#--#-#--#-#--#-#--#-#--#-#--#-#--#-#--#-#--#-#--#-#--#-#
#----#----#----#----#----#----#----#----#----#----#----#----#----#----#----#----#----#----#----#----
----------------------------------------------------------------------------------------------------
##-####-####-####-####-####-####-####-####-####-####-####-####-####-####-####-####-####-####-####-##
-#----#----#----#----#----#----#----#----#----#----#----#----#----#----#----#----#----#----#----#---
--#-#--#-#--#-#--#-#--#-#--#-#--#-#--#-#--#-#--#-#--#-#--#-#--#-#--#-#--#-#--#-#--#-#--#-#--#-#--#-#
#----#----#----#----#----#----#----#----#----#----#----#----#----#----#----#----#----#----#----#----
----------------------------------------------------------------------------------------------------
##-####-####-####-####-####-####-####-####-####-####-####-####-####-####-####-####-####-####-####-##
-#----#----#----#----#----#----#----#----#----#----#----#----#----#----#----#----#----#----#----#---
--#-#--#-#--#-#--#-#--#-#--#-#--#-#--#-#--#-#--#-#--#-#--#-#--#-#--#-#--#-#--#-#--#-#--#-#--#-#--#-#
#----#----#----#----#----#----#----#----#----#----#----#----#----#----#----#----#----#----#----#----
----------------------------------------------------------------------------------------------------
##-####-####-####-####-####-####-####-####-####-####-####-####-####-####-####-####-####-####-####-##
-#----#----#----#----#----#----#----#----#----#----#----#----#----#----#----#----#----#----#----#---
--#-#--#-#--#-#--#-#--#-#--#-#--#-#--#-#--#-#--#-#--#-#--#-#--#-#--#-#--#-#--#-#--#-#--#-#--#-#--#-#
#----#----#----#----#----#----#----#----#----#----#----#----#----#----#----#----#----#----#----#----
----------------------------------------------------------------------------------------------------
##-####-####-####-####-####-####-####-####-####-####-####-####-####-####-####-####-####-####-####-##
-#----#----#----#----#----#----#----#----#----#----#----#----#----#----#----#----#----#----#----#---
--#-#--#-#--#-#--#-#--#-#--#-#--#-#--#-#--#-#--#-#--#-#--#-#--#-#--#-#--#-#--#-#--#-#--#-#--#-#--#-#
#----#----#----#----#----#----#----#----#----#----#----#----#----#----#----#----#----#----#----#----
----------------------------------------------------------------------------------------------------
##-####-####-####-####-####-####-####-####-####-####-####-####-####-####-####-####-####-####-####-##