?diagonal=Never;
-##---##---##---##---##---##---##---##---##---##---##---##---##---##---##---##---##---##---##---##--
-#-#--#-#--#-#--#-#--#-#--#-#--#-#--#-#--#-#--#-#--#-#--#-#--#-#--#-#--#-#--#-#--#-#--#-#--#-#--#-#-
-#----#----#----#----#----#----#----#----#----#----#----#----#----#----#----#----#----#----#----#---
-###--###--###--###--###--###--###--###--###--###--###--###--###--###--###--###--###--###--###--###-
------------S---------------------------------------------------------------------------------------
-##---##---##---##---##---##---##---##---##---##---##---##---##---##---##---##---##---##---##---##--
-#-#--#-#--#-#--#-#--#-#--#-#--#-#--#-#--#-#--#-#--#-#--#-#--#-#--#-#--#-#--#-#--#-#--#-#--#-#--#-#-
-#----#----#----#----#----#----#----#----#----#----#----#----#----#----#----#----#----#----#----#---
-###--###--###--###--###--###--###--###--###--###--###--###--###--###--###--###--###--###--###--###-
----------------------------------------------------------------------------------------------------
-##---##---##---##---##---##---##---##---##---##---##---##---##---##---##---##---##---##---##---##--
-#-#--#-#--#-#--#-#--#-#--#-#--#-#--#-#--#-#--#-#--#-#--#-#--#-#--#-#--#-#--#-#--#-#--#-#--#-#--#-#-
-#----#----#----#----#----#----#----#----#----#----#----#----#----#----#----#----#----#----#----#---
-###--###--###--###--###--###--###--###--###--###--###--###--###--###--###--###--###--###--###--###-
----------------------------------------------------------------------------------------------------
-##---##---##---##---##---##---##---##---##---##---##---##---##---##---##---##---##---##---##---##--
-#-#--#-#--#-#--#-#--#-#--#-#--#-#--#-#--#-#--#-#--#-#--#-#--#-#--#-#--#-#--#-#--#-#--#-#--#-#--#-#-
-#----#----#----#----#----#----#----#----#----#----#----#----#----#----#----#----#----#----#----#---
-###--###--###--###--###--###--###--###--###--###--###--###--###--###--###--###--###--###--###--###-
----------------------------------------------------------------------------------------------------
-##---##---##---##---##---##---##---##---##---##---##---##---##---##---##---##---##---##---##---##--
-#-#--#-#--#-#--#-#--#-#--#-#--#-#--#-#--#-#--#-#--#-#--#-#--#-#--#-#--#-#--#-#--#-#--#-#--#-#--#-#-
-#----#----#----#----#----#----#----#----#----#----#----#----#----#----#----#----#----#----#----#---
-###--###--###--###--###--###--###--###--###--###--###--###--###--###--###--###--###--###--###--###-
----------------------------------------------------------------------------------------------------
-##---##---##---##---##---##---##---##---##---##---##---##---##---##---##---##---##---##---##---##--
-#-#--#-#--#-#--#-#--#-#--#-#--#-#--#-#--#-#--#-#--#-#--#-#--#-#--#-#--#-#--#-#--#-#--#-#--#-#--#-#-
-#----#----#----#----#----#----#----#----#----#----#----#----#----#----#----#----#----#----#----#---
-###--###--###--###--###--###--###--###--###--###--###--###--###--###--###--###--###--###--###--###-
----------------------------------------------------------------------------------------------------
-##---##---##---##---##---##---##---##---##---##---##---##---##---##---##---##---##---##---##---##--
-#-#--#-#--#-#--#-#--#-#--#-#--#-#--#-#--#-#--#-#--#-#--#-#--#-#--#-#--#-#--#-#--#-#--#-#--#-#--#-#-
-#----#----#----#----#----#----#----#----#----#----#----#----#----#----#----#----#----#----#----#---
-###--###--###--###--###--###--###--###--###--###--###--###--###--###--###--###--###--###--###--###-
----------------------------------------------------------------------------------------------------
-##---##---##---##---##---##---##---##---##---##---##---##---##---##---##---##---##---##---##---##--
-#-#--#-#--#-#--#-#--#-#--#-#--#-#--#-#--#-#--#-#--#-#--#-#--#-#--#-#--#-#--#-#--#-#--#-#--#-#--#-#-
-#----#----#----#----#----#----#----#----#----#----#----#----#----#----#----#----#----#----#----#---
-###--###--###--###--###--###--###--###--###--###--###--###--###--###--###--###--###--###--###--###-
----------------------------------------------------------------------------------------------------
-##---##---##---##---##---##---##---##---##---##---##---##---##---##---##---##---##---##---##---##--
-#-#--#-#--#-#--#-#--#-#--#-#--#-#--#-#--#-#--#-#--#-#--#-#--#-#--#-#--#-#--#-#--#-#--#-#--#-#--#-#-
-#----#----#----#----#----#----#----#----#----#----#----#----#----#----#----#----#----#----#----#---
-###--###--###--###--###--###--###--###--###--###--###--###--###--###--###--###--###--###--###--###-
----------------------------------------------------------------------------------------------------
-##---##---##---##---##---##---##---##---##---##---##---##---##---##---##---##---##---##---##---##--
-#-#--#-#--#-#--#-#--#-#--#-#--#-#--#-#--#-#--#-#--#-#--#-#--#-#--#-#--#-#--#-#--#-#--#-#--#-#--#-#-
-#----#----#----#----#----#----#----#----#----#----#----#----#----#----#----#----#----#----#----#---
-###--###--###--###--###--###--###--###--###--###--###--###--###--###--###--###--###--###--###--###-
----------------------------------------------------------------------------------------------------
-##---##---##---##---##---##---##---##---##---##---##---##---##---##---##---##---##---##---##---##--
-#-#--#-#--#-#--#-#--#-#--#-#--#-#--#-#--#-#--#-#--#-#--#-#--#-#--#-#--#-#--#-#--#-#--#-#--#-#--#-#-
-#----#----#----#----#----#----#----#----#----#----#----#----#----#----#----#----#----#----#----#---
-###--###--###--###--###--###--###--###--###--###--###--###--###--###--###--###--###--###--###--###-
----------------E-----------------------------------------------------------------------------------
-##---##---##---##---##---##---##---##---##---##---##---##---##---##---##---##---##---##---##---##--
-#-#--#-#--#-#--#-#--#-#--#-#--#-#--#-#--#-#--#-#--#-#--#-#--#-#--#-#--#-#--#-#--#-#--#-#--#-#--#-#-
-#----#----#----#----#----#----#----#----#----#----#----#----#----#----#----#----#----#----#----#---
-###--###--###--###--###--###--###--###--###--###--###--###--###--###--###--###--###--###--###--###-
----------------------------------------------------------------------------------------------------
-##---##---##---##---##---##---##---##---##---##---##---##---##---##---##---##---##---##---##---##--
-#-#--#-#--#-#--#-#--#-#--#-#--#-#--#-#--#-#--#-#--#-#--#-#--#-#--#-#--#-#--#-#--#-#--#-#--#-#--#-#-
-#----#----#----#----#----#----#----#----#----#----#----#----#----#----#----#----#----#----#----#---
-###--###--###--###--###--###--###--###--###--###--###--###--###--###--###--###--###--###--###--###-
----------------------------------------------------------------------------------------------------
-##---##---##---##---##---##---##---##---##---##---##---##---##---##---##---##---##---##---##---##--
-#-#--#-#--#-#--#-#--#-#--#-#--#-#--#-#--#-#--#-#--#-#--#-#--#-#--#-#--#-#--#-#--#-#--#-#--#-#--#-#-
-#----#----#----#----#----#----#----#----#----#----#----#----#----#----#----#----#----#----#----#---
-###--###--###--###--###--###--###--###--###--###--###--###--###--###--###--###--###--###--###--###-
----------------------------------------------------------------------------------------------------
-##---##---##---##---##---##---##---##---##---##---##---##---##---##---##---##---##---##---##---##--
-#-#--#-#--#-#--#-#--#-#--#-#--#-#--#-#--#-#--#-#--#-#--#-#--#-#--#-#--#-#--#-#--#-#--#-#--#-#--#-#-
-#----#----#----#----#----#----#----#----#----#----#----#----#----#----#----#----#----#----#----#---
-###--###--###--###--###--###--###--###--###--###--###--###--###--###--###--###--###--###--###--###-
----------------------------------------------------------------------------------------------------
-##---##---##---##---##---##---##---##---##---##---##---##---##---##---##---##---##---##---##---##--
-#-#--#-#--#-#--#-#--#-#--#-#--#-#--#-#--#-#--#-#--#-#--#-#--#-#--#-#--#-#--#-#--#-#--#-#--#-#--#-#-
-#----#----#----#----#----#----#----#----#----#----#----#----#----#----#----#----#----#----#----#---
-###--###--###--###--###--###--###--###--###--###--###--###--###--###--###--###--###--###--###--###-
----------------------------------------------------------------------------------------------------
-##---##---##---##---##---##---##---##---##---##---##---##---##---##---##---##---##---##---##---##--
-#-#--#-#--#-#--#-#--#-#--#-#--#-#--#-#--#-#--#-#--#-#--#-#--#-#--#-#--#-#--#-#--#-#--#-#--#-#--#-#-
-#----#----#----#----#----#----#----#----#----#----#----#----#----#----#----#----#----#----#----#---
-###--###--###--###--###--###--###--###--###--###--###--###--###--###--###--###--###--###--###--###-
----------------------------------------------------------------------------------------------------
-##---##---##---##---##---##---##---##---##---##---##---##---##---##---##---##---##---##---##---##--
-#-#--#-#--#-#--#-#--#-#--#-#--#-#--#-#--#-#--#-#--#-#--#-#--#-#--#-#--#-#--#-#--#-#--#-#--#-#--#-#-
-#----#----#----#----#----#----#----#----#----#----#----#----#----#----#----#----#----#----#----#---
-###--###--###--###--###--###--###--###--###--###--###--###--###--###--###--###--###--###--###--###-
----------------------------------------------------------------------------------------------------
-##---##---##---##---##---##---##---##---##---##---##---##---##---##---##---##---##---##---##---##--
-#-#--#-#--#-#--#-#--#-#--#-#--#-#--#-#--#-#--#-#--#-#--#-#--#-#--#-#--#-#--#-#--#-#--#-#--#-#--#-#-
-#----#----#----#----#----#----#----#----#----#----#----#----#----#----#----#----#----#----#----#---
-###--###--###--###--###--###--###--###--###--###--###--###--###--###--###--###--###--###--###--###-
----------------------------------------------------------------------------------------------------
-##---##---##---##---##---##---##---##---##---##---##---##---##---##---##---##---##---##---##---##--
-#-#--#-#--#-#--#-#--#-#--#-#--#-#--#-#--#-#--#-#--#-#--#-#--#-#--#-#--#-#--#-#--#-#--#-#--#-#--#-#-
-#----#----#----#----#----#----#----#----#----#----#----#----#----#----#----#----#----#----#----#---
-###--###--###--###--###--###--###--###--###--###--###--###--###--###--###--###--###--###--###--###-
----------------------------------------------------------------------------------------------------