?diagonal=Never;
##-####-####-####-####-####-####-####-####-####-####-####-####-####-####-####-####-####-####-####-##
#----#----#----#----#----#----#----#----#----#----#----#----#----#----#----#----#----#----#----#----
#---##---##---##---##---##---##---##---##---##---##---##---##---##---##---##---##---##---##---##---#
----------------------------------------------------------------------------------------------------
---#----#----#----#----#----#----#----#----#----#----#----#----#----#----#----#----#----#----#----#-
##-####-####-####-####-####-####-####-####-####-####-####-####-####-####-####-####-####-####-####-##
#----#----#----#----#----#----#----#----#----#----#----#----#----#----#----#----#----#----#----#----
#---##---##---##---##---##---##---##---##---##---##---##---##---##---##---##---##---##---##---##---#
----------------------------------------------------------------------------------------------------
---#----#----#----#----#----#----#----#----#----#----#----#----#----#----#----#----#----#----#----#-
##-####-####-####-####-####-####-####-####-####-####-####-####-####-####-####-####-####-####-####-##
#----#----#----#----#----#----#----#----#----#----#----#----#----#----#----#----#----#----#----#----
#---##---##---##---##---##---##---##---##---##---##---##---##---##---##---##---##---##---##---##---#
----------------------------------------------------------------------------------------------------
---#----#----#----#----#----#----#----#----#----#----#----#----#----#----#----#----#----#----#----#-
##-####-####-####-####-####-####-####-####-####-####-####-####-####-####-####-####-####-####-####-##
#----#----#----#----#----#----#----#----#----#----#----#----#----#----#----#----#----#----#----#----
#---##---##---##---##---##---##---##---##---##---##---##---##---##---##---##---##---##---##---##---#
----------------------------------------------------------------------------------------------------
---#----#----#----#----#----#----#----#----#----#----#----#----#----#----#----#----#----#----#----#-
##-####-####-####-####-####-####-####-####-####-####-####-####-####-####-####-####-####-####-####-##
#----#----#----#----#----#----#----#----#----#----#----#----#----#----#----#----#----#----#----#----
#---##---##---##---##---##---##---##---##---##---##---##---##---##---##---##---##---##---##---##---#
----------------------------------------------------------------------------------------------------
---#----#----#----#----#----#----#----#----#----#----#----#----#----#----#----#----#----#----#----#-
##-####-####-####-####-####-####-####-####-####-####-####-####-####-####-####-####-####-####-####-##
#----#----#----#----#----#----#----#----#----#----#----#----#----#----#----#----#----#----#----#----
#---##---##---##---##---##---##---##---##---##---##---##---##---##---##---##---##---##---##---##---#
----------------------------------------------------------------------------------------------------
---#----#----#----#----#----#----#----#----#----#----#----#----#----#----#----#----#----#----#----#-
##-####-####-####-####-####-####-####-####-####-####-####-####-####-####-####-####-####-####-####-##
#----#----#----#----#----#----#----#----#----#----#----#----#----#----#----#----#----#----#----#----
#---##---##---##---##---##---##---##---##---##---##---##---##---##---##---##---##---##---##---##---#
----------------------------------------------------------------------------------------------------
---#----#----#----#----#----#----#----#----#----#----#----#----#----#----#----#----#----#----#----#-
##-####-####-####-####-####-####-####-####-####-####-####-####-####-####-####-####-####-####-####-##
#----#----#----#----#----#----#----#----#----#----#----#----#----#----#----#----#----#----#----#----
#---##---##---##---##---##---##---##---##---##---##---##---##---##---##---##---##---##---##---##---#
----------------------------------------------------------------------------------------------------
---#----#----#----#----#----#----#----#----#----#----#----#----#----#----#----#----#----#----#----#-
##-####-####-####-####-####-####-####-####-####-####-####-####-####-####-####-####-####-####-####-##
#----#----#----#----#----#----#----#----#----#----#----#----#----#----#----#----#----#----#----#----
#---##---##---##---##---##---##---##---##---##---##---##---##---##---##---##---##---##---##---##---#
----------------------------------------------------------------------------------------------------
---#----#----#----#----#----#----#----#----#----#----#----#----#----#----#----#----#----#----#----#-
##-####-####-####-####-####-####-####-####-####-####-####-####-####-####-####-####-####-####-####-##
#----#----#----#----#----#----#----#----#----#----#----#----#----#----#----#----#----#----#S---#----
#---##---##---##---##---##---##---##---##---##---##---##---##---##---##---##---##---##---##---##---#
----------------------------------------------------------------------------------------------------
---#----#----#----#----#----#----#----#----#----#----#----#----#----#----#----#----#----#----#----#-
##-####-####-####-####-####-####-####-####-####-####-####-####-####-####-####-####-####-####-####-##
#----#----#----#----#----#----#----#----#----#E---#----#----#----#----#----#----#----#----#----#----
#---##---##---##---##---##---##---##---##---##---##---##---##---##---##---##---##---##---##---##---#
----------------------------------------------------------------------------------------------------
---#----#----#----#----#----#----#----#----#----#----#----#----#----#----#----#----#----#----#----#-
##-####-####-####-####-####-####-####-####-####-####-####-####-####-####-####-####-####-####-####-##
#----#----#----#----#----#----#----#----#----#----#----#----#----#----#----#----#----#----#----#----
#---##---##---##---##---##---##---##---##---##---##---##---##---##---##---##---##---##---##---##---#
----------------------------------------------------------------------------------------------------
---#----#----#----#----#----#----#----#----#----#----#----#----#----#----#----#----#----#----#----#-
##-####-####-####-####-####-####-####-####-####-####-####-####-####-####-####-####-####-####-####-##
#----#----#----#----#----#----#----#----#----#----#----#----#----#----#----#----#----#----#----#----
#---##---##---##---##---##---##---##---##---##---##---##---##---##---##---##---##---##---##---##---#
----------------------------------------------------------------------------------------------------
---#----#----#----#----#----#----#----#----#----#----#----#----#----#----#----#----#----#----#----#-
##-####-####-####-####-####-####-####-####-####-####-####-####-####-####-####-####-####-####-####-##
#----#----#----#----#----#----#----#----#----#----#----#----#----#----#----#----#----#----#----#----
#---##---##---##---##---##---##---##---##---##---##---##---##---##---##---##---##---##---##---##---#
----------------------------------------------------------------------------------------------------
---#----#----#----#----#----#----#----#----#----#----#----#----#----#----#----#----#----#----#----#-
##-####-####-####-####-####-####-####-####-####-####-####-####-####-####-####-####-####-####-####-##
#----#----#----#----#----#----#----#----#----#----#----#----#----#----#----#----#----#----#----#----
#---##---##---##---##---##---##---##---##---##---##---##---##---##---##---##---##---##---##---##---#
----------------------------------------------------------------------------------------------------
---#----#----#----#----#----#----#----#----#----#----#----#----#----#----#----#----#----#----#----#-
##-####-####-####-####-####-####-####-####-####-####-####-####-####-####-####-####-####-####-####-##
#----#----#----#----#----#----#----#----#----#----#----#----#----#----#----#----#----#----#----#----
#---##---##---##---##---##---##---##---##---##---##---##---##---##---##---##---##---##---##---##---#
----------------------------------------------------------------------------------------------------
---#----#----#----#----#----#----#----#----#----#----#----#----#----#----#----#----#----#----#----#-
##-####-####-####-####-####-####-####-####-####-####-####-####-####-####-####-####-####-####-####-##
#----#----#----#----#----#----#----#----#----#----#----#----#----#----#----#----#----#----#----#----
#---##---##---##---##---##---##---##---##---##---##---##---##---##---##---##---##---##---##---##---#
----------------------------------------------------------------------------------------------------
---#----#----#----#----#----#----#----#----#----#----#----#----#----#----#----#----#----#----#----#-
##-####-####-####-####-####-####-####-####-####-####-####-####-####-####-####-####-####-####-####-##
#----#----#----#----#----#----#----#----#----#----#----#----#----#----#----#----#----#----#----#----
#---##---##---##---##---##---##---##---##---##---##---##---##---##---##---##---##---##---##---##---#
----------------------------------------------------------------------------------------------------
---#----#----#----#----#----#----#----#----#----#----#----#----#----#----#----#----#----#----#----#-
##-####-####-####-####-####-####-####-####-####-####-####-####-####-####-####-####-####-####-####-##
#----#----#----#----#----#----#----#----#----#----#----#----#----#----#----#----#----#----#----#----
#---##---##---##---##---##---##---##---##---##---##---##---##---##---##---##---##---##---##---##---#
----------------------------------------------------------------------------------------------------
---#----#----#----#----#----#----#----#----#----#----#----#----#----#----#----#----#----#----#----#-
##-####-####-####-####-####-####-####-####-####-####-####-####-####-####-####-####-####-####-####-##
#----#----#----#----#----#----#----#----#----#----#----#----#----#----#----#----#----#----#----#----
#---##---##---##---##---##---##---##---##---##---##---##---##---##---##---##---##---##---##---##---#
----------------------------------------------------------------------------------------------------
---#----#----#----#----#----#----#----#----#----#----#----#----#----#----#----#----#----#----#----#-