?diagonal=Never;
-###--###--###--###--###--###--###--###--###--###--###--###--###--###--###--###--###--###--###--###-
#----#----#----#----#----#----#----#----#----#----#----#----#----#----#----#----#----#----#----#----
----#----#----#----#----#----#----#----#--S-#----#----#----#----#----#----#----#----#----#----#----#
#-#-##-#-##-#-##-#-##-#-##-#-##-#-##-#-##-#-##-#-##-#-##-#-##-#-##-#-##-#-##-#-##-#-##-#-##-#-##-#-#
----------------------------------------------------------------------------------------------------
-###--###--###--###--###--###--###--###--###--###--###--###--###--###--###--###--###--###--###--###-
#----#----#----#----#----#----#----#----#----#----#----#----#----#----#----#----#----#----#----#----
----#----#----#----#----#----#----#----#----#----#----#----#----#----#----#----#----#----#----#----#
#-#-##-#-##-#-##-#-##-#-##-#-##-#-##-#-##-#-##-#-##-#-##-#-##-#-##-#-##-#-##-#-##-#-##-#-##-#-##-#-#
----------------------------------------------------------------------------------------------------
-###--###--###--###--###--###--###--###--###--###--###--###--###--###--###--###--###--###--###--###-
#----#----#----#----#----#----#----#----#----#----#----#----#----#----#----#----#----#----#----#----
----#----#----#----#----#----#----#----#----#----#----#----#----#----#----#----#----#----#----#----#
#-#-##-#-##-#-##-#-##-#-##-#-##-#-##-#-##-#-##-#-##-#-##-#-##-#-##-#-##-#-##-#-##-#-##-#-##-#-##-#-#
----------------------------------------------------------------------------------------------------
-###--###--###--###--###--###--###--###--###--###--###--###--###--###--###--###--###--###--###--###-
#----#----#----#----#----#----#----#----#----#----#----#----#----#----#----#----#----#----#----#----
----#----#----#----#----#----#----#----#----#----#----#----#----#----#----#----#----#----#----#----#
#-#-##-#-##-#-##-#-##-#-##-#-##-#-##-#-##-#-##-#-##-#-##-#-##-#-##-#-##-#-##-#-##-#-##-#-##-#-##-#-#
----------------------------------------------------------------------------------------------------
-###--###--###--###--###--###--###--###--###--###--###--###--###--###--###--###--###--###--###--###-
#----#----#----#----#----#----#----#----#----#----#----#----#----#----#----#----#----#----#----#----
----#----#----#----#----#----#----#----#----#----#----#----#----#----#----#----#----#----#----#----#
#-#-##-#-##-#-##-#-##-#-##-#-##-#-##-#-##-#-##-#-##-#-##-#-##-#-##-#-##-#-##-#-##-#-##-#-##-#-##-#-#
----------------------------------------------------------------------------------------------------
-###--###--###--###--###--###--###--###--###--###--###--###--###--###--###--###--###--###--###--###-
#----#----#----#----#----#----#----#----#----#----#----#----#----#----#----#----#----#----#----#----
----#----#----#----#----#----#----#----#----#----#----#----#----#----#----#----#----#----#----#----#
#-#-##-#-##-#-##-#-##-#-##-#-##-#-##-#-##-#-##-#-##-#-##-#-##-#-##-#-##-#-##-#-##-#-##-#-##-#-##-#-#
----------------------------------------------------------------------------------------------------
-###--###--###--###--###--###--###--###--###--###--###--###--###--###--###--###--###--###--###--###-
#----#----#----#----#----#----#----#----#----#----#----#----#----#----#----#----#----#----#----#----
----#----#----#----#----#----#----#----#----#----#----#----#----#----#----#----#----#----#----#----#
#-#-##-#-##-#-##-#-##-#-##-#-##-#-##-#-##-#-##-#-##-#-##-#-##-#-##-#-##-#-##-#-##-#-##-#-##-#-##-#-#
----------------------------------------------------------------------------------------------------
-###--###--###--###--###--###--###--###--###--###--###--###--###--###--###--###--###--###--###--###E
#----#----#----#----#----#----#----#----#----#----#----#----#----#----#----#----#----#----#----#----
----#----#----#----#----#----#----#----#----#----#----#----#----#----#----#----#----#----#----#----#
#-#-##-#-##-#-##-#-##-#-##-#-##-#-##-#-##-#-##-#-##-#-##-#-##-#-##-#-##-#-##-#-##-#-##-#-##-#-##-#-#
----------------------------------------------------------------------------------------------------
-###--###--###--###--###--###--###--###--###--###--###--###--###--###--###--###--###--###--###--###-
#----#----#----#----#----#----#----#----#----#----#----#----#----#----#----#----#----#----#----#----
----#----#----#----#----#----#----#----#----#----#----#----#----#----#----#----#----#----#----#----#
#-#-##-#-##-#-##-#-##-#-##-#-##-#-##-#-##-#-##-#-##-#-##-#-##-#-##-#-##-#-##-#-##-#-##-#-##-#-##-#-#
----------------------------------------------------------------------------------------------------
-###--###--###--###--###--###--###--###--###--###--###--###--###--###--###--###--###--###--###--###-
#----#----#----#----#----#----#----#----#----#----#----#----#----#----#----#----#----#----#----#----
----#----#----#----#----#----#----#----#----#----#----#----#----#----#----#----#----#----#----#----#
#-#-##-#-##-#-##-#-##-#-##-#-##-#-##-#-##-#-##-#-##-#-##-#-##-#-##-#-##-#-##-#-##-#-##-#-##-#-##-#-#
----------------------------------------------------------------------------------------------------
-###--###--###--###--###--###--###--###--###--###--###--###--###--###--###--###--###--###--###--###-
#----#----#----#----#----#----#----#----#----#----#----#----#----#----#----#----#----#----#----#----
----#----#----#----#----#----#----#----#----#----#----#----#----#----#----#----#----#----#----#----#
#-#-##-#-##-#-##-#-##-#-##-#-##-#-##-#-##-#-##-#-##-#-##-#-##-#-##-#-##-#-##-#-##-#-##-#-##-#-##-#-#
----------------------------------------------------------------------------------------------------
-###--###--###--###--###--###--###--###--###--###--###--###--###--###--###--###--###--###--###--###-
#----#----#----#----#----#----#----#----#----#----#----#----#----#----#----#----#----#----#----#----
----#----#----#----#----#----#----#----#----#----#----#----#----#----#----#----#----#----#----#----#
#-#-##-#-##-#-##-#-##-#-##-#-##-#-##-#-##-#-##-#-##-#-##-#-##-#-##-#-##-#-##-#-##-#-##-#-##-#-##-#-#
----------------------------------------------------------------------------------------------------
-###--###--###--###--###--###--###--###--###--###--###--###--###--###--###--###--###--###--###--###-
#----#----#----#----#----#----#----#----#----#----#----#----#----#----#----#----#----#----#----#----
----#----#----#----#----#----#----#----#----#----#----#----#----#----#----#----#----#----#----#----#
#-#-##-#-##-#-##-#-##-#-##-#-##-#-##-#-##-#-##-#-##-#-##-#-##-#-##-#-##-#-##-#-##-#-##-#-##-#-##-#-#
----------------------------------------------------------------------------------------------------
-###--###--###--###--###--###--###--###--###--###--###--###--###--###--###--###--###--###--###--###-
#----#----#----#----#----#----#----#----#----#----#----#----#----#----#----#----#----#----#----#----
----#----#----#----#----#----#----#----#----#----#----#----#----#----#----#----#----#----#----#----#
#-#-##-#-##-#-##-#-##-#-##-#-##-#-##-#-##-#-##-#-##-#-##-#-##-#-##-#-##-#-##-#-##-#-##-#-##-#-##-#-#
----------------------------------------------------------------------------------------------------
-###--###--###--###--###--###--###--###--###--###--###--###--###--###--###--###--###--###--###--###-
#----#----#----#----#----#----#----#----#----#----#----#----#----#----#----#----#----#----#----#----
----#----#----#----#----#----#----#----#----#----#----#----#----#----#----#----#----#----#----#----#
#-#-##-#-##-#-##-#-##-#-##-#-##-#-##-#-##-#-##-#-##-#-##-#-##-#-##-#-##-#-##-#-##-#-##-#-##-#-##-#-#
----------------------------------------------------------------------------------------------------
-###--###--###--###--###--###--###--###--###--###--###--###--###--###--###--###--###--###--###--###-
#----#----#----#----#----#----#----#----#----#----#----#----#----#----#----#----#----#----#----#----
----#----#----#----#----#----#----#----#----#----#----#----#----#----#----#----#----#----#----#----#
#-#-##-#-##-#-##-#-##-#-##-#-##-#-##-#-##-#-##-#-##-#-##-#-##-#-##-#-##-#-##-#-##-#-##-#-##-#-##-#-#
----------------------------------------------------------------------------------------------------
-###--###--###--###--###--###--###--###--###--###--###--###--###--###--###--###--###--###--###--###-
#----#----#----#----#----#----#----#----#----#----#----#----#----#----#----#----#----#----#----#----
----#----#----#----#----#----#----#----#----#----#----#----#----#----#----#----#----#----#----#----#
#-#-##-#-##-#-##-#-##-#-##-#-##-#-##-#-##-#-##-#-##-#-##-#-##-#-##-#-##-#-##-#-##-#-##-#-##-#-##-#-#
----------------------------------------------------------------------------------------------------
-###--###--###--###--###--###--###--###--###--###--###--###--###--###--###--###--###--###--###--###-
#----#----#----#----#----#----#----#----#----#----#----#----#----#----#----#----#----#----#----#----
----#----#----#----#----#----#----#----#----#----#----#----#----#----#----#----#----#----#----#----#
#-#-##-#-##-#-##-#-##-#-##-#-##-#-##-#-##-#-##-#-##-#-##-#-##-#-##-#-##-#-##-#-##-#-##-#-##-#-##-#-#
----------------------------------------------------------------------------------------------------
-###--###--###--###--###--###--###--###--###--###--###--###--###--###--###--###--###--###--###--###-
#----#----#----#----#----#----#----#----#----#----#----#----#----#----#----#----#----#----#----#----
----#----#----#----#----#----#----#----#----#----#----#----#----#----#----#----#----#----#----#----#
#-#-##-#-##-#-##-#-##-#-##-#-##-#-##-#-##-#-##-#-##-#-##-#-##-#-##-#-##-#-##-#-##-#-##-#-##-#-##-#-#
----------------------------------------------------------------------------------------------------
-###--###--###--###--###--###--###--###--###--###--###--###--###--###--###--###--###--###--###--###-
#----#----#----#----#----#----#----#----#----#----#----#----#----#----#----#----#----#----#----#----
----#----#----#----#----#----#----#----#----#----#----#----#----#----#----#----#----#----#----#----#
#-#-##-#-##-#-##-#-##-#-##-#-##-#-##-#-##-#-##-#-##-#-##-#-##-#-##-#-##-#-##-#-##-#-##-#-##-#-##-#-#
----------------------------------------------------------------------------------------------------