?diagonal=Never;
----#----#----#----#----#----#----#----#----#----#----#----#----#----#----#----#----#----#----#----#
----------------------------------------------------------------------------------------------------
#---##---##---##---##---##---##---##---##---##---##---##---##---##---##---##---##---##---##---##---#
--##---##---##---##---##---##---##---##---##---##---##---##---##---##---##---##---##---##---##---##-
#--###--###--###--###--###--###--###--###--###--###--###--###--###--###--###--###--###--###--###--##
----#----#----#----#----#----#----#----#----#----#----#----#----#----#----#----#----#----#----#----#
----------------------------------------------------------------------------------------------------
#---##---##---##---##---##---##---##---##---##---##---##---##---##---##---##---##---##---##---##---#
--##---##---##---##---##---##---##---##---##---##---##---##---##---##---##---##---##---##---##---##-
#--###--###--###--###--###--###--###--###--###--###--###--###--###--###--###--###--###--###--###--##
----#----#----#----#----#----#----#----#----#----#----#----#----#----#----#----#----#----#----#----#
----------------------------------------------------------------------------------------------------
#---##---##---##---##---##---##---##---##---##---##---##---##---##---##---##---##---##---##---##---#
--##---##---##---##---##---##---##---##---##---##---##---##---##---##---##---##---##---##---##---##-
#--###--###--###--###--###--###--###--###--###--###--###--###--###--###--###--###--###--###--###--##
----#----#----#----#----#----#----#----#----#----#----#----#----#----#----#----#----#----#----#----#
----------------------------------------------------------------------------------------------------
#---##---##---##---##---##---##---##---##---##---##---##---##---##---##---##---##---##---##---##---#
--##---##---##---##---##---##---##---##---##---##---##---##---##---##---##---##---##---##---##---##-
#--###--###--###--###--###--###--###--###--###--###--###--###--###--###--###--###--###--###--###--##
----#----#----#----#----#----#----#----#----#----#----#----#----#----#----#----#----#----#----#----#
----------------------------------------------------------------------------------------------------
#---##---##---##---##---##---##---##---##---##---##---##---##---##---##---##---##---##---##---##---#
--##---##---##---##---##---##---##---##---##---##---##---##---##---##---##---##---##---##---##---##-
#--###--###--###--###--###--###--###--###--###--###--###--###--###--###--###--###--###--###--###--##
----#----#----#----#----#----#----#----#----#----#----#----#----#----#----#----#----#----#----#----#
----------------------------------------------------------------------------------------------------
#---##---##---##---##---##---##---##---##---##---##---##---##---##---##---##---##---##---##---##---#
--##---##---##---##---##---##---##---##---##---##---##---##---##---##---##---##---##---##---##---##-
#--###--###--###--###--###--###--###--###--###--###--###--###--###--###--###--###--###--###--###--##
----#----#----#----#----#----#----#----#----#----#----#----#----#----#----#----#----#----#----#----#
----------------------------------------------------------------------------------------------------
#---##---##---##---##---##---##---##---##---##---##---##---##---##---##---##---##---##---##---##---#
--##---##---##---##---##---##---##---##---##---##---##---##---##---##---##---##---##---##---##---##-
#--###--###--###--###--###--###--###--###--###--###--###--###--###--###--###--###--###--###--###--##
----#----#----#----#----#----#----#----#----#----#----#---E#----#----#----#----#----#----#----#----#
----------------------------------------------------------------------------------------------------
#---##---##---##---##---##---##---##---##---##---##---##---##---##---##---##---##---##---##---##---#
--##---##---##---##---##---##---##---##---##---##---##---##---##---##---##---##---##---##---##---##-
#--###--###--###--###--###--###--###--###--###--###--###--###--###--###--###--###--###--###--###--##
----#----#----#----#----#----#----#----#----#----#----#----#----#----#----#----#----#----#----#----#
----------------------------------------------------------------------------------------------------
#---##---##---##---##---##---##---##---##---##---##---##---##---##---##---##---##---##---##---##---#
--##---##---##---##---##---##---##---##---##---##---##---##---##---##---##---##---##---##---##---##-
#--###--###--###--###--###--###--###--###--###--###--###--###--###--###--###--###--###--###--###--##
----#----#----#----#----#----#----#----#----#----#----#----#----#----#----#----#----#----#----#----#
----------------------------------------------------------------------------------------------------
#---##---##---##---##---##---##---##---##---##---##---##---##---##---##---##---##---##---##---##---#
--##---##---##---##---##---##---##---##---##---##---##---##---##---##---##---##---##---##---##---##-
#--###--###--###--###--###--###--###--###--###--###--###--###--###--###--###--###--###--###--###--##
----#----#----#----#----#----#----#----#----#----#----#----#----#----#----#----#----#----#----#----#
----------------------------------------------------------------------------------------------------
#---##---##---##---##---##---##---##---##---##---##---##---##---##---##---##---##---##---##---##---#
--##---##---##---##---##---##---##---##---##---##---##---##---##---##---##---##---##---##---##---##-
#--###--###--###--###--###--###--###--###--###--###--###--###--###--###--###--###--###--###--###--##
----#----#----#----#----#----#----#----#----#----#----#----#----#----#----#----#----#----#----#----#
----------------------------------------------------------------------------------------------------
#---##---##---##---##---##---##---##---##---##---##---##---##---##---##---##---##---##---##---##---#
--##---##---##---##---##---##---##---##---##---##---##---##---##---##---##---##---##---##---##---##-
#--###--###--###--###--###--###--###--###--###--###--###--###--###--###--###--###--###--###--###--##
----#----#----#----#----#----#----#----#----#----#----#----#----#----#----#----#----#----#----#----#
----------------------------------------------------------------------------------------------------
#---##---##---##---##---##---##---##---##---##---##---##---##---##---##---##---##---##---##---##---#
--##---##---##---##---##---##---##---##---##---##---##---##---##---##---##---##---##---##---##---##-
#--###--###--###--###--###--###--###--###--###--###--###--###--###--###--###--###--###--###--###--##
----#----#----#----#----#----#----#----#----#----#----#----#----#----#----#----#----#----#----#----#
----------------------------------------------------------------------------------------------------
#---##---##---##---##---##---##---##---##---##---##---##---##---##---##---##---##---##---##---##---#
--##---##---##---##---##---##---##---##---##---##---##---##---##---##---##---##---##---##---##---##-
#--###--###--###--###--###--###--###--###--###--###--###--###--###--###--###--###--###--###--###--##
----#----#----#----#----#----#----#----#----#----#----#----#----#----#----#----#----#----#----#----#
----------------------------------------------------------------------------------------------------
#---##---##---##---##---##---##---##---##---##---##---##---##---##---##---##---##---##---##---##---#
--##---##---##---##---##---##---##---##---##---##---##---##---##---##---##---##---##---##---##---##-
#--###--###--###--###--###--###--###--###--###--###--###--###--###--###--###--###--###--###--###--##
----#----#----#----#----#----#----#----#----#----#----#----#----#----#----#----#----#----#----#----#
----------------------------------------------------------------------------------------------------
#---##---##---##---##---##---##---##---##---##---##---##---##---##---##---##---##---##---##---##---#
--##---##---##---##---##---##---##---##---##---##---##---##---##---##---##---##---##---##---##---##-
#--###--###--###--###--###--###--###--###--###--###--###--###--###--###--###--###--###--###--###--##
----#----#----#----#----#----#----#----#----#----#----#----#----#----#----#----#----#----#----#----#
----------------------------------------------------------------------------------------------------
#---##---##---##---##---##---##---##---##---##---##---##---##---##---##---##---##---##---##---##---#
--##---##---##---##---##--S##---##---##---##---##---##---##---##---##---##---##---##---##---##---##-
#--###--###--###--###--###--###--###--###--###--###--###--###--###--###--###--###--###--###--###--##
----#----#----#----#----#----#----#----#----#----#----#----#----#----#----#----#----#----#----#----#
----------------------------------------------------------------------------------------------------
#---##---##---##---##---##---##---##---##---##---##---##---##---##---##---##---##---##---##---##---#
--##---##---##---##---##---##---##---##---##---##---##---##---##---##---##---##---##---##---##---##-
#--###--###--###--###--###--###--###--###--###--###--###--###--###--###--###--###--###--###--###--##
----#----#----#----#----#----#----#----#----#----#----#----#----#----#----#----#----#----#----#----#
----------------------------------------------------------------------------------------------------
#---##---##---##---##---##---##---##---##---##---##---##---##---##---##---##---##---##---##---##---#
--##---##---##---##---##---##---##---##---##---##---##---##---##---##---##---##---##---##---##---##-
#--###--###--###--###--###--###--###--###--###--###--###--###--###--###--###--###--###--###--###--##
----#----#----#----#----#----#----#----#----#----#----#----#----#----#----#----#----#----#----#----#
----------------------------------------------------------------------------------------------------
#---##---##---##---##---##---##---##---##---##---##---##---##---##---##---##---##---##---##---##---#
--##---##---##---##---##---##---##---##---##---##---##---##---##---##---##---##---##---##---##---##-
#--###--###--###--###--###--###--###--###--###--###--###--###--###--###--###--###--###--###--###--##