?diagonal=Never;
#--#-#--#-#--#-#--#-#--#-#--#-#--#-#--#-#--#-#--#-#--#-#--#-#--#-#--#-#--#-#--#-#--#-#--#-#--#-#--#-
--#----#----#----#----#----#----#----#----#----#----#----#----#----#----#----#----#----#----#----#--
----#----#----#----#----#----#----#----#----#----#----#----#----#----#----#----#----#----#----#----#
----------------------------------------------------------------------------------------------------
#----#----#----#----#----#----#----#----#----#----#----#----#----#----#----#----#----#----#----#----
#--#-#--#-#--#-#--#-#--#-#--#-#--#-#--#-#--#-#--#-#--#-#--#-#--#-#--#-#--#-#--#-#--#-#--#-#--#-#--#-
--#----#----#----#----#---S#----#----#----#----#----#----#----#----#----#----#----#----#----#----#--
----#----#----#----#----#----#----#----#----#----#----#----#----#----#----#----#----#----#----#----#
----------------------------------------------------------------------------------------------------
#----#----#----#----#----#----#----#----#----#----#----#----#----#----#----#----#----#----#----#----
#--#-#--#-#--#-#--#-#--#-#--#-#--#-#--#-#--#-#--#-#--#-#--#-#--#-#--#-#--#-#--#-#--#-#--#-#--#-#--#-
--#----#----#----#----#----#----#----#----#----#----#----#----#----#----#----#----#----#----#----#--
----#----#----#----#----#----#----#----#----#----#----#----#----#----#----#----#----#----#----#----#
----------------------------------------------------------------------------------------------------
#----#----#----#----#----#----#----#----#----#----#----#----#----#----#----#----#----#----#----#----
#--#-#--#-#--#-#--#-#--#-#--#-#--#-#--#-#--#-#--#-#--#-#--#-#--#-#--#-#--#-#--#-#--#-#--#-#--#-#--#-
--#----#----#----#----#----#----#----#----#----#----#----#----#----#----#----#----#----#----#----#--
----#----#----#----#----#----#----#----#----#----#----#----#----#----#----#----#----#----#----#----#
----------------------------------------------------------------------------------------------------
#----#----#----#----#----#----#----#----#----#----#----#----#----#----#----#----#----#----#----#----
#--#-#--#-#--#-#--#-#--#-#--#-#--#-#--#-#--#-#--#-#--#-#--#-#--#-#--#-#--#-#--#-#--#-#--#-#--#-#--#-
--#----#---E#----#----#----#----#----#----#----#----#----#----#----#----#----#----#----#----#----#--
----#----#----#----#----#----#----#----#----#----#----#----#----#----#----#----#----#----#----#----#
----------------------------------------------------------------------------------------------------
#----#----#----#----#----#----#----#----#----#----#----#----#----#----#----#----#----#----#----#----
#--#-#--#-#--#-#--#-#--#-#--#-#--#-#--#-#--#-#--#-#--#-#--#-#--#-#--#-#--#-#--#-#--#-#--#-#--#-#--#-
--#----#----#----#----#----#----#----#----#----#----#----#----#----#----#----#----#----#----#----#--
----#----#----#----#----#----#----#----#----#----#----#----#----#----#----#----#----#----#----#----#
----------------------------------------------------------------------------------------------------
#----#----#----#----#----#----#----#----#----#----#----#----#----#----#----#----#----#----#----#----
#--#-#--#-#--#-#--#-#--#-#--#-#--#-#--#-#--#-#--#-#--#-#--#-#--#-#--#-#--#-#--#-#--#-#--#-#--#-#--#-
--#----#----#----#----#----#----#----#----#----#----#----#----#----#----#----#----#----#----#----#--
----#----#----#----#----#----#----#----#----#----#----#----#----#----#----#----#----#----#----#----#
----------------------------------------------------------------------------------------------------
#----#----#----#----#----#----#----#----#----#----#----#----#----#----#----#----#----#----#----#----
#--#-#--#-#--#-#--#-#--#-#--#-#--#-#--#-#--#-#--#-#--#-#--#-#--#-#--#-#--#-#--#-#--#-#--#-#--#-#--#-
--#----#----#----#----#----#----#----#----#----#----#----#----#----#----#----#----#----#----#----#--
----#----#----#----#----#----#----#----#----#----#----#----#----#----#----#----#----#----#----#----#
----------------------------------------------------------------------------------------------------
#----#----#----#----#----#----#----#----#----#----#----#----#----#----#----#----#----#----#----#----
#--#-#--#-#--#-#--#-#--#-#--#-#--#-#--#-#--#-#--#-#--#-#--#-#--#-#--#-#--#-#--#-#--#-#--#-#--#-#--#-
--#----#----#----#----#----#----#----#----#----#----#----#----#----#----#----#----#----#----#----#--
----#----#----#----#----#----#----#----#----#----#----#----#----#----#----#----#----#----#----#----#
----------------------------------------------------------------------------------------------------
#----#----#----#----#----#----#----#----#----#----#----#----#----#----#----#----#----#----#----#----
#--#-#--#-#--#-#--#-#--#-#--#-#--#-#--#-#--#-#--#-#--#-#--#-#--#-#--#-#--#-#--#-#--#-#--#-#--#-#--#-
--#----#----#----#----#----#----#----#----#----#----#----#----#----#----#----#----#----#----#----#--
----#----#----#----#----#----#----#----#----#----#----#----#----#----#----#----#----#----#----#----#
----------------------------------------------------------------------------------------------------
#----#----#----#----#----#----#----#----#----#----#----#----#----#----#----#----#----#----#----#----
#--#-#--#-#--#-#--#-#--#-#--#-#--#-#--#-#--#-#--#-#--#-#--#-#--#-#--#-#--#-#--#-#--#-#--#-#--#-#--#-
--#----#----#----#----#----#----#----#----#----#----#----#----#----#----#----#----#----#----#----#--
----#----#----#----#----#----#----#----#----#----#----#----#----#----#----#----#----#----#----#----#
----------------------------------------------------------------------------------------------------
#----#----#----#----#----#----#----#----#----#----#----#----#----#----#----#----#----#----#----#----
#--#-#--#-#--#-#--#-#--#-#--#-#--#-#--#-#--#-#--#-#--#-#--#-#--#-#--#-#--#-#--#-#--#-#--#-#--#-#--#-
--#----#----#----#----#----#----#----#----#----#----#----#----#----#----#----#----#----#----#----#--
----#----#----#----#----#----#----#----#----#----#----#----#----#----#----#----#----#----#----#----#
----------------------------------------------------------------------------------------------------
#----#----#----#----#----#----#----#----#----#----#----#----#----#----#----#----#----#----#----#----
#--#-#--#-#--#-#--#-#--#-#--#-#--#-#--#-#--#-#--#-#--#-#--#-#--#-#--#-#--#-#--#-#--#-#--#-#--#-#--#-
--#----#----#----#----#----#----#----#----#----#----#----#----#----#----#----#----#----#----#----#--
----#----#----#----#----#----#----#----#----#----#----#----#----#----#----#----#----#----#----#----#
----------------------------------------------------------------------------------------------------
#----#----#----#----#----#----#----#----#----#----#----#----#----#----#----#----#----#----#----#----
#--#-#--#-#--#-#--#-#--#-#--#-#--#-#--#-#--#-#--#-#--#-#--#-#--#-#--#-#--#-#--#-#--#-#--#-#--#-#--#-
--#----#----#----#----#----#----#----#----#----#----#----#----#----#----#----#----#----#----#----#--
----#----#----#----#----#----#----#----#----#----#----#----#----#----#----#----#----#----#----#----#
----------------------------------------------------------------------------------------------------
#----#----#----#----#----#----#----#----#----#----#----#----#----#----#----#----#----#----#----#----
#--#-#--#-#--#-#--#-#--#-#--#-#--#-#--#-#--#-#--#-#--#-#--#-#--#-#--#-#--#-#--#-#--#-#--#-#--#-#--#-
--#----#----#----#----#----#----#----#----#----#----#----#----#----#----#----#----#----#----#----#--
----#----#----#----#----#----#----#----#----#----#----#----#----#----#----#----#----#----#----#----#
----------------------------------------------------------------------------------------------------
#----#----#----#----#----#----#----#----#----#----#----#----#----#----#----#----#----#----#----#----
#--#-#--#-#--#-#--#-#--#-#--#-#--#-#--#-#--#-#--#-#--#-#--#-#--#-#--#-#--#-#--#-#--#-#--#-#--#-#--#-
--#----#----#----#----#----#----#----#----#----#----#----#----#----#----#----#----#----#----#----#--
----#----#----#----#----#----#----#----#----#----#----#----#----#----#----#----#----#----#----#----#
----------------------------------------------------------------------------------------------------
#----#----#----#----#----#----#----#----#----#----#----#----#----#----#----#----#----#----#----#----
#--#-#--#-#--#-#--#-#--#-#--#-#--#-#--#-#--#-#--#-#--#-#--#-#--#-#--#-#--#-#--#-#--#-#--#-#--#-#--#-
--#----#----#----#----#----#----#----#----#----#----#----#----#----#----#----#----#----#----#----#--
----#----#----#----#----#----#----#----#----#----#----#----#----#----#----#----#----#----#----#----#
----------------------------------------------------------------------------------------------------
#----#----#----#----#----#----#----#----#----#----#----#----#----#----#----#----#----#----#----#----
#--#-#--#-#--#-#--#-#--#-#--#-#--#-#--#-#--#-#--#-#--#-#--#-#--#-#--#-#--#-#--#-#--#-#--#-#--#-#--#-
--#----#----#----#----#----#----#----#----#----#----#----#----#----#----#----#----#----#----#----#--
----#----#----#----#----#----#----#----#----#----#----#----#----#----#----#----#----#----#----#----#
----------------------------------------------------------------------------------------------------
#----#----#----#----#----#----#----#----#----#----#----#----#----#----#----#----#----#----#----#----
#--#-#--#-#--#-#--#-#--#-#--#-#--#-#--#-#--#-#--#-#--#-#--#-#--#-#--#-#--#-#--#-#--#-#--#-#--#-#--#-
--#----#----#----#----#----#----#----#----#----#----#----#----#----#----#----#----#----#----#----#--
----#----#----#----#----#----#----#----#----#----#----#----#----#----#----#----#----#----#----#----#
----------------------------------------------------------------------------------------------------
#----#----#----#----#----#----#----#----#----#----#----#----#----#----#----#----#----#----#----#----
#--#-#--#-#--#-#--#-#--#-#--#-#--#-#--#-#--#-#--#-#--#-#--#-#--#-#--#-#--#-#--#-#--#-#--#-#--#-#--#-
--#----#----#----#----#----#----#----#----#----#----#----#----#----#----#----#----#----#----#----#--
----#----#----#----#----#----#----#----#----#----#----#----#----#----#----#----#----#----#----#----#
----------------------------------------------------------------------------------------------------
#----#----#----#----#----#----#----#----#----#----#----#----#----#----#----#----#----#----#----#----