?diagonal=Never;
#-##-#-##-#-##-#-##-#-##-#-##-#-##-#-##-#-##-#-##-#-##-#-##-#-##-#-##-#-##-#-##-#-##-#-##-#-##-#-##-
----------------------------------------------------------------------------------------------------
----------------------------------------------------------------------------------------------------
####-####-####-####-####-####-####-####-####-####-####-####-####-####-####-####-####-####-####-####-
#----#----#----#----#----#----#----#----#----#----#----#----#----#----#----#----#----#----#----#----
#-##-#-##-#-##-#-##-#-##-#-##-#-##-#-##-#-##-#-##-#-##-#-##-#-##-#-##-#-##-#-##-#-##-#-##-#-##-#-##-
----------------------------------------------------------------------------------------------------
----------------------------------------------------------------------------------------------------
####-####-####-####-####-####-####-####-####-####-####-####-####-####-####-####-####-####-####-####-
#----#----#----#----#----#----#----#----#----#----#----#----#----#----#----#----#----#----#----#----
#-##-#-##-#-##-#-##-#-##-#-##-#-##-#-##-#-##-#-##-#-##-#-##-#-##-#-##-#-##-#-##-#-##-#-##-#-##-#-##-
----------------------------------------------------------------------------------------------------
----------------------------------------------------------------------------------------------------
####-####-####-####-####-####-####-####-####-####-####-####-####-####-####-####-####-####-####-####-
#----#----#----#----#----#----#----#----#----#----#----#----#----#----#----#----#----#----#----#----
#-##-#-##-#-##-#-##-#-##-#-##-#-##-#-##-#-##-#-##-#-##-#-##-#-##-#-##-#-##-#-##-#-##-#-##-#-##-#-##-
----------------------------------------------------------------------------------------------------
----------------------------------------------------------------------------------------------------
####-####-####-####-####-####-####-####-####-####-####-####-####-####-####-####-####-####-####-####-
#----#----#----#----#----#----#----#----#----#----#----#----#----#----#----#----#----#----#----#----
#-##-#-##-#-##-#-##-#-##-#-##-#-##-#-##-#-##-#-##-#-##-#-##-#-##-#-##-#-##-#-##-#-##-#-##-#-##-#-##-
----------------------------------------------------------------------------------------------------
----------------------------------------------------------------------------------------------------
####-####-####-####-####-####-####-####-####-####-####-####-####-####-####-####-####-####-####-####-
#----#----#----#----#----#----#----#----#----#----#----#----#----#----#----#----#----#----#----#----
#-##-#-##-#-##-#-##-#-##-#-##-#-##-#-##-#-##-#-##-#-##-#-##-#-##-#-##-#-##-#-##-#-##-#-##-#-##-#-##-
----------------------------------------------------------------------------------------------------
----------------------------------------------------------------------------------------------------
####-####-####-####-####-####-####-####-####-####-####-####-####-####-####-####-####-####-####-####-
#----#----#----#----#----#----#----#----#----#----#----#----#----#----#----#----#----#----#----#----
#-##-#-##-#-##-#-##-#-##-#-##-#-##-#-##-#-##-#-##-#-##-#-##-#-##-#-##-#-##-#-##-#-##-#-##-#-##-#-##-
----------------------------------------------------------------------------------------------------
----------------------------------------------------------------------------------------------------
####-####-####-####-####-####-####-####-####-####-####-####-####-####-####-####-####-####-####-####-
#----#----#----#----#----#----#----#----#----#----#----#----#----#----#----#----#----#----#----#----
#-##-#-##-#-##-#-##-#-##-#-##-#-##-#-##-#-##-#-##-#-##-#-##-#-##-#-##-#-##-#-##-#-##-#-##-#-##-#-##-
----------------------------------------------------------------------------------------------------
----------------------------------------------------------------------------------------------------
####-####-####-####-####-####-####-####-####-####-####-####-####-####-####-####-####-####-####-####-
#----#----#----#----#----#----#----#----#----#----#----#----#----#----#----#----#----#----#----#----
#-##-#-##-#-##-#-##-#-##-#-##-#-##-#-##-#-##-#-##-#-##-#-##-#-##-#-##-#-##-#-##-#-##-#-##-#-##-#-##-
----------------------------------------------------------------------------------------------------
----------------------------------------------------------------------------------------------------
####-####-####-####-####-####-####-####-####-####-####-####-####-####-####-####-####-####-####-####-
#----#----#----#----#----#----#----#----#----#----#----#----#----#----#----#----#----#----#----#----
#-##-#-##-#-##-#-##-#-##-#-##-#-##-#-##-#-##-#-##-#-##-#-##-#-##-#-##-#-##-#-##-#-##-#-##-#-##-#-##-
----------------------------------------------------------------------------------------------------
----------------------------------------------------------------------------------------------------
####-####-####-####-####-####-####-####-####-####-####-####-####-####-####-####-####-####-####-####-
#----#----#----#----#----#----#----#----#----#----#----#----#----#----#----#----#----#----#----#----
#-##-#-##-#-##-#-##-#-##-#-##-#-##-#-##-#-##-#-##-#-##-#-##-#-##-#-##-#-##-#-##-#-##-#-##-#-##-#-##-
----------------------------------------------------------------------------------------------------
----------------------------------------------------------------------------------------------------
####-####-####-####-####-####-####-####-####-####-####-####-####-####-####-####-####-####-####-####-
#----#----#----#----#----#----#----#----#----#----#----#----#----#----#----#----#----#----#----#----
#-##-#-##-#-##-#-##-#-##-#-##-#-##-#-##-#-##-#-##-#-##-#-##-#-##-#-##-#-##-#-##-#-##-#-##-#-##-#-##-
----------------------------------------------------------------------------------------------------
----------------------------------------------------------------------------------------------------
####-####-####-####-####-####-####-####-####-####-####-####-####-####-####-####-####-####-####-####-
#----#----#----#----#----#----#----#----#----#----#----#----#----#----#----#----#----#----#----#----
#-##-#-##-#-##-#-##-#-##-#-##-#-##-#-##-#-##-#-##-#-##-#-##-#-##-#-##-#-##-#-##-#-##-#-##-#-##-#-##-
----------------------------------------------------------------------------------------------------
----------------------------------------------------------------------------------------------------
####-####-####-####-####-####-####-####-####-####-####-####-####-####-####-####-####-####-####-####-
#----#----#----#----#----#----#----#----#----#----#----#----#----#----#----#----#----#----#----#----
#-##-#-##-#-##-#-##-#-##-#-##-#-##-#-##-#-##-#-##-#-##-#-##-#-##-#-##-#-##-#-##-#-##-#-##-#-##-#-##-
----------------------------------------------------------------------------------------------------
----------------------------------------------------------------------------------------------------
####-####-####-####-####-####-####-####-####-####-####-####-####-####-####-####-####-####-####-####-
#----#----#----#----#----#----#----#----#----#----#----#----#----#----#----#----#----#----#----#----
#-##-#-##-#-##-#-##-#-##-#-##-#-##-#-##-#-##-#-##-#-##-#-##-#-##-#-##-#-##-#-##-#-##-#-##-#-##-#-##-
------------------------S---------------------------------------------------------------------------
------------------------------------------------------------------------------------------------E---
####-####-####-####-####-####-####-####-####-####-####-####-####-####-####-####-####-####-####-####-
#----#----#----#----#----#----#----#----#----#----#----#----#----#----#----#----#----#----#----#----
#-##-#-##-#-##-#-##-#-##-#-##-#-##-#-##-#-##-#-##-#-##-#-##-#-##-#-##-#-##-#-##-#-##-#-##-#-##-#-##-
----------------------------------------------------------------------------------------------------
----------------------------------------------------------------------------------------------------
####-####-####-####-####-####-####-####-####-####-####-####-####-####-####-####-####-####-####-####-
#----#----#----#----#----#----#----#----#----#----#----#----#----#----#----#----#----#----#----#----
#-##-#-##-#-##-#-##-#-##-#-##-#-##-#-##-#-##-#-##-#-##-#-##-#-##-#-##-#-##-#-##-#-##-#-##-#-##-#-##-
----------------------------------------------------------------------------------------------------
----------------------------------------------------------------------------------------------------
####-####-####-####-####-####-####-####-####-####-####-####-####-####-####-####-####-####-####-####-
#----#----#----#----#----#----#----#----#----#----#----#----#----#----#----#----#----#----#----#----
#-##-#-##-#-##-#-##-#-##-#-##-#-##-#-##-#-##-#-##-#-##-#-##-#-##-#-##-#-##-#-##-#-##-#-##-#-##-#-##-
----------------------------------------------------------------------------------------------------
----------------------------------------------------------------------------------------------------
####-####-####-####-####-####-####-####-####-####-####-####-####-####-####-####-####-####-####-####-
#----#----#----#----#----#----#----#----#----#----#----#----#----#----#----#----#----#----#----#----
#-##-#-##-#-##-#-##-#-##-#-##-#-##-#-##-#-##-#-##-#-##-#-##-#-##-#-##-#-##-#-##-#-##-#-##-#-##-#-##-
----------------------------------------------------------------------------------------------------
----------------------------------------------------------------------------------------------------
####-####-####-####-####-####-####-####-####-####-####-####-####-####-####-####-####-####-####-####-
#----#----#----#----#----#----#----#----#----#----#----#----#----#----#----#----#----#----#----#----
#-##-#-##-#-##-#-##-#-##-#-##-#-##-#-##-#-##-#-##-#-##-#-##-#-##-#-##-#-##-#-##-#-##-#-##-#-##-#-##-
----------------------------------------------------------------------------------------------------
----------------------------------------------------------------------------------------------------
####-####-####-####-####-####-####-####-####-####-####-####-####-####-####-####-####-####-####-####-
#----#----#----#----#----#----#----#----#----#----#----#----#----#----#----#----#----#----#----#----