?diagonal=Always;
-###--###--###--###--###--###--###--###--###--###--###--###--###--###--###--###--###--###--###--###-
----#----#----#----#----#----#----#----#----#----#----#----#----#----#----#----#----#----#----#----#
-###--###--###--###--###--###--###--###--###--###--###--###--###--###--###--###--###--###--###--###-
#----#----#----#----#----#----#----#----#----#----#----#----#----#----#----#----#----#----#----#----
----------------------------------------------------------------------------------------------------
-###--###--###--###--###--###--###--###--###--###--###--###--###--###--###--###--###--###--###--###-
----#----#----#----#----#----#----#----#----#----#----#----#----#----#----#----#----#----#----#----#
-###--###--###--###--###--###--###--###--###--###--###--###--###--###--###--###--###--###--###--###-
#----#----#----#----#----#----#----#----#----#----#----#----#----#----#----#----#----#----#----#----
----------------------------------------------------------------------------------------------------
-###--###--###--###--###--###--###--###--###--###--###--###--###--###--###--###--###--###--###--###-
----#----#----#----#----#----#----#----#----#----#----#----#----#----#----#----#----#----#----#----#
-###--###--###--###--###--###--###--###--###--###--###--###--###--###--###--###--###--###--###--###-
#----#----#----#----#----#----#----#----#----#----#----#----#----#----#----#----#----#----#----#----
----------------------------------------------------------------------------------------------------
-###--###--###--###--###--###--###--###--###--###--###--###--###--###--###--###--###--###--###--###-
----#----#----#----#----#----#----#----#----#----#----#----#----#----#----#----#----#----#----#----#
-###--###--###--###--###--###--###--###--###--###--###--###--###--###--###--###--###--###--###--###-
#----#----#----#----#----#----#----#----#----#----#----#----#----#----#----#----#----#----#----#----
----------------------------------------------------------------------------------------------------
-###--###--###--###--###--###--###--###--###--###--###--###--###--###--###--###--###--###--###--###-
----#----#----#----#----#----#----#----#----#----#----#----#----#----#----#----#----#----#----#----#
-###--###--###--###--###--###--###--###--###--###--###--###--###--###--###--###--###--###--###--###-
#----#----#----#----#----#----#----#----#----#----#----#----#----#----#----#----#----#----#----#----
----------------------------------------------------------------------------------------------------
-###--###--###--###--###--###--###--###--###--###--###--###--###--###--###--###--###--###--###--###-
----#----#----#----#----#----#----#----#----#----#----#----#----#----#----#----#----#----#----#----#
-###--###--###--###--###--###--###--###--###--###--###--###--###--###--###--###--###--###--###--###-
#----#----#----#----#----#----#----#----#----#----#----#----#----#----#----#----#----#----#----#----
----------------------------------------------------------------------------------------------------
-###--###--###--###--###--###--###--###--###--###--###--###--###--###--###--###--###--###--###--###-
----#----#----#----#----#----#----#----#----#----#----#----#----#----#----#----#----#----#----#----#
-###--###--###--###--###--###--###--###--###--###--###--###--###--###--###--###--###--###--###--###-
#----#----#----#----#----#----#----#----#----#----#----#----#----#----#----#----#----#----#----#----
----------------------------------------------------------------------------------------------------
-###--###--###--###--###--###--###--###--###--###--###--###--###--###--###--###--###--###--###--###-
----#----#----#----#----#----#----#----#----#----#----#----#----#----#----#----#----#----#----#----#
-###--###--###--###--###--###--###--###--###--###--###--###--###--###--###--###--###--###--###--###-
#----#----#----#----#----#----#----#----#----#----#----#----#----#----#----#----#----#----#----#----
----------------------------------------------------------------------------------------------------
-###--###--###--###--###--###--###--###--###--###--###--###--###--###--###--###--###--###--###--###-
----#----#----#----#----#----#----#----#----#----#----#----#----#----#----#----#----#----#----#----#
-###--###--###--###--###--###--###--###--###--###--###--###--###--###--###--###--###--###--###--###-
#----#----#----#----#----#----#----#----#----#----#----#----#----#----#----#----#----#----#----#----
----------------------------------------------------------------------------------------------------
-###--###--###--###--###--###--###--###--###--###--###--###--###--###--###--###--###--###--###--###-
----#----#----#----#----#----#----#----#----#----#----#----#----#----#----#----#----#----#----#----#
-###--###--###--###--###--###--###--###--###--###--###--###--###--###--###--###--###--###--###--###-
#----#----#----#----#----#----#----#----#----#----#----#----#----#----#----#----#----#----#-E--#----
----------------------------------------------------------------------------------------------------
-###--###--###--###--###--###--###--###--###--###--###--###--###--###--###--###--###--###--###--###-
----#----#----#----#----#----#----#----#----#----#----#----#----#----#----#----#----#----#----#----#
-###--###--###--###--###--###--###--###--###--###--###--###--###--###--###--###--###--###--###--###-
#----#----#----#----#----#----#----#----#----#----#----#----#----#----#----#----#----#----#----#----
----------------------------------------------------------------------------------------------------
-###--###--###--###--###--###--###--###--###--###--###--###--###--###--###--###--###--###--###--###-
----#----#----#----#----#----#----#----#----#----#----#----#----#----#----#----#----#----#----#----#
-###--###--###--###--###--###--###--###--###--###--###--###--###--###--###--###--###--###--###--###-
#----#----#----#----#----#----#----#----#----#----#----#----#----#----#----#----#----#----#----#----
----------------------------------------------------------------------------------------------------
-###--###--###--###--###--###--###--###--###--###--###--###--###--###--###--###--###--###--###--###-
----#----#----#----#----#----#----#----#----#----#----#----#----#----#----#----#----#----#----#----#
-###--###--###--###--###--###--###--###--###--###--###--###--###--###--###--###--###--###--###--###-
#----#----#----#----#----#----#----#----#----#----#----#----#----#----#----#----#----#----#----#----
----------------------------------------------------------------------------------------------------
-###--###--###--###--###--###--###--###--###--###--###--###--###--###--###--###--###--###--###--###-
----#----#----#----#----#----#----#----#----#----#----#----#----#----#----#----#----#----#----#----#
-###--###--###--###--###--###--###--###--###--###--###--###--###--###--###--###--###--###--###--###-
#----#----#----#----#----#----#----#----#----#----#----#----#----#----#----#----#----#----#----#----
----------------------------------------------------------------------------------------------------
-###--###--###--###--###--###--###--###--###--###--###--###--###--###--###--###--###--###--###--###-
----#----#----#----#----#----#----#----#----#----#----#----#----#----#----#----#----#----#----#----#
-###--###--###--###--###--###--###--###--###--###--###--###--###--###--###--###--###--###--###--###-
#----#----#----#----#----#----#----#----#----#----#----#----#----#----#----#----#----#----#----#----
----------------------------------------------------------------------------------------------------
-###--###--###--###--###--###--###--###--###--###--###--###--###--###--###--###--###--###--###--###-
----#----#----#----#----#----#----#----#----#----#----#----#----#----#----#----#----#----#----#----#
-###--###--###--###--###--###--###--###--###--###--###--###--###--###--###--###--###--###--###--###-
#----#----#----#----#----#----#----#----#----#----#----#----#----#----#----#----#----#----#----#----
----------------------------------------------------------------------------------------------------
-###--###--###--###--###--###--###--###--###--###--###--###--###--###--###--###--###--###--###--###-
----#----#----#----#----#----#----#----#----#----#----#----#----#----#----#----#----#----#----#----#
-###--###--###--###--###--###--###--###--###--###--###--###--###--###--###--###--###--###--###--###-
#----#----#----#----#----#----#----#----#----#----#----#----#----#----#----#----#----#----#----#----
----------------------------------------------------------------------------------------------------
-###--###--###--###--###--###--###--###--###--###--###--###--###--###--###--###--###--###--###--###-
----#----#----#----#----#----#----#----#----#----#----#----#----#----#----#----#----#----#----#----#
-###--###--###--###--###--###--###--###--###--###--###--###--###--###--###--###--###--###--###--###-
#----#----#----#----#----#----#----#----#----#----#----#----#----#----#----#----#----#----#----#----
----------------------------------------------------------------------------------------------------
-###--###--###--###--###--###--###--###--###--###--###--###--###--###--###--###--###--###--###--###-
----#----#----#----#----#----#----#----#----#----#----#----#----#----#----#----#----#----#----#----#
-###--###--###-S###--###--###--###--###--###--###--###--###--###--###--###--###--###--###--###--###-
#----#----#----#----#----#----#----#----#----#----#----#----#----#----#----#----#----#----#----#----
----------------------------------------------------------------------------------------------------
-###--###--###--###--###--###--###--###--###--###--###--###--###--###--###--###--###--###--###--###-
----#----#----#----#----#----#----#----#----#----#----#----#----#----#----#----#----#----#----#----#
-###--###--###--###--###--###--###--###--###--###--###--###--###--###--###--###--###--###--###--###-
#----#----#----#----#----#----#----#----#----#----#----#----#----#----#----#----#----#----#----#----
----------------------------------------------------------------------------------------------------