?diagonal=Always;
---#----#----#----#----#----#----#----#----#----#----#----#----#----#----#----#----#----#----#----#-
#----#----#----#----#----#----#----#----#----#----#----#----#----#----#----#----#----#----#----#----
#-#--#-#--#-#--#-#--#-#--#-#--#-#--#-#--#-#--#-#--#-#--#-#--#-#--#-#--#-#--#-#--#-#--#-#--#-#--#-#--
-#-#--#-#--#-#--#-#--#-#--#-#--#-#--#-#--#-#--#-#--#-#--#-#--#-#--#-#--#-#--#-#--#-#--#-#--#-#--#-#-
----#----#----#----#----#----#----#----#----#----#----#----#----#----#----#----#----#----#----#----#
---#----#----#----#----#----#----#----#----#----#----#----#----#----#----#----#----#----#----#----#-
#----#----#----#----#----#----#----#----#----#----#----#----#----#----#----#----#----#----#----#----
#-#--#-#--#-#--#-#--#-#--#-#--#-#--#-#--#-#--#-#--#-#--#-#--#-#--#-#--#-#--#-#--#-#--#-#--#-#--#-#--
-#-#--#-#--#-#--#-#--#-#--#-#--#-#--#-#--#-#--#-#--#-#--#-#--#-#--#-#--#-#--#-#--#-#--#-#--#-#--#-#-
----#----#----#----#----#----#----#----#----#----#----#----#----#----#----#----#----#----#----#----#
---#----#----#----#----#----#----#----#----#----#----#----#----#----#----#----#----#----#----#----#-
#----#----#----#----#----#----#----#----#----#----#----#----#----#----#----#----#----#----#----#----
#-#--#-#--#-#--#-#--#-#--#-#--#-#--#-#--#-#--#-#--#-#--#-#--#-#--#-#--#-#--#-#--#-#--#-#--#-#--#-#--
-#-#--#-#--#-#--#-#--#-#--#-#--#-#--#-#--#-#--#-#--#-#--#-#--#-#--#-#--#-#--#-#--#-#--#-#--#-#--#-#-
----#----#----#----#----#----#----#----#----#----#----#----#----#----#----#----#----#----#----#----#
---#----#----#----#----#----#----#----#----#----#----#----#----#----#----#----#----#----#----#----#-
#----#----#----#----#----#----#----#----#----#----#----#----#----#----#----#----#----#----#----#----
#-#--#-#--#-#--#-#--#-#--#-#--#-#--#-#--#-#--#-#--#-#--#-#--#-#--#-#--#-#--#-#--#-#--#-#--#-#--#-#--
-#-#--#-#--#-#--#-#--#-#--#-#--#-#--#-#--#-#--#-#--#-#--#-#--#-#--#-#--#-#--#-#--#-#--#-#--#-#--#-#-
----#----#----#----#----#----#----#----#----#----#----#----#----#----#----#----#----#----#----#----#
---#----#----#----#----#----#----#----#----#----#----#----#----#----#----#----#----#----#----#----#-
#----#----#----#----#----#----#----#----#----#----#----#----#----#----#----#----#----#----#----#----
#-#--#-#--#-#--#-#--#-#--#-#--#-#--#-#--#-#--#-#--#-#--#-#--#-#--#-#--#-#--#-#--#-#--#-#--#-#--#-#--
-#-#--#-#--#-#--#-#--#-#--#-#--#-#--#-#--#-#--#-#--#-#--#-#--#-#--#-#--#-#--#-#--#-#--#-#--#-#--#-#-
----#----#----#----#----#----#----#----#----#----#----#----#----#----#----#----#----#----#----#----#
---#----#----#----#----#----#----#----#----#----#----#----#----#----#----#----#----#----#----#----#-
#----#----#----#----#----#----#----#----#----#----#----#----#----#----#----#----#----#----#----#----
#-#--#-#--#-#--#-#--#-#--#-#--#-#--#-#--#-#--#-#--#-#--#-#--#-#--#-#--#-#--#-#--#-#--#-#--#-#--#-#--
-#-#--#-#--#-#--#-#--#-#--#-#--#-#--#-#--#-#--#-#--#-#--#-#--#-#--#-#--#-#--#-#--#-#--#-#--#-#--#-#-
----#----#----#----#----#----#----#----#----#----#----#----#----#----#----#----#----#----#----#----#
---#----#----#----#----#----#----#----#----#----#----#----#----#----#----#----#----#----#----#----#-
#----#----#----#----#----#----#----#----#----#----#----#----#----#----#----#----#----#----#----#----
#-#--#-#--#-#--#-#--#-#--#-#--#-#--#-#--#-#--#-#--#-#--#-#--#-#--#-#--#-#--#-#--#-#--#-#--#-#--#-#--
-#-#--#-#--#-#--#-#--#-#--#-#--#-#--#-#--#-#--#-#--#-#--#-#--#-#--#-#--#-#--#-#--#-#--#-#--#-#--#-#-
----#----#----#----#----#----#----#----#----#----#----#----#----#----#----#----#----#----#----#----#
---#----#----#----#----#----#----#----#----#----#----#----#----#----#----#----#----#----#----#----#-
#----#----#----#----#----#----#----#----#----#----#----#----#----#----#----#----#----#----#----#----
#-#--#-#--#-#--#-#--#-#--#-#--#-#--#-#--#-#--#-#--#-#--#-#--#-#--#-#--#-#--#-#--#-#--#-#--#-#--#-#--
-#-#--#-#--#-#--#-#--#-#--#-#--#-#--#-#--#-#--#-#--#-#--#-#--#-#--#-#--#-#--#-#--#-#--#-#--#-#--#-#-
----#----#----#----#----#----#----#----#----#----#----#----#----#----#----#----#----#----#----#----#
---#----#----#----#----#----#----#----#----#----#----#----#----#----#----#----#----#----#----#----#-
#----#----#----#----#----#----#----#----#----#----#----#----#----#----#----#----#----#----#----#----
#-#--#-#--#-#--#-#--#-#--#-#--#-#--#-#--#-#--#-#--#-#--#-#--#-#--#-#--#-#--#-#--#-#--#-#--#-#--#-#--
-#-#--#-#--#-#--#-#--#-#--#-#--#-#--#-#--#-#--#-#--#-#--#-#--#-#--#-#--#-#--#-#--#-#--#-#--#-#--#-#-
----#----#----#----#----#----#----#----#----#----#----#----#----#----#----#----#----#----#----#----#
---#----#----#----#----#----#----#----#----#----#----#----#----#----#----#----#----#----#----#----#-
#----#----#----#----#----#----#----#----#----#----#----#----#----#----#----#----#----#----#----#----
#-#--#-#--#-#--#-#--#-#--#-#--#-#--#-#--#-#--#-#--#-#--#-#--#-#--#-#--#-#--#-#--#-#--#-#--#-#--#-#--
-#-#--#-#--#-#--#-#--#-#--#-#--#-#--#-#--#-#--#-#--#-#--#-#--#-#--#-#--#-#--#-#--#-#--#-#--#-#--#-#-
----#----#----#----#----#----#----#----#----#----#----#----#----#----#----#----#----#----#----#----#
---#----#----#----#----#----#----#----#----#----#----#----#----#----#----#----#----#----#----#----#-
#----#----#----#----#----#----#----#----#----#----#----#----#----#----#----#----#----#----#----#----
#-#--#-#--#-#--#-#--#-#--#-#--#-#--#-#--#-#--#-#--#-#--#-#--#-#--#-#--#-#--#-#--#-#--#-#--#-#--#-#--
-#-#--#-#--#-#--#-#--#-#--#-#--#-#--#-#--#-#--#-#--#-#--#-#--#-#--#-#--#-#--#-#--#-#--#-#--#-#--#-#-
----#----#----#----#----#----#----#----#----#----#----#----#----#----#----#----#----#----#----#----#
---#----#----#----#----#----#----#----#----#----#----#----#----#----#----#----#----#----#----#----#-
#----#----#----#----#----#----#----#----#----#----#----#----#----#----#----#----#----#----#----#----
#-#--#-#--#-#--#-#--#-#--#-#--#-#--#-#--#-#--#-#--#-#E-#-#--#-#--#-#--#-#--#-#--#-#--#-#--#-#--#-#--
-#-#--#-#--#-#--#-#--#-#--#-#--#-#--#-#--#-#--#-#--#-#--#-#--#-#--#-#--#-#--#-#--#-#--#-#--#-#--#-#-
----#----#----#----#----#----#----#----#----#----#----#----#----#----#----#----#----#----#----#----#
---#----#----#----#----#----#----#----#----#----#----#----#----#----#----#----#----#----#----#----#-
#----#----#----#----#----#----#----#----#----#----#----#----#----#----#----#----#----#----#----#----
#-#--#-#--#-#--#-#--#-#--#-#--#-#--#-#--#-#--#-#--#-#--#-#--#-#--#-#--#-#--#-#--#-#--#-#--#-#--#-#--
-#-#--#-#--#-#--#-#--#-#--#-#--#-#--#-#--#-#--#-#--#-#--#-#--#-#--#-#--#-#--#-#--#-#--#-#--#-#--#-#-
----#----#----#----#----#----#----#----#----#----#----#----#----#----#----#----#----#----#----#----#
---#----#----#----#----#----#----#----#----#----#----#----#----#----#----#----#----#----#----#----#-
#----#----#----#----#----#----#----#----#----#----#----#----#----#----#----#----#----#----#----#----
#-#--#-#--#-#--#-#--#-#--#-#--#-#--#-#--#-#--#-#--#-#--#-#--#-#--#-#--#-#--#-#--#-#--#-#--#-#--#-#--
-#-#--#-#--#-#--#-#--#-#--#-#--#-#--#-#--#-#--#-#--#-#--#-#--#-#--#-#--#-#--#-#--#-#--#-#--#-#--#-#-
----#----#----#----#----#----#----#----#----#----#----#----#----#----#----#----#----#----#----#----#
---#----#----#----#----#----#----#----#----#----#----#----#----#----#----#----#----#----#----#----#-
#----#----#----#----#----#----#----#----#----#----#----#----#----#----#----#----#----#----#----#----
#-#--#-#--#-#--#-#--#-#--#-#--#-#--#-#--#-#--#-#--#-#--#-#--#-#--#-#--#-#--#-#--#-#--#-#--#-#--#-#--
-#-#--#-#--#-#--#-#--#-#--#-#--#-#--#-#--#-#--#-#--#-#--#-#--#-#--#-#--#-#--#-#--#-#--#-#--#-#--#-#-
----#----#----#----#----#----#----#----#----#----#----#----#----#----#----#----#----#----#----#----#
---#----#----#----#----#----#----#----#----#----#----#----#----#----#----#----#----#----#----#----#-
#----#----#----#----#----#----#----#----#----#----#----#----#----#----#----#----#----#----#----#----
#-#--#-#--#-#--#-#--#-#--#-#--#-#--#-#--#-#--#-#--#-#--#-#--#-#--#-#--#-#--#-#--#-#--#-#--#-#--#-#--
-#-#--#-#--#-#--#-#--#-#--#-#--#-#--#-#--#-#--#-#--#-#--#-#--#-#--#-#--#-#--#-#--#-#--#-#--#-#--#-#-
----#----#----#----#----#----#----#----#----#----#----#----#----#----#----#----#----#----#----#----#
---#----#----#----#----#----#----#----#----#----#----#----#----#----#----#----#----#----#----#----#-
#----#----#----#----#----#----#----#----#----#----#----#----#----#----#----#----#----#----#----#----
#-#--#-#--#-#--#-#--#-#--#-#--#-#--#-#--#-#--#-#--#-#--#-#--#-#--#-#--#-#--#-#--#-#--#-#--#-#--#-#--
-#-#--#-#--#-#-S#-#--#-#--#-#--#-#--#-#--#-#--#-#--#-#--#-#--#-#--#-#--#-#--#-#--#-#--#-#--#-#--#-#-
----#----#----#----#----#----#----#----#----#----#----#----#----#----#----#----#----#----#----#----#
---#----#----#----#----#----#----#----#----#----#----#----#----#----#----#----#----#----#----#----#-
#----#----#----#----#----#----#----#----#----#----#----#----#----#----#----#----#----#----#----#----
#-#--#-#--#-#--#-#--#-#--#-#--#-#--#-#--#-#--#-#--#-#--#-#--#-#--#-#--#-#--#-#--#-#--#-#--#-#--#-#--
-#-#--#-#--#-#--#-#--#-#--#-#--#-#--#-#--#-#--#-#--#-#--#-#--#-#--#-#--#-#--#-#--#-#--#-#--#-#--#-#-
----#----#----#----#----#----#----#----#----#----#----#----#----#----#----#----#----#----#----#----#
---#----#----#----#----#----#----#----#----#----#----#----#----#----#----#----#----#----#----#----#-
#----#----#----#----#----#----#----#----#----#----#----#----#----#----#----#----#----#----#----#----
#-#--#-#--#-#--#-#--#-#--#-#--#-#--#-#--#-#--#-#--#-#--#-#--#-#--#-#--#-#--#-#--#-#--#-#--#-#--#-#--
-#-#--#-#--#-#--#-#--#-#--#-#--#-#--#-#--#-#--#-#--#-#--#-#--#-#--#-#--#-#--#-#--#-#--#-#--#-#--#-#-
----#----#----#----#----#----#----#----#----#----#----#----#----#----#----#----#----#----#----#----#
---#----#----#----#----#----#----#----#----#----#----#----#----#----#----#----#----#----#----#----#-
#----#----#----#----#----#----#----#----#----#----#----#----#----#----#----#----#----#----#----#----
#-#--#-#--#-#--#-#--#-#--#-#--#-#--#-#--#-#--#-#--#-#--#-#--#-#--#-#--#-#--#-#--#-#--#-#--#-#--#-#--
-#-#--#-#--#-#--#-#--#-#--#-#--#-#--#-#--#-#--#-#--#-#--#-#--#-#--#-#--#-#--#-#--#-#--#-#--#-#--#-#-
----#----#----#----#----#----#----#----#----#----#----#----#----#----#----#----#----#----#----#----#