?diagonal=Always;
-#--#-#--#-#--#-#--#-#--#-#--#-#--#-#--#-#--#-#--#-#--#-#--#-#--#-#--#-#--#-#--#-#--#-#--#-#--#-#--#
--##---##---##---##---##---##---##---##---##---##---##---##---##---##---##---##---##---##---##---##-
----------------------------------------------------------------------------------------------------
-#----#----#----#----#----#----#----#----#----#----#----#----#----#----#----#----#----#----#----#---
--#-#--#-#--#-#--#-#--#-#--#-#--#-#--#-#--#-#--#-#--#-#--#-#--#-#--#-#--#-#--#-#--#-#--#-#--#-#--#-#
-#--#-#--#-#--#-#--#-#--#-#--#-#--#-#--#-#--#-#--#-#--#-#--#-#--#-#--#-#--#-#--#-#--#-#--#-#--#-#--#
--##---##---##---##---##---##---##---##---##---##---##---##---##---##---##---##---##---##---##---##-
----------------------------------------------------------------------------------------------------
-#----#----#----#----#----#----#----#----#----#----#----#----#----#----#----#----#----#----#----#---
--#-#--#-#--#-#--#-#--#-#--#-#--#-#--#-#--#-#--#-#--#-#--#-#--#-#--#-#--#-#--#-#--#-#--#-#--#-#--#-#
-#--#-#--#-#--#-#--#-#--#-#--#-#--#-#--#-#--#-#--#-#--#-#--#-#--#-#--#-#--#-#--#-#--#-#--#-#--#-#--#
--##---##---##---##---##---##---##---##---##---##---##---##---##---##---##---##---##---##---##---##-
----------------------------------------------------------------------------------------------------
-#----#----#----#----#----#----#----#----#----#----#----#----#----#----#----#----#----#----#----#---
--#-#--#-#--#-#--#-#--#-#--#-#--#-#--#-#--#-#--#-#--#-#--#-#--#-#--#-#--#-#--#-#--#-#--#-#--#-#--#-#
-#--#-#--#-#--#-#--#-#--#-#--#-#--#-#--#-#--#-#--#-#--#-#--#-#--#-#--#-#--#-#--#-#--#-#--#-#--#-#--#
--##---##---##---##---##---##---##---##---##---##---##---##---##---##---##---##---##---##---##---##-
----------------------------------------------------------------------------------------------------
-#----#----#----#----#----#----#----#----#----#----#----#----#----#----#----#----#----#----#----#---
--#-#--#-#--#-#--#-#--#-#--#-#--#-#--#-#--#-#--#-#--#-#--#-#--#-#--#-#--#-#--#-#--#-#--#-#--#-#--#-#
-#--#-#--#-#--#-#--#-#--#-#--#-#--#-#--#-#--#-#--#-#--#-#--#-#--#-#--#-#--#-#--#-#--#-#--#-#--#-#--#
--##---##---##---##---##---##---##---##---##---##---##---##---##---##---##---##---##---##---##---##-
----------------------------------------------------------------------------------------------------
-#----#----#----#----#----#----#----#----#----#----#----#----#----#----#----#----#----#----#----#---
--#-#--#-#--#-#--#-#--#-#--#-#--#-#--#-#--#-#--#-#--#-#--#-#--#-#--#-#--#-#--#-#--#-#--#-#--#-#--#-#
-#--#-#--#-#--#-#--#-#--#-#--#-#--#-#--#-#--#-#--#-#--#-#--#-#--#-#--#-#--#-#--#-#--#-#--#-#--#-#--#
--##---##---##---##---##---##---##---##---##---##---##---##---##---##---##---##---##---##---##---##-
----------------------------------------------------------------------------------------------------
-#----#----#----#----#----#----#----#----#----#----#----#----#----#----#----#----#----#----#----#---
--#-#--#-#--#-#--#-#--#-#--#-#--#-#--#-#--#-#--#-#--#-#--#-#--#-#--#-#--#-#--#-#--#-#--#-#--#-#--#-#
-#--#-#--#-#--#-#--#-#--#-#--#-#--#-#--#-#--#-#--#-#--#-#--#-#--#-#--#-#--#-#--#-#--#-#--#-#--#-#--#
--##---##---##---##---##---##---##---##---##---##---##---##---##---##---##---##---##---##---##---##-
----------------------------------------------------------------------------------------------------
-#----#----#----#----#----#----#----#----#----#----#----#----#----#----#----#----#----#----#----#---
--#-#--#-#--#-#--#-#--#-#--#-#--#-#--#-#--#-#--#-#--#-#--#-#--#-#--#-#--#-#--#-#--#-#--#-#--#-#--#-#
-#--#-#--#-#--#-#--#-#--#-#--#-#--#-#--#-#--#-#--#-#--#-#--#-#--#-#--#-#--#-#--#-#--#-#--#-#--#-#--#
--##---##---##---##---##---##---##---##---##---##---##---##---##---##---##---##---##---##---##---##-
----------------------------------------------------------------------------------------------------
-#----#----#----#----#----#----#----#----#----#----#----#----#----#----#----#----#----#----#----#---
--#-#--#-#--#-#--#-#--#-#--#-#--#-#--#-#--#-#--#-#--#-#--#-#--#-#--#-#--#-#--#-#--#-#--#-#--#-#--#-#
-#--#-#--#-#--#-#--#-#--#-#--#-#--#-#--#-#--#-#--#-#--#-#--#-#--#-#--#-#--#-#--#-#--#-#--#-#--#-#--#
--##---##---##---##---##---##---##---##---##---##---##---##---##---##---##---##---##---##---##---##-
----------------------------------------------------------------------------------------------------
-#----#----#----#----#---E#----#----#----#----#----#----#----#----#----#----#----#----#----#----#---
--#-#--#-#--#-#--#-#--#-#--#-#--#-#--#-#--#-#--#-#--#-#--#-#--#-#--#-#--#-#--#-#--#-#--#-#--#-#--#-#
-#--#-#--#-#--#-#--#-#--#-#--#-#--#-#--#-#--#-#--#-#--#-#--#-#--#-#--#-#--#-#--#-#--#-#--#-#--#-#--#
--##---##---##---##---##---##---##---##---##---##---##---##---##---##---##---##---##---##---##---##-
----------------------------------------------------------------------------------------------------
-#----#----#----#----#----#----#----#----#----#----#----#----#----#----#----#----#----#----#----#---
--#-#--#-#--#-#--#-#--#-#--#-#--#-#--#-#--#-#--#-#--#-#--#-#--#-#--#-#--#-#--#-#--#-#--#-#--#-#--#-#
-#--#-#--#-#--#-#--#-#--#-#--#-#--#-#--#-#--#-#--#-#--#-#--#-#--#-#--#-#--#-#--#-#--#-#--#-#--#-#--#
--##---##---##---##---##---##---##---##---##---##---##---##---##---##---##---##---##---##---##---##-
----------------------------------------------------------------------------------------------------
-#----#----#----#----#----#----#----#----#----#----#----#----#----#----#----#----#----#----#----#---
--#-#--#-#--#-#--#-#--#-#--#-#--#-#--#-#--#-#--#-#--#-#--#-#--#-#--#-#--#-#--#-#--#-#--#-#--#-#--#-#
-#--#-#--#-#--#-#--#-#--#-#--#-#--#-#--#-#--#-#--#-#--#-#--#-#--#-#--#-#--#-#--#-#--#-#--#-#--#-#--#
--##---##---##---##---##---##---##---##---##---##---##---##---##---##---##---##---##---##---##---##-
----------------------------------------------------------------------------------------------------
-#----#----#----#----#----#----#----#----#----#----#----#----#----#----#----#----#----#----#----#---
--#-#--#-#--#-#--#-#--#-#--#-#--#-#--#-#--#-#--#-#--#-#--#-#--#-#--#-#--#-#--#-#--#-#--#-#--#-#--#-#
-#--#-#--#-#--#-#--#-#--#-#--#-#--#-#--#-#--#-#--#-#--#-#--#-#--#-#--#-#--#-#--#-#--#-#--#-#--#-#--#
--##---##---##---##---##---##---##---##---##---##---##---##---##---##---##---##---##---##---##---##-
----------------------------------------------------------------------------------------------------
-#----#----#----#----#----#----#----#----#----#----#----#----#----#----#----#----#----#----#----#---
--#-#--#-#--#-#--#-#--#-#--#-#--#-#--#-#--#-#--#-#--#-#--#-#--#-#--#-#--#-#--#-#--#-#--#-#--#-#--#-#
-#--#-#--#-#--#-#--#-#--#-#--#-#--#-#--#-#--#-#--#-#--#-#--#-#--#-#--#-#--#-#--#-#--#-#--#-#--#-#--#
--##---##---##---##---##---##---##---##---##---##---##---##---##---##---##---##---##---##---##---##-
----------------------------------------------------------------------------------------------------
-#----#----#----#----#----#----#----#----#----#----#----#----#----#----#----#----#----#----#----#---
--#-#--#-#--#-#--#-#--#-#--#-#--#-#--#-#--#-#--#-#--#-#--#-#--#-#--#-#--#-#--#-#--#-#--#-#--#-#--#-#
-#--#-#--#-#--#-#--#-#--#-#--#-#--#-#--#-#--#-#--#-#--#-#--#-#--#-#--#-#--#-#--#-#--#-#--#-#--#-#--#
--##---##---##---##---##---##---##---##---##---##---##---##---##---##---##---##---##---##---##---##-
----------------------------------------------------------------------------------------------------
-#----#----#----#----#----#----#----#----#----#----#----#----#----#----#----#----#----#----#----#---
--#-#--#-#--#-#--#-#--#-#--#-#--#-#--#-#--#-#--#-#--#-#--#-#--#-#--#-#--#-#--#-#--#-#--#-#--#-#--#-#
-#--#-#--#-#--#-#--#-#--#-#--#-#--#-#--#-#--#-#--#-#--#-#--#-#--#-#--#-#--#-#--#-#--#-#--#-#--#-#--#
--##---##---##---##---##---##---##---##---##---##---##---##---##---##---##---##---##---##---##---##-
--------------------------------------------------------------------------------------------S-------
-#----#----#----#----#----#----#----#----#----#----#----#----#----#----#----#----#----#----#----#---
--#-#--#-#--#-#--#-#--#-#--#-#--#-#--#-#--#-#--#-#--#-#--#-#--#-#--#-#--#-#--#-#--#-#--#-#--#-#--#-#
-#--#-#--#-#--#-#--#-#--#-#--#-#--#-#--#-#--#-#--#-#--#-#--#-#--#-#--#-#--#-#--#-#--#-#--#-#--#-#--#
--##---##---##---##---##---##---##---##---##---##---##---##---##---##---##---##---##---##---##---##-
----------------------------------------------------------------------------------------------------
-#----#----#----#----#----#----#----#----#----#----#----#----#----#----#----#----#----#----#----#---
--#-#--#-#--#-#--#-#--#-#--#-#--#-#--#-#--#-#--#-#--#-#--#-#--#-#--#-#--#-#--#-#--#-#--#-#--#-#--#-#
-#--#-#--#-#--#-#--#-#--#-#--#-#--#-#--#-#--#-#--#-#--#-#--#-#--#-#--#-#--#-#--#-#--#-#--#-#--#-#--#
--##---##---##---##---##---##---##---##---##---##---##---##---##---##---##---##---##---##---##---##-
----------------------------------------------------------------------------------------------------
-#----#----#----#----#----#----#----#----#----#----#----#----#----#----#----#----#----#----#----#---
--#-#--#-#--#-#--#-#--#-#--#-#--#-#--#-#--#-#--#-#--#-#--#-#--#-#--#-#--#-#--#-#--#-#--#-#--#-#--#-#
-#--#-#--#-#--#-#--#-#--#-#--#-#--#-#--#-#--#-#--#-#--#-#--#-#--#-#--#-#--#-#--#-#--#-#--#-#--#-#--#
--##---##---##---##---##---##---##---##---##---##---##---##---##---##---##---##---##---##---##---##-
----------------------------------------------------------------------------------------------------
-#----#----#----#----#----#----#----#----#----#----#----#----#----#----#----#----#----#----#----#---
--#-#--#-#--#-#--#-#--#-#--#-#--#-#--#-#--#-#--#-#--#-#--#-#--#-#--#-#--#-#--#-#--#-#--#-#--#-#--#-#
-#--#-#--#-#--#-#--#-#--#-#--#-#--#-#--#-#--#-#--#-#--#-#--#-#--#-#--#-#--#-#--#-#--#-#--#-#--#-#--#
--##---##---##---##---##---##---##---##---##---##---##---##---##---##---##---##---##---##---##---##-
----------------------------------------------------------------------------------------------------
-#----#----#----#----#----#----#----#----#----#----#----#----#----#----#----#----#----#----#----#---
--#-#--#-#--#-#--#-#--#-#--#-#--#-#--#-#--#-#--#-#--#-#--#-#--#-#--#-#--#-#--#-#--#-#--#-#--#-#--#-#