?diagonal=Always;
-#----#----#----#----#----#----#----#----#----#----#----#----#----#----#----#----#----#----#----#---
##---##---##---##---##---##---##---##---##---##---##---##---##---##---##---##---##---##---##---##---
-#----#----#----#----#----#----#----#----#----#----#----#----#----#----#----#----#----#----#----#---
-##---##---##---##---##---##---##---##---##---##---##---##---##---##---##---##---##---##---##---##--
--#----#----#----#----#----#----#----#----#----#----#----#----#----#----#----#----#----#----#----#--
-#----#----#----#----#----#----#----#----#----#----#----#----#----#----#----#----#----#----#----#---
##---##---##---##---##---##---##---##---##---##---##---##---##---##---##---##---##---##---##---##---
-#----#----#----#----#----#----#----#----#----#----#----#----#----#----#----#----#----#----#----#---
-##---##---##---##---##---##---##---##---##---##---##---##---##---##---##---##---##---##---##---##--
--#----#----#----#----#----#----#----#----#----#----#----#----#----#----#----#----#----#----#----#--
-#----#----#----#----#----#----#----#----#----#----#----#----#----#----#----#----#----#----#----#---
##---##---##---##---##---##---##---##---##---##---##---##---##---##---##---##---##---##---##---##---
-#----#----#----#----#----#----#----#----#----#----#----#----#----#----#----#----#----#----#----#---
-##---##---##---##---##---##---##---##---##---##---##---##---##---##---##---##---##---##---##---##--
--#----#----#----#----#----#----#----#----#----#----#----#----#----#----#----#----#----#----#----#--
-#----#----#----#----#----#----#----#----#----#----#----#----#----#----#----#----#----#----#----#---
##---##---##---##---##---##---##---##---##---##---##---##---##---##---##---##---##---##---##---##---
-#----#----#----#----#----#----#----#----#----#----#----#----#----#----#----#----#----#----#----#---
-##---##---##---##---##---##---##S--##---##---##---##---##---##---##---##---##---##---##---##---##--
--#----#----#----#----#----#----#----#----#----#----#----#----#----#----#----#----#----#----#----#--
-#----#----#----#----#----#----#----#----#----#----#----#----#----#----#----#----#----#----#----#---
##---##---##---##---##---##---##---##---##---##---##---##---##---##---##---##---##---##---##---##---
-#----#----#----#----#----#----#----#----#----#----#----#----#----#----#----#----#----#----#----#---
-##---##---##---##---##---##---##---##---##---##---##---##---##---##---##---##---##---##---##---##--
--#----#----#----#----#----#----#----#----#----#----#----#----#----#----#----#----#----#----#----#--
-#----#----#----#----#----#----#----#----#----#----#----#----#----#----#----#----#----#----#----#---
##---##---##---##---##---##---##---##---##---##---##---##---##---##---##---##---##---##---##---##---
-#----#----#----#----#----#----#----#----#----#----#----#----#----#----#----#----#----#----#----#---
-##---##---##---##---##---##---##---##---##---##---##---##---##---##---##---##---##---##---##---##--
--#----#----#----#----#----#----#----#----#----#----#----#----#----#----#----#----#----#----#----#--
-#----#----#----#----#----#----#----#----#----#----#----#----#----#----#----#----#----#----#----#---
##---##---##---##---##---##---##---##---##---##---##---##---##---##---##---##---##---##---##---##---
-#----#----#----#----#----#----#----#----#----#----#----#----#----#----#----#----#----#----#----#---
-##---##---##---##---##---##---##---##---##---##---##---##---##---##---##---##---##---##---##---##--
--#----#----#----#----#----#----#----#----#----#----#----#----#----#----#----#----#----#----#----#--
-#----#----#----#----#----#----#----#----#----#----#----#----#----#----#----#----#----#----#----#---
##---##---##---##---##---##---##---##---##---##---##---##---##---##---##---##---##---##---##---##---
-#----#----#----#----#----#----#----#----#----#----#----#----#----#----#----#----#----#----#----#---
-##---##---##---##---##---##---##---##---##---##---##---##---##---##---##---##---##---##---##---##--
--#----#----#----#----#----#----#----#----#----#----#----#----#----#----#----#----#----#----#----#--
-#----#----#----#----#----#----#----#----#----#----#----#----#----#----#----#----#----#----#----#---
##---##---##---##---##---##---##---##---##---##---##---##---##---##---##---##---##---##---##---##---
-#----#----#----#----#----#----#----#----#----#----#----#----#----#----#----#----#----#----#----#---
-##---##---##---##---##---##---##---##---##---##---##---##---##---##---##---##---##---##---##---##--
--#----#----#----#----#----#----#----#----#----#----#----#----#----#----#----#----#----#----#----#--
-#----#----#----#----#----#----#----#----#----#----#----#----#----#----#----#----#----#----#----#---
##---##---##---##---##---##---##---##---##---##---##---##---##---##---##---##---##---##E--##---##---
-#----#----#----#----#----#----#----#----#----#----#----#----#----#----#----#----#----#----#----#---
-##---##---##---##---##---##---##---##---##---##---##---##---##---##---##---##---##---##---##---##--
--#----#----#----#----#----#----#----#----#----#----#----#----#----#----#----#----#----#----#----#--
-#----#----#----#----#----#----#----#----#----#----#----#----#----#----#----#----#----#----#----#---
##---##---##---##---##---##---##---##---##---##---##---##---##---##---##---##---##---##---##---##---
-#----#----#----#----#----#----#----#----#----#----#----#----#----#----#----#----#----#----#----#---
-##---##---##---##---##---##---##---##---##---##---##---##---##---##---##---##---##---##---##---##--
--#----#----#----#----#----#----#----#----#----#----#----#----#----#----#----#----#----#----#----#--
-#----#----#----#----#----#----#----#----#----#----#----#----#----#----#----#----#----#----#----#---
##---##---##---##---##---##---##---##---##---##---##---##---##---##---##---##---##---##---##---##---
-#----#----#----#----#----#----#----#----#----#----#----#----#----#----#----#----#----#----#----#---
-##---##---##---##---##---##---##---##---##---##---##---##---##---##---##---##---##---##---##---##--
--#----#----#----#----#----#----#----#----#----#----#----#----#----#----#----#----#----#----#----#--
-#----#----#----#----#----#----#----#----#----#----#----#----#----#----#----#----#----#----#----#---
##---##---##---##---##---##---##---##---##---##---##---##---##---##---##---##---##---##---##---##---
-#----#----#----#----#----#----#----#----#----#----#----#----#----#----#----#----#----#----#----#---
-##---##---##---##---##---##---##---##---##---##---##---##---##---##---##---##---##---##---##---##--
--#----#----#----#----#----#----#----#----#----#----#----#----#----#----#----#----#----#----#----#--
-#----#----#----#----#----#----#----#----#----#----#----#----#----#----#----#----#----#----#----#---
##---##---##---##---##---##---##---##---##---##---##---##---##---##---##---##---##---##---##---##---
-#----#----#----#----#----#----#----#----#----#----#----#----#----#----#----#----#----#----#----#---
-##---##---##---##---##---##---##---##---##---##---##---##---##---##---##---##---##---##---##---##--
--#----#----#----#----#----#----#----#----#----#----#----#----#----#----#----#----#----#----#----#--
-#----#----#----#----#----#----#----#----#----#----#----#----#----#----#----#----#----#----#----#---
##---##---##---##---##---##---##---##---##---##---##---##---##---##---##---##---##---##---##---##---
-#----#----#----#----#----#----#----#----#----#----#----#----#----#----#----#----#----#----#----#---
-##---##---##---##---##---##---##---##---##---##---##---##---##---##---##---##---##---##---##---##--
--#----#----#----#----#----#----#----#----#----#----#----#----#----#----#----#----#----#----#----#--
-#----#----#----#----#----#----#----#----#----#----#----#----#----#----#----#----#----#----#----#---
##---##---##---##---##---##---##---##---##---##---##---##---##---##---##---##---##---##---##---##---
-#----#----#----#----#----#----#----#----#----#----#----#----#----#----#----#----#----#----#----#---
-##---##---##---##---##---##---##---##---##---##---##---##---##---##---##---##---##---##---##---##--
--#----#----#----#----#----#----#----#----#----#----#----#----#----#----#----#----#----#----#----#--
-#----#----#----#----#----#----#----#----#----#----#----#----#----#----#----#----#----#----#----#---
##---##---##---##---##---##---##---##---##---##---##---##---##---##---##---##---##---##---##---##---
-#----#----#----#----#----#----#----#----#----#----#----#----#----#----#----#----#----#----#----#---
-##---##---##---##---##---##---##---##---##---##---##---##---##---##---##---##---##---##---##---##--
--#----#----#----#----#----#----#----#----#----#----#----#----#----#----#----#----#----#----#----#--
-#----#----#----#----#----#----#----#----#----#----#----#----#----#----#----#----#----#----#----#---
##---##---##---##---##---##---##---##---##---##---##---##---##---##---##---##---##---##---##---##---
-#----#----#----#----#----#----#----#----#----#----#----#----#----#----#----#----#----#----#----#---
-##---##---##---##---##---##---##---##---##---##---##---##---##---##---##---##---##---##---##---##--
--#----#----#----#----#----#----#----#----#----#----#----#----#----#----#----#----#----#----#----#--
-#----#----#----#----#----#----#----#----#----#----#----#----#----#----#----#----#----#----#----#---
##---##---##---##---##---##---##---##---##---##---##---##---##---##---##---##---##---##---##---##---
-#----#----#----#----#----#----#----#----#----#----#----#----#----#----#----#----#----#----#----#---
-##---##---##---##---##---##---##---##---##---##---##---##---##---##---##---##---##---##---##---##--
--#----#----#----#----#----#----#----#----#----#----#----#----#----#----#----#----#----#----#----#--
-#----#----#----#----#----#----#----#----#----#----#----#----#----#----#----#----#----#----#----#---
##---##---##---##---##---##---##---##---##---##---##---##---##---##---##---##---##---##---##---##---
-#----#----#----#----#----#----#----#----#----#----#----#----#----#----#----#----#----#----#----#---
-##---##---##---##---##---##---##---##---##---##---##---##---##---##---##---##---##---##---##---##--
--#----#----#----#----#----#----#----#----#----#----#----#----#----#----#----#----#----#----#----#--