?diagonal=Always;
---#----#----#----#----#----#----#----#----#----#----#----#----#----#----#----#----#----#----#----#-
#--#-#--#-#--#-#--#-#--#-#--#-#--#-#--#-#--#-#--#-#--#-#--#-#--#-#--#-#--#-#--#-#--#-#--#-#--#-#--#-
----#----#----#----#----#----#----#----#----#----#----#----#----#----#----#----#----#----#----#----#
-###--###--###--###--###--###--###--###--###--###--###--###--###--###--###--###--###--###--###--###-
----------------------------------------------------------------------------------------------------
---#----#----#----#----#----#----#----#----#----#----#----#----#----#----#----#----#----#----#----#-
#--#-#--#-#--#-#--#-#--#-#--#-#--#-#--#-#--#-#--#-#--#-#--#-#--#-#--#-#--#-#--#-#--#-#--#-#--#-#--#-
----#----#----#----#----#----#----#----#----#----#----#----#----#----#----#----#----#----#----#----#
-###--###--###--###--###--###--###--###--###--###--###--###--###--###--###--###--###--###--###--###-
----------------------------------------------------------------------------------------------------
---#----#----#----#----#----#----#----#----#----#----#----#----#----#----#----#----#----#----#----#-
#--#-#--#-#--#-#--#-#--#-#--#-#--#-#--#-#--#-#--#-#--#-#--#-#--#-#--#-#--#-#--#-#--#-#--#-#--#-#--#-
----#----#----#----#----#----#----#----#----#----#----#----#----#----#----#----#----#----#----#----#
-###--###--###--###--###--###--###--###--###--###--###--###--###--###--###--###--###--###--###--###-
----------------------------------------------------------------------------------------------------
---#----#----#----#----#----#----#----#----#----#----#----#----#----#----#----#----#----#----#----#-
#--#-#--#-#--#-#--#-#--#-#--#-#--#-#--#-#--#-#--#-#--#-#--#-#--#-#--#-#--#-#--#-#--#-#--#-#--#-#--#-
----#----#----#----#----#----#----#----#----#----#----#----#----#----#----#----#----#----#----#----#
-###--###--###--###--###--###--###--###--###--###--###--###--###--###--###--###--###--###--###--###-
----------------------------------------------------------------------------------------------------
---#----#----#----#----#----#----#----#----#----#----#----#----#----#----#----#----#----#----#----#-
#--#-#--#-#--#-#--#-#--#-#--#-#--#-#--#-#--#-#--#-#--#-#--#-#--#-#--#-#--#-#--#-#--#-#--#-#--#-#--#-
----#----#----#----#----#----#----#----#----#----#----#----#----#----#----#----#----#----#----#----#
-###--###--###--###--###--###--###--###--###--###--###--###--###--###--###--###--###--###--###--###-
----------------------------------------------------------------------------------------------------
---#----#----#----#----#----#----#----#----#----#----#----#----#----#----#----#----#----#----#----#-
#--#-#--#-#--#-#--#-#--#-#--#-#--#-#--#-#--#-#--#-#--#-#--#-#--#-#--#-#--#-#--#-#--#-#--#-#--#-#--#-
----#----#----#----#----#----#----#----#----#----#----#----#----#----#----#----#----#----#----#----#
-###--###--###--###--###--###--###--###--###--###--###--###--###--###--###--###--###--###--###--###-
----------------------------------------------------------------------------------------------------
---#----#----#----#----#----#----#----#----#----#----#----#----#----#----#----#----#----#----#----#-
#--#-#--#-#--#-#--#-#--#-#--#-#--#-#--#-#--#-#--#-#--#-#--#-#--#-#--#-#--#-#--#-#--#-#--#-#--#-#--#-
----#----#----#----#----#----#----#----#----#----#----#----#----#----#----#----#----#----#----#----#
-###--###--###--###--###--###--###--###--###--###--###--###--###--###--###--###--###--###--###--###-
----------------------------------------------------------------------------------------------------
---#----#----#----#----#----#----#----#----#----#----#----#----#----#----#----#----#----#----#----#-
#--#-#--#-#--#-#--#-#--#-#--#-#--#-#--#-#--#-#--#-#--#-#--#-#--#-#--#-#--#-#--#-#--#-#--#-#--#-#--#-
----#----#----#----#----#----#----#----#----#----#----#----#----#----#----#----#----#----#----#----#
-###--###--###--###--###--###--###--###--###--###--###--###--###--###--###--###--###--###--###--###-
----------------------------------------------------------------------------------------------------
---#----#----#----#----#----#----#----#----#----#----#----#----#----#----#----#----#----#----#----#-
#--#-#--#-#--#-#--#-#--#-#--#-#--#-#--#-#--#-#--#-#--#-#--#-#--#-#--#-#--#-#--#-#--#-#--#-#--#-#--#-
----#----#----#----#----#----#----#----#----#----#----#----#----#----#----#----#----#----#----#----#
-###--###--###--###--###--###--###--###--###--###--###--###--###--###--###--###--###--###--###--###-
----------------------------------------------------------------------------------------------------
---#----#----#----#----#----#----#----#----#----#----#----#----#----#----#----#----#----#----#----#-
#--#-#--#-#--#-#--#-#--#-#--#-#--#-#--#-#--#-#--#-#--#-#--#-#--#-#--#-#--#-#--#-#--#-#--#-#--#-#--#-
----#----#----#----#----#----#----#----#----#----#----#----#----#----#----#----#----#----#----#----#
-###--###--###--###--###--###--###--###--###--###--###--###--###--###--###--###--###--###--###--###-
----------------------------------------------------------------------------------------------------
---#----#----#----#----#----#----#----#----#----#----#----#----#----#----#----#----#----#----#----#-
#--#-#--#-#--#-#--#-#--#-#--#-#--#-#--#-#--#-#--#-#--#-#--#-#--#-#--#-#--#-#--#-#--#-#--#-#--#-#--#-
----#----#----#----#----#----#----#----#----#----#----#----#----#----#----#----#----#----#----#----#
-###--###--###--###--###--###--###--###--###--###--###--###--###--###--###--###--###--###--###--###-
----------------------------------------------------------------------------------------------------
---#----#----#----#----#----#----#----#----#----#----#----#----#----#----#----#----#----#----#E---#-
#--#-#--#-#--#-#--#-#--#-#--#-#--#-#--#-#--#-#--#-#--#-#--#-#--#-#--#-#--#-#--#-#--#-#--#-#--#-#--#-
----#----#----#----#----#----#----#----#----#----#----#----#----#----#----#----#----#----#----#----#
-###--###--###--###--###--###--###--###--###--###--###--###--###--###--###--###--###--###--###--###-
----------------------------------------------------------------------------------------------------
---#----#----#----#----#----#----#----#----#----#----#----#----#----#----#----#----#----#----#----#-
#--#-#--#-#--#-#--#-#--#-#--#-#--#-#--#-#--#-#--#-#--#-#--#-#--#-#--#-#--#-#--#-#--#-#--#-#--#-#--#-
----#----#----#----#----#----#----#----#----#----#----#----#----#----#----#----#----#----#----#----#
-###--###--###--###--###--###--###--###--###--###--###--###--###--###--###--###--###--###--###--###-
----------------------------------------------------------------------------------------------------
---#----#----#----#----#----#----#----#----#----#----#----#----#----#----#----#----#----#----#----#-
#--#-#--#-#--#-#--#-#--#-#--#-#--#-#--#-#--#-#--#-#--#-#--#-#--#-#--#-#--#-#--#-#--#-#--#-#--#-#--#-
----#----#----#----#----#----#----#----#----#----#----#----#----#----#----#----#----#----#----#----#
-###--###--###--###--###--###--###--###--###--###--###--###--###--###--###--###--###--###--###--###-
----------------------------------------------------------------------------------------------------
---#----#----#----#----#----#----#----#----#----#----#----#----#----#----#----#----#----#----#----#-
#--#-#--#-#--#-#--#-#--#-#--#-#--#-#--#-#--#-#--#-#--#-#--#-#--#-#--#-#--#-#--#-#--#-#--#-#--#-#--#-
----#----#----#----#----#----#----#----#----#----#----#----#----#----#----#----#----#----#----#----#
-###--###--###--###--###--###--###--###--###--###--###--###--###--###--###--###--###--###--###--###-
----------------------------------------------------------------------------------------------------
---#----#----#----#----#----#----#----#----#----#----#----#----#----#----#----#----#----#----#----#-
#--#-#--#-#--#-#--#-#--#-#--#-#--#-#--#-#--#-#--#-#--#-#--#-#--#-#--#-#--#-#--#-#--#-#--#-#--#-#--#-
----#----#----#----#----#----#----#----#----#----#----#----#----#----#----#----#----#----#----#----#
-###--###--###--###--###--###--###--###--###--###--###--###--###--###--###--###--###--###--###--###-
----------------------------------------------------------------------------------------------------
---#----#----#----#----#----#----#----#----#----#----#----#----#----#----#----#----#----#----#----#-
#--#-#--#-#--#-#--#-#--#-#--#-#--#-#--#-#--#-#--#-#--#-#--#-#--#-#--#-#--#-#--#-#--#-#--#-#--#-#--#-
----#----#----#----#----#----#----#----#----#----#----#----#---S#----#----#----#----#----#----#----#
-###--###--###--###--###--###--###--###--###--###--###--###--###--###--###--###--###--###--###--###-
----------------------------------------------------------------------------------------------------
---#----#----#----#----#----#----#----#----#----#----#----#----#----#----#----#----#----#----#----#-
#--#-#--#-#--#-#--#-#--#-#--#-#--#-#--#-#--#-#--#-#--#-#--#-#--#-#--#-#--#-#--#-#--#-#--#-#--#-#--#-
----#----#----#----#----#----#----#----#----#----#----#----#----#----#----#----#----#----#----#----#
-###--###--###--###--###--###--###--###--###--###--###--###--###--###--###--###--###--###--###--###-
----------------------------------------------------------------------------------------------------
---#----#----#----#----#----#----#----#----#----#----#----#----#----#----#----#----#----#----#----#-
#--#-#--#-#--#-#--#-#--#-#--#-#--#-#--#-#--#-#--#-#--#-#--#-#--#-#--#-#--#-#--#-#--#-#--#-#--#-#--#-
----#----#----#----#----#----#----#----#----#----#----#----#----#----#----#----#----#----#----#----#
-###--###--###--###--###--###--###--###--###--###--###--###--###--###--###--###--###--###--###--###-
----------------------------------------------------------------------------------------------------
---#----#----#----#----#----#----#----#----#----#----#----#----#----#----#----#----#----#----#----#-
#--#-#--#-#--#-#--#-#--#-#--#-#--#-#--#-#--#-#--#-#--#-#--#-#--#-#--#-#--#-#--#-#--#-#--#-#--#-#--#-
----#----#----#----#----#----#----#----#----#----#----#----#----#----#----#----#----#----#----#----#
-###--###--###--###--###--###--###--###--###--###--###--###--###--###--###--###--###--###--###--###-
----------------------------------------------------------------------------------------------------