?diagonal=Always;
#--#-#--#-#--#-#--#-#--#-#--#-#--#-#--#-#--#-#--#-#--#-#--#-#--#-#--#-#--#-#--#-#--#-#--#-#--#-#--#-
-#----#----#----#----#----#----#----#----#----#----#----#----#----#----#----#----#----#----#----#---
----#----#----#----#----#----#----#----#----#----#----#----#----#----#----#----#----#----#----#----#
--#----#----#----#----#----#----#----#----#----#----#----#----#----#----#----#----#----#----#----#--
##--###--###--###--###--###--###--###--###--###--###--###--###--###--###--###--###--###--###--###--#
#--#-#--#-#--#-#--#-#--#-#--#-#--#-#--#-#--#-#--#-#--#-#--#-#--#-#--#-#--#-#--#-#--#-#--#-#--#-#--#-
-#----#----#----#----#----#----#----#----#----#----#----#----#----#----#----#----#----#----#----#---
----#----#----#----#----#----#----#----#----#----#----#----#----#----#----#----#----#----#----#----#
--#----#----#----#----#----#----#----#----#----#----#----#----#----#----#----#----#----#----#----#--
##--###--###--###--###--###--###--###--###--###--###--###--###--###--###--###--###--###--###--###--#
#--#-#--#-#--#-#--#-#--#-#--#-#--#-#--#-#--#-#--#-#--#-#--#-#--#-#--#-#--#-#--#-#--#-#--#-#--#-#--#-
-#----#----#----#----#----#----#----#----#----#----#----#----#----#----#----#----#----#----#----#---
----#----#----#----#----#----#----#----#----#----#----#----#----#----#----#----#----#----#----#----#
--#----#----#----#----#----#----#----#----#----#----#----#----#----#----#----#----#----#----#----#--
##--###--###--###--###--###--###--###--###--###--###--###--###--###--###--###--###--###--###--###--#
#--#-#--#-#--#-#--#-#--#-#--#-#--#-#--#-#--#-#--#-#--#-#--#-#--#-#--#-#--#-#--#-#--#-#--#-#--#-#--#-
-#----#----#----#----#----#----#----#----#----#----#----#----#----#----#----#----#----#----#----#---
----#----#----#----#----#----#----#----#----#----#----#----#----#----#----#----#----#----#----#----#
--#----#----#----#----#----#----#----#----#----#----#----#----#----#----#----#----#----#----#----#--
##--###--###--###--###--###--###--###--###--###--###--###--###--###--###--###--###--###--###--###--#
#--#-#--#-#--#-#--#-#--#-#--#-#--#-#--#-#--#-#--#-#--#-#--#-#--#-#--#-#--#-#--#-#--#-#--#-#--#-#--#-
-#----#----#----#----#----#----#----#----#----#----#----#----#----#----#----#----#----#----#----#---
----#----#----#----#----#----#----#----#----#----#----#----#----#----#----#----#----#----#----#----#
--#----#----#----#----#----#----#----#----#----#----#----#----#----#----#----#----#----#----#----#--
##--###--###--###--###--###--###--###--###--###--###--###--###--###--###--###--###--###--###--###--#
#--#-#--#-#--#-#--#-#--#-#--#-#--#-#--#-#--#-#--#-#--#-#--#-#--#-#--#-#--#-#--#-#--#-#--#-#--#-#--#-
-#----#----#----#----#----#----#----#----#----#----#----#----#----#----#----#----#----#----#----#---
----#----#----#----#----#----#----#----#----#----#----#----#----#----#----#----#----#----#----#----#
--#----#----#----#----#----#----#----#----#----#----#----#----#----#----#----#----#----#----#----#--
##--###--###--###--###--###--###--###--###--###--###--###--###--###--###--###--###--###--###--###--#
#--#-#--#-#--#-#--#-#--#-#--#-#--#-#--#-#--#-#--#-#--#-#--#-#--#-#--#-#--#-#--#-#--#-#--#-#--#-#--#-
-#----#----#----#----#----#----#----#----#----#----#----#----#----#----#----#----#----#----#----#---
----#----#----#----#----#----#----#----#----#----#----#----#----#----#----#----#----#----#----#----#
--#----#----#----#----#----#----#----#----#----#----#----#----#----#----#----#----#----#----#----#--
##--###--###--###--###--###--###--###--###--###--###--###--###--###--###--###--###--###--###--###--#
#--#-#--#-#--#-#--#-#--#-#--#-#--#-#--#-#--#-#--#-#--#-#--#-#--#-#--#-#--#-#--#-#--#-#--#-#--#-#--#-
-#----#----#----#----#----#----#----#----#----#----#----#----#----#----#----#----#----#----#----#---
----#----#----#----#----#----#----#----#----#----#----#----#----#----#----#----#----#----#----#----#
--#----#----#----#----#----#----#----#----#----#----#----#----#----#----#----#----#----#----#----#--
##--###--###--###--###--###--###--###--###--###--###--###--###--###--###--###--###--###--###--###--#
#--#-#--#-#--#-#--#-#--#-#--#-#--#-#--#-#--#-#--#-#--#-#--#-#--#-#--#-#--#-#--#-#--#-#--#-#--#-#--#-
-#----#----#----#----#----#----#----#----#----#----#----#----#----#----#----#----#----#----#----#---
----#----#----#----#----#----#----#----#----#----#----#----#----#----#----#----#----#----#----#----#
--#----#----#----#----#----#----#----#----#----#----#----#----#----#----#----#----#----#----#----#--
##--###--###--###--###--###--###--###--###--###--###--###--###--###--###--###--###--###--###--###--#
#--#-#--#-#--#-#--#-#--#-#--#-#--#-#--#-#--#-#--#-#--#-#--#-#--#-#--#-#--#-#--#-#--#-#--#-#--#-#--#-
-#----#----#----#----#----#----#----#----#----#----#----#----#----#----#----#----#----#----#----#---
----#----#----#----#----#----#----#----#----#----#----#----#----#----#----#----#----#----#----#----#
--#----#----#----#----#----#----#----#----#----#----#----#----#----#----#----#----#----#----#----#--
##--###--###--###S-###--###--###--###--###--###--###--###--###--###--###--###--###--###--###--###--#
#--#-#--#-#--#-#--#-#--#-#--#-#--#-#--#-#--#-#--#-#--#-#--#-#--#-#--#-#--#-#--#-#--#-#--#-#--#-#--#-
-#----#----#----#----#----#----#----#----#----#----#----#----#----#----#----#----#----#----#----#---
----#----#----#----#----#----#----#----#----#----#----#----#----#----#----#----#----#----#----#----#
--#----#----#----#----#----#----#----#----#----#----#----#----#----#----#----#----#----#----#----#--
##--###--###--###--###--###--###--###--###--###--###--###--###--###--###--###--###--###--###--###--#
#--#-#--#-#--#-#--#-#--#-#--#-#--#-#--#-#--#-#--#-#--#-#--#-#--#-#--#-#--#-#--#-#--#-#--#-#--#-#--#-
-#----#----#----#----#----#----#----#----#----#----#----#----#----#----#----#----#----#----#----#---
----#----#----#----#----#----#----#----#----#----#----#----#----#----#----#----#----#----#----#----#
--#----#----#----#----#----#----#----#----#----#----#----#----#----#----#----#----#----#----#----#--
##--###--###--###--###--###--###--###--###--###--###--###--###--###--###--###--###E-###--###--###--#
#--#-#--#-#--#-#--#-#--#-#--#-#--#-#--#-#--#-#--#-#--#-#--#-#--#-#--#-#--#-#--#-#--#-#--#-#--#-#--#-
-#----#----#----#----#----#----#----#----#----#----#----#----#----#----#----#----#----#----#----#---
----#----#----#----#----#----#----#----#----#----#----#----#----#----#----#----#----#----#----#----#
--#----#----#----#----#----#----#----#----#----#----#----#----#----#----#----#----#----#----#----#--
##--###--###--###--###--###--###--###--###--###--###--###--###--###--###--###--###--###--###--###--#
#--#-#--#-#--#-#--#-#--#-#--#-#--#-#--#-#--#-#--#-#--#-#--#-#--#-#--#-#--#-#--#-#--#-#--#-#--#-#--#-
-#----#----#----#----#----#----#----#----#----#----#----#----#----#----#----#----#----#----#----#---
----#----#----#----#----#----#----#----#----#----#----#----#----#----#----#----#----#----#----#----#
--#----#----#----#----#----#----#----#----#----#----#----#----#----#----#----#----#----#----#----#--
##--###--###--###--###--###--###--###--###--###--###--###--###--###--###--###--###--###--###--###--#
#--#-#--#-#--#-#--#-#--#-#--#-#--#-#--#-#--#-#--#-#--#-#--#-#--#-#--#-#--#-#--#-#--#-#--#-#--#-#--#-
-#----#----#----#----#----#----#----#----#----#----#----#----#----#----#----#----#----#----#----#---
----#----#----#----#----#----#----#----#----#----#----#----#----#----#----#----#----#----#----#----#
--#----#----#----#----#----#----#----#----#----#----#----#----#----#----#----#----#----#----#----#--
##--###--###--###--###--###--###--###--###--###--###--###--###--###--###--###--###--###--###--###--#
#--#-#--#-#--#-#--#-#--#-#--#-#--#-#--#-#--#-#--#-#--#-#--#-#--#-#--#-#--#-#--#-#--#-#--#-#--#-#--#-
-#----#----#----#----#----#----#----#----#----#----#----#----#----#----#----#----#----#----#----#---
----#----#----#----#----#----#----#----#----#----#----#----#----#----#----#----#----#----#----#----#
--#----#----#----#----#----#----#----#----#----#----#----#----#----#----#----#----#----#----#----#--
##--###--###--###--###--###--###--###--###--###--###--###--###--###--###--###--###--###--###--###--#
#--#-#--#-#--#-#--#-#--#-#--#-#--#-#--#-#--#-#--#-#--#-#--#-#--#-#--#-#--#-#--#-#--#-#--#-#--#-#--#-
-#----#----#----#----#----#----#----#----#----#----#----#----#----#----#----#----#----#----#----#---
----#----#----#----#----#----#----#----#----#----#----#----#----#----#----#----#----#----#----#----#
--#----#----#----#----#----#----#----#----#----#----#----#----#----#----#----#----#----#----#----#--
##--###--###--###--###--###--###--###--###--###--###--###--###--###--###--###--###--###--###--###--#
#--#-#--#-#--#-#--#-#--#-#--#-#--#-#--#-#--#-#--#-#--#-#--#-#--#-#--#-#--#-#--#-#--#-#--#-#--#-#--#-
-#----#----#----#----#----#----#----#----#----#----#----#----#----#----#----#----#----#----#----#---
----#----#----#----#----#----#----#----#----#----#----#----#----#----#----#----#----#----#----#----#
--#----#----#----#----#----#----#----#----#----#----#----#----#----#----#----#----#----#----#----#--
##--###--###--###--###--###--###--###--###--###--###--###--###--###--###--###--###--###--###--###--#
#--#-#--#-#--#-#--#-#--#-#--#-#--#-#--#-#--#-#--#-#--#-#--#-#--#-#--#-#--#-#--#-#--#-#--#-#--#-#--#-
-#----#----#----#----#----#----#----#----#----#----#----#----#----#----#----#----#----#----#----#---
----#----#----#----#----#----#----#----#----#----#----#----#----#----#----#----#----#----#----#----#
--#----#----#----#----#----#----#----#----#----#----#----#----#----#----#----#----#----#----#----#--
##--###--###--###--###--###--###--###--###--###--###--###--###--###--###--###--###--###--###--###--#
#--#-#--#-#--#-#--#-#--#-#--#-#--#-#--#-#--#-#--#-#--#-#--#-#--#-#--#-#--#-#--#-#--#-#--#-#--#-#--#-
-#----#----#----#----#----#----#----#----#----#----#----#----#----#----#----#----#----#----#----#---
----#----#----#----#----#----#----#----#----#----#----#----#----#----#----#----#----#----#----#----#
--#----#----#----#----#----#----#----#----#----#----#----#----#----#----#----#----#----#----#----#--
##--###--###--###--###--###--###--###--###--###--###--###--###--###--###--###--###--###--###--###--#