?diagonal=Always;
-#----#----#----#----#----#----#----#----#----#----#----#----#----#----#----#----#----#----#----#---
---##---##---##---##---##---##---##---##---##---##---##---##---##---##---##---##---##---##---##---##
----------------------------------------------------------------------------------------------------
#----#----#----#----#----#----#----#----#----#----#----#----#----#----#----#----#----#----#----#----
---##---##---##---##---##---##---##---##---##---##---##---##---##---##---##---##---##---##---##---##
-#----#----#----#----#----#----#----#----#----#----#----#----#----#----#----#----#----#----#----#---
---##---##---##---##---##---##---##---##---##---##---##---##---##---##---##---##---##---##---##---##
----------------------------------------------------------------------------------------------------
#----#----#----#----#----#----#----#----#----#----#----#----#----#----#----#----#----#----#----#----
---##---##---##---##---##---##---##---##---##---##---##---##---##---##---##---##---##---##---##---##
-#----#----#----#----#----#----#----#----#----#----#----#----#----#----#----#----#----#----#----#---
---##---##---##---##---##---##---##---##---##---##---##---##---##---##---##---##---##---##---##---##
----------------------------------------------------------------------------------------------------
#----#----#----#----#----#----#----#----#----#----#----#----#----#----#----#----#----#----#----#----
---##---##---##---##---##---##---##---##---##---##---##---##---##---##---##---##---##---##---##---##
-#----#----#----#----#----#----#----#----#----#----#----#----#----#----#----#----#----#----#----#---
---##---##---##---##---##---##---##---##---##---##---##---##---##---##---##---##---##---##---##---##
----------------------------------------------------------------------------------------------------
#----#----#----#----#----#----#----#----#----#----#----#----#----#----#----#----#----#----#----#----
---##---##---##---##---##---##---##---##---##---##---##---##---##---##---##---##---##---##---##---##
-#----#----#----#----#----#----#----#----#----#----#----#----#----#----#----#----#----#----#----#---
---##---##---##---##---##---##---##---##---##---##---##---##---##---##---##---##---##---##---##---##
----------------------------------------------------------------------------------------------------
#----#----#----#----#----#----#----#----#----#----#----#----#----#----#----#----#----#----#----#----
---##---##---##---##---##---##---##---##---##---##---##---##---##---##---##---##---##---##---##---##
-#----#----#----#----#----#----#----#----#----#----#----#----#----#----#----#----#----#----#----#---
---##---##---##---##---##---##---##---##---##---##---##---##---##---##---##---##---##---##---##---##
----------------------------------------------------------------------------------------------------
#----#----#----#----#----#----#----#----#----#----#----#----#----#----#----#----#----#----#----#----
---##---##---##---##---##---##---##---##---##---##---##---##---##---##---##---##---##---##---##---##
-#----#----#----#----#----#----#----#----#----#----#----#----#----#----#----#----#----#----#----#---
---##---##---##---##---##---##---##---##---##---##---##---##---##---##---##---##---##---##---##---##
----------------------------------------------------------------------------------------------------
#----#----#----#----#----#----#----#----#----#----#----#----#----#----#----#----#----#----#----#----
---##---##---##---##---##---##---##---##---##---##---##---##---##---##---##---##---##---##---##---##
-#----#----#----#----#----#----#----#----#----#----#----#----#----#----#----#----#----#----#----#---
---##---##---##---##---##---##---##---##---##---##---##---##---##---##---##---##---##---##---##---##
----------------------------------------------------------------------------------------------------
#----#----#----#----#----#----#----#----#----#----#----#----#----#----#----#----#----#----#----#----
---##---##---##---##---##---##---##---##---##---##---##---##---##---##---##---##---##---##---##---##
-#----#----#----#----#----#----#----#----#----#----#----#----#----#----#----#----#----#----#----#---
---##---##---##---##---##---##---##---##---##---##---##---##---##---##---##---##---##---##---##---##
----------------------------------------------------------------------------------------------------
#----#----#----#----#----#----#----#----#----#----#----#----#----#----#----#----#----#----#----#----
---##---##---##---##---##---##---##---##---##---##---##---##---##---##---##---##---##---##---##---##
-#----#----#----#----#----#----#----#----#----#----#----#----#----#----#----#----#----#----#----#---
---##---##---##---##---##---##---##---##---##---##---##---##---##---##---##---##---##---##---##---##
----------------------------------------------------------------------------------------------------
#----#----#----#----#----#----#----#----#----#----#----#----#----#----#----#----#----#----#----#----
---##---##---##---##---##---##---##---##---##---##---##---##---##---##---##---##---##---##---##---##
-#----#----#----#----#----#----#----#----#----#----#----#----#----#----#----#----#----#----#----#---
---##---##---##---##---##---##---##---##---##---##---##---##---##---##---##---##---##---##---##---##
----------------------------------------------------------------------------------------------------
#----#----#----#----#----#----#----#----#----#----#----#----#----#----#----#----#----#----#----#----
---##---##---##---##---##---##---##---##---##---##---##---##---##---##---##---##---##---##---##---##
-#----#----#----#----#----#----#----#----#----#----#----#----#----#----#----#----#----#----#----#---
---##---##---##---##---##---##---##---##---##---##---##---##---##---##---##---##---##---##---##---##
----------------------------------------------------------------------------------------------------
#----#----#----#----#----#----#----#----#----#----#----#----#----#----#----#----#----#----#----#----
---##---##---##---##---##---##---##---##---##---##---##---##---##---##---##---##---##---##---##---##
-#----#----#----#----#----#----#----#----#----#----#----#----#----#----#----#----#----#----#----#---
---##---##---##---##---##---##---##---##---##---##---##---##---##---##---##---##---##---##---##---##
----------------------------------------------------------------------------------------------------
#----#----#----#----#----#----#----#----#----#----#----#----#----#----#----#----#----#----#----#----
---##---##---##---##---##---##---##---##---##---##---##---##---##---##---##---##---##---##---##---##
-#----#----#----#----#----#----#----#----#----#----#----#----#----#----#----#----#----#----#----#---
---##---##---##---##---##---##---##---##---##---##---##---##---##---##---##---##---##---##---##---##
----------------------------------------------------------------------------------------------------
#----#----#----#----#----#----#----#----#----#----#----#----#----#----#----#----#----#----#----#----
---##---##---##---##---##---##---##---##---##---##---##---##---##---##---##---##---##---##---##---##
-#----#----#----#----#----#----#----#----#----#----#----#----#----#----#----#----#----#----#----#---
---##---##---##---##---##---##---##---##---##---##---##---##---##---##---##---##---##---##---##---##
----------------------------------------------------------------------------------------------------
#----#----#----#----#----#----#----#----#----#----#----#----#----#----#----#----#----#----#----#----
---##---##---##---##---##---##---##---##---##---##---##---##---##---##---##---##---##---##---##---##
-#----#----#----#----#----#----#----#----#----#----#----#----#----#----#----#----#----#----#----#---
---##---##---##---##---##---##---##---##---##---##---##---##---##---##---##---##---##---##---##---##
----------------------------------------------------------------------------------------------------
#----#----#----#----#----#----#----#----#----#----#----#----#----#----#----#----#----#----#----#----
---##---##---##---##---##---##---##---##---##---##---##---##---##---##---##---##---##---##---##---##
-#----#----#----#----#----#----#----#----#----#----#----#----#----#----#----#----#----#----#----#---
---##---##---##---##---##---##---##---##---##---##---##---##---##---##---##---##---##---##---##---##
----------------------------------------------------------------------------------------------------
#----#----#----#----#----#----#----#----#----#----#----#----#----#----#----#----#----#----#----#----
---##---##---##---##---##---##---##---##-S-##---##---##---##---##---##---##---##---##---##---##---##
-#----#----#----#----#----#----#----#----#----#----#----#----#----#----#----#----#----#----#----#---
---##---##---##---##--E##---##---##---##---##---##---##---##---##---##---##---##---##---##---##---##
----------------------------------------------------------------------------------------------------
#----#----#----#----#----#----#----#----#----#----#----#----#----#----#----#----#----#----#----#----
---##---##---##---##---##---##---##---##---##---##---##---##---##---##---##---##---##---##---##---##
-#----#----#----#----#----#----#----#----#----#----#----#----#----#----#----#----#----#----#----#---
---##---##---##---##---##---##---##---##---##---##---##---##---##---##---##---##---##---##---##---##
----------------------------------------------------------------------------------------------------
#----#----#----#----#----#----#----#----#----#----#----#----#----#----#----#----#----#----#----#----
---##---##---##---##---##---##---##---##---##---##---##---##---##---##---##---##---##---##---##---##
-#----#----#----#----#----#----#----#----#----#----#----#----#----#----#----#----#----#----#----#---
---##---##---##---##---##---##---##---##---##---##---##---##---##---##---##---##---##---##---##---##
----------------------------------------------------------------------------------------------------
#----#----#----#----#----#----#----#----#----#----#----#----#----#----#----#----#----#----#----#----
---##---##---##---##---##---##---##---##---##---##---##---##---##---##---##---##---##---##---##---##