?diagonal=Always;
----------------------------------------------------------------------------------------------------
##---##---##---##---##---##---##---##---##---##---##---##---##---##---##---##---##---##---##---##---
-#----#----#----#----#----#----#----#----#----#----#----#----#----#----#----#----#----#----#----#---
---#----#----#----#----#----#----#----#----#----#----#----#----#----#----#----#----#----#----#----#-
##-#-##-#-##-#-##-#-##-#-##-#-##-#-##-#-##-#-##-#-##-#-##-#-##-#-##-#-##-#-##-#-##-#-##-#-##-#-##-#-
----------------------------------------------------------------------------------------------------
##---##---##---##---##---##---##---##---##---##---##---##---##---##---##---##---##---##---##---##---
-#----#----#----#----#----#----#----#----#----#----#----#----#----#----#----#----#----#----#----#---
---#----#----#----#----#----#----#----#----#----#----#----#----#----#----#----#----#----#----#----#-
##-#-##-#-##-#-##-#-##-#-##-#-##-#-##-#-##-#-##-#-##-#-##-#-##-#-##-#-##-#-##-#-##-#-##-#-##-#-##-#-
----------------------------------------------------------------------------------------------------
##---##---##---##---##---##---##---##---##---##---##---##---##---##---##---##---##---##---##---##---
-#----#----#----#----#----#----#----#----#----#----#----#----#----#----#----#----#----#----#----#---
---#----#----#----#----#----#----#----#----#----#----#----#----#----#----#----#----#----#----#----#-
##-#-##-#-##-#-##-#-##-#-##-#-##-#-##-#-##-#-##-#-##-#-##-#-##-#-##-#-##-#-##-#-##-#-##-#-##-#-##-#-
----------------------------------------------------------------------------------------------------
##---##---##---##---##---##---##---##---##---##---##---##---##---##---##---##---##---##---##---##---
-#----#----#----#----#----#----#----#----#----#----#----#----#----#----#----#----#----#----#----#---
---#----#----#----#----#----#----#----#----#----#----#----#----#----#----#----#----#----#----#----#-
##-#-##-#-##-#-##-#-##-#-##-#-##-#-##-#-##-#-##-#-##-#-##-#-##-#-##-#-##-#-##-#-##-#-##-#-##-#-##-#-
----------------------------------------------------------------------------------------------------
##---##---##---##---##---##---##---##---##---##---##---##---##---##---##---##---##---##---##---##---
-#----#----#----#----#----#----#----#----#----#----#----#----#----#----#----#----#----#----#----#---
---#----#----#----#----#----#----#----#----#----#----#----#----#----#----#----#----#----#----#----#-
##-#-##-#-##-#-##-#-##-#-##-#-##-#-##-#-##-#-##-#-##-#-##-#-##-#-##-#-##-#-##-#-##-#-##-#-##-#-##-#-
----------------------------------------------------------------------------------------------------
##---##---##---##---##---##---##---##---##---##---##---##---##---##---##---##---##---##---##---##---
-#----#----#----#----#----#----#----#----#----#----#----#----#----#----#----#----#----#----#----#---
---#----#----#----#----#----#----#----#----#----#----#----#----#----#----#----#----#----#----#----#-
##-#-##-#-##-#-##-#-##-#-##-#-##-#-##-#-##-#-##-#-##-#-##-#-##-#-##-#-##-#-##-#-##-#-##-#-##-#-##-#-
----------------------------------------------------------------------------------------------------
##---##---##---##---##---##---##---##---##---##---##---##---##---##---##---##---##---##---##---##---
-#----#----#----#----#----#----#----#----#----#----#----#----#----#----#----#----#----#----#----#---
---#----#----#----#----#----#----#----#----#----#----#----#----#----#----#----#----#----#----#----#-
##-#-##-#-##-#-##-#-##-#-##-#-##-#-##-#-##-#-##-#-##-#-##-#-##-#-##-#-##-#-##-#-##-#-##-#-##-#-##-#-
----------------------------------------------------------------------------------------------------
##---##---##---##---##---##---##---##---##---##---##---##---##---##---##---##---##---##---##---##---
-#----#----#----#----#----#----#----#----#----#----#----#----#----#----#----#----#----#----#----#---
---#----#----#----#----#----#----#----#----#----#----#----#----#----#----#----#----#----#----#----#-
##-#-##-#-##-#-##-#-##-#-##-#-##-#-##-#-##-#-##-#-##-#-##-#-##-#-##-#-##-#-##-#-##-#-##-#-##-#-##-#-
----------------------------------------------------------------------------------------------------
##---##---##---##---##---##---##---##---##---##---##---##---##---##---##---##---##---##---##---##---
-#----#----#----#----#----#----#----#----#----#----#----#----#----#----#----#----#----#----#----#---
---#----#----#----#----#----#----#----#----#----#----#----#----#----#----#----#----#----#----#----#-
##-#-##-#-##-#-##-#-##-#-##-#-##-#-##-#-##-#-##-#-##-#-##-#-##-#-##-#-##-#-##-#-##-#-##-#-##-#-##-#-
----------------------------------------------------------------------------------------------------
##---##---##---##---##---##---##---##---##---##---##---##---##---##---##---##---##---##---##---##---
-#----#----#----#----#----#----#----#----#----#----#----#----#----#----#----#----#----#----#----#---
---#----#----#----#----#----#----#----#----#----#----#----#----#----#----#----#----#----#----#----#-
##-#-##-#-##-#-##-#-##-#-##-#-##-#-##-#-##-#-##-#-##-#-##-#-##-#-##-#-##-#-##-#-##-#-##-#-##-#-##-#-
----------------------------------------------------------------------------------------------------
##---##---##---##---##---##---##---##---##---##---##---##---##---##---##---##---##---##---##---##---
-#----#----#----#----#----#----#----#----#----#----#----#----#----#----#----#----#----#----#----#---
---#----#----#----#----#----#----#----#----#----#----#----#----#----#----#----#----#----#----#----#-
##-#-##-#-##-#-##-#-##-#-##-#-##-#-##-#-##-#-##-#-##-#-##-#-##-#-##-#-##-#-##-#-##-#-##-#-##-#-##-#-
----------------------------------------------------------------------------------------------------
##---##---##---##---##---##---##---##---##---##---##---##---##---##---##---##---##---##---##---##---
-#----#----#----#----#----#----#----#----#----#----#----#----#----#----#----#----#----#----#----#---
---#----#----#----#----#----#----#----#----#----#----#----#----#----#----#----#----#----#----#----#-
##-#-##-#-##-#-##-#-##-#-##-#-##-#-##-#-##-#-##-#-##-#-##-#-##-#-##-#-##-#-##-#-##-#-##-#-##-#-##-#-
----------------------------------------------------------------------------------------------------
##---##---##---##---##---##---##---##---##---##---##---##---##---##---##---##---##---##---##---##---
-#----#----#----#----#----#----#----#----#----#----#----#----#----#----#----#----#----#----#----#---
---#----#----#----#----#----#----#----#----#----#----#----#----#----#----#----#----#----#----#----#-
##-#-##-#-##-#-##-#-##-#-##-#-##-#-##-#-##-#-##-#-##-#-##-#-##-#-##-#-##-#-##-#-##-#-##-#-##-#-##-#-
----------------------------------------------------------------------------------------------------
##---##---##---##---##---##---##---##---##---##---##---##---##---##---##---##---##S--##---##---##---
-#----#----#----#----#----#----#----#----#----#----#----#----#----#----#----#----#----#----#----#---
---#----#----#----#----#----#----#----#----#----#----#----#----#----#----#----#----#----#----#----#-
##-#-##-#-##-#-##-#-##-#-##-#-##-#-##-#-##-#-##-#-##-#-##-#-##-#-##-#-##-#-##-#-##-#-##-#-##-#-##-#-
----------------------------------------------------------------------------------------------------
##---##---##---##---##---##---##---##---##---##---##---##---##---##---##---##---##---##---##---##---
-#----#----#----#----#----#----#----#----#----#----#----#----#----#----#----#----#----#----#----#---
---#----#----#----#----#----#----#----#----#----#----#----#----#----#----#----#----#----#----#----#-
##-#-##-#-##-#-##-#-##-#-##-#-##-#-##-#-##-#-##-#-##-#-##-#-##-#-##-#-##-#-##-#-##-#-##-#-##-#-##-#-
----------------------------------------------------------------------------------------------------
##---##---##---##---##---##---##---##---##---##---##---##---##---##---##---##---##---##---##---##---
-#----#----#----#----#----#----#----#----#----#----#----#----#----#----#----#----#----#----#----#---
---#----#----#----#----#----#----#----#----#----#----#----#----#----#----#----#----#----#----#----#-
##-#-##-#-##-#-##-#-##-#-##-#-##-#-##-#-##-#-##-#-##-#-##-#-##-#-##-#-##-#-##-#-##-#-##-#-##-#-##-#-
----------------------------------------------------------------------------------------------------
##---##---##---##---##---##---##---##---##---##---##---##---##---##---##---##---##---##---##---##---
-#----#----#----#----#----#----#----#----#----#----#----#----#----#----#----#----#----#----#----#---
---#----#----#----#----#----#----#----#----#----#----#----#----#----#----#----#----#----#----#----#-
##-#-##-#-##-#-##-#-##-#-##-#-##-#-##-#-##-#-##-#-##-#-##-#-##-#-##-#-##-#-##-#-##-#-##-#-##-#-##-#-
----------------------------------------------------------------------------------------------------
##---##---##---##---##---##---##---##---##---##---##---##---##---##---##---##---##---##---##---##---
-#----#----#----#----#----#----#----#----#----#----#----#----#----#----#----#----#----#----#----#---
---#----#----#----#----#----#----#----#----#----#----#----#----#----#----#----#----#----#----#----#-
##-#-##-#-##-#-##-#-##-#-##-#-##-#-##-#-##-#-##-#-##-#-##-#-##-#-##-#-##-#-##-#-##-#-##-#-##-#-##-#-
----------------------------------------------------------------------------------------------------
##---##---##---##---##---##---##---##---##---##---##---##---##---##---##---##---##---##---##---##---
-#----#----#----#----#----#----#----#----#----#----#----#----#----#----#----#----#----#----#----#---
---#----#----#----#----#----#----#----#----#----#----#----#----#----#----#----#----#----#----#----#-
##-#-##-#-##-#-##-#-##-#-##-#-##-#-##-#-##-#-##-#-##-#-##-#-##-#-##-#-##-#-##-#-##-#-##-#-##-#-##-#-
----------------------------------------------------------------------------------------------------
##---##---##---##---##---##---##---##---##---##---##---##---##---##---##---##---##---##E--##---##---
-#----#----#----#----#----#----#----#----#----#----#----#----#----#----#----#----#----#----#----#---
---#----#----#----#----#----#----#----#----#----#----#----#----#----#----#----#----#----#----#----#-
##-#-##-#-##-#-##-#-##-#-##-#-##-#-##-#-##-#-##-#-##-#-##-#-##-#-##-#-##-#-##-#-##-#-##-#-##-#-##-#-