?diagonal=Always;
---##---##---##---##---##---##---##---##---##---##---##---##---##---##---##---##---##---##---##---##
-##---##---##---##---##---##---##---##---##---##---##---##---##---##---##---##---##---##---##---##--
---#----#----#----#----#----#----#----#----#----#----#----#----#----#----#----#----#----#----#----#-
#----#----#----#----#----#----#----#----#----#----#----#----#----#----#----#----#----#----#----#----
---#----#----#----#----#----#----#----#----#----#----#----#----#----#----#----#----#----#----#----#-
---##---##---##---##---##---##---##---##---##---##---##---##---##---##---##---##---##---##---##---##
-##---##---##---##---##---##---##---##---##---##---##---##---##---##---##---##---##---##---##---##--
---#----#----#----#----#----#----#----#----#----#----#----#----#----#----#----#----#----#----#----#-
#----#----#----#----#----#----#----#----#----#----#----#----#----#----#-E--#----#----#----#----#----
---#----#----#----#----#----#----#----#----#----#----#----#----#----#----#----#----#----#----#----#-
---##---##---##---##---##---##---##---##---##---##---##---##---##---##---##---##---##---##---##---##
-##---##---##---##---##---##---##---##---##---##---##---##---##---##---##---##---##---##---##---##--
---#----#----#----#----#----#----#----#----#----#----#----#----#----#----#----#----#----#----#----#-
#----#----#----#----#----#----#----#----#----#----#----#----#----#----#----#----#----#----#----#----
---#----#----#----#----#----#----#----#----#----#----#----#----#----#----#----#----#----#----#----#-
---##---##---##---##---##---##---##---##---##---##---##---##---##---##---##---##---##---##---##---##
-##---##---##---##---##---##---##---##---##---##---##---##---##---##---##---##---##---##---##---##--
---#----#----#----#----#----#----#----#----#----#----#----#----#----#----#----#----#----#----#----#-
#----#----#----#----#----#----#----#----#----#----#----#----#----#----#----#----#----#----#----#----
---#----#----#----#----#----#----#----#----#----#----#----#----#----#----#----#----#----#----#----#-
---##---##---##---##---##---##---##---##---##---##---##---##---##---##---##---##---##---##---##---##
-##---##---##---##---##---##---##---##---##---##---##---##---##---##---##---##---##---##---##---##--
---#----#----#----#----#----#----#----#----#----#----#----#----#----#----#----#----#----#----#----#-
#----#----#----#----#----#----#----#----#----#----#----#----#----#----#----#----#----#----#----#----
---#----#----#----#----#----#----#----#----#----#----#----#----#----#----#----#----#----#----#----#-
---##---##---##---##---##---##---##---##---##---##---##---##---##---##---##---##---##---##---##---##
-##---##---##---##---##---##---##---##---##---##---##---##---##---##---##---##---##---##---##---##--
---#----#----#----#----#----#----#----#----#----#----#----#----#----#----#----#----#----#----#----#-
#----#----#----#----#----#----#----#----#----#----#----#----#----#----#----#----#----#----#----#----
---#----#----#----#----#----#----#----#----#----#----#----#----#----#----#----#----#----#----#----#-
---##---##---##---##---##---##---##---##---##---##---##---##---##---##---##---##---##---##---##---##
-##---##---##---##---##---##---##---##---##---##---##---##---##---##---##---##---##---##---##---##--
---#----#----#----#----#----#----#----#----#----#----#----#----#----#----#----#----#----#----#----#-
#----#----#----#----#----#----#----#----#----#----#----#----#----#----#----#----#----#----#----#----
---#----#----#----#----#----#----#----#----#----#----#----#----#----#----#----#----#S---#----#----#-
---##---##---##---##---##---##---##---##---##---##---##---##---##---##---##---##---##---##---##---##
-##---##---##---##---##---##---##---##---##---##---##---##---##---##---##---##---##---##---##---##--
---#----#----#----#----#----#----#----#----#----#----#----#----#----#----#----#----#----#----#----#-
#----#----#----#----#----#----#----#----#----#----#----#----#----#----#----#----#----#----#----#----
---#----#----#----#----#----#----#----#----#----#----#----#----#----#----#----#----#----#----#----#-
---##---##---##---##---##---##---##---##---##---##---##---##---##---##---##---##---##---##---##---##
-##---##---##---##---##---##---##---##---##---##---##---##---##---##---##---##---##---##---##---##--
---#----#----#----#----#----#----#----#----#----#----#----#----#----#----#----#----#----#----#----#-
#----#----#----#----#----#----#----#----#----#----#----#----#----#----#----#----#----#----#----#----
---#----#----#----#----#----#----#----#----#----#----#----#----#----#----#----#----#----#----#----#-
---##---##---##---##---##---##---##---##---##---##---##---##---##---##---##---##---##---##---##---##
-##---##---##---##---##---##---##---##---##---##---##---##---##---##---##---##---##---##---##---##--
---#----#----#----#----#----#----#----#----#----#----#----#----#----#----#----#----#----#----#----#-
#----#----#----#----#----#----#----#----#----#----#----#----#----#----#----#----#----#----#----#----
---#----#----#----#----#----#----#----#----#----#----#----#----#----#----#----#----#----#----#----#-
---##---##---##---##---##---##---##---##---##---##---##---##---##---##---##---##---##---##---##---##
-##---##---##---##---##---##---##---##---##---##---##---##---##---##---##---##---##---##---##---##--
---#----#----#----#----#----#----#----#----#----#----#----#----#----#----#----#----#----#----#----#-
#----#----#----#----#----#----#----#----#----#----#----#----#----#----#----#----#----#----#----#----
---#----#----#----#----#----#----#----#----#----#----#----#----#----#----#----#----#----#----#----#-
---##---##---##---##---##---##---##---##---##---##---##---##---##---##---##---##---##---##---##---##
-##---##---##---##---##---##---##---##---##---##---##---##---##---##---##---##---##---##---##---##--
---#----#----#----#----#----#----#----#----#----#----#----#----#----#----#----#----#----#----#----#-
#----#----#----#----#----#----#----#----#----#----#----#----#----#----#----#----#----#----#----#----
---#----#----#----#----#----#----#----#----#----#----#----#----#----#----#----#----#----#----#----#-
---##---##---##---##---##---##---##---##---##---##---##---##---##---##---##---##---##---##---##---##
-##---##---##---##---##---##---##---##---##---##---##---##---##---##---##---##---##---##---##---##--
---#----#----#----#----#----#----#----#----#----#----#----#----#----#----#----#----#----#----#----#-
#----#----#----#----#----#----#----#----#----#----#----#----#----#----#----#----#----#----#----#----
---#----#----#----#----#----#----#----#----#----#----#----#----#----#----#----#----#----#----#----#-
---##---##---##---##---##---##---##---##---##---##---##---##---##---##---##---##---##---##---##---##
-##---##---##---##---##---##---##---##---##---##---##---##---##---##---##---##---##---##---##---##--
---#----#----#----#----#----#----#----#----#----#----#----#----#----#----#----#----#----#----#----#-
#----#----#----#----#----#----#----#----#----#----#----#----#----#----#----#----#----#----#----#----
---#----#----#----#----#----#----#----#----#----#----#----#----#----#----#----#----#----#----#----#-
---##---##---##---##---##---##---##---##---##---##---##---##---##---##---##---##---##---##---##---##
-##---##---##---##---##---##---##---##---##---##---##---##---##---##---##---##---##---##---##---##--
---#----#----#----#----#----#----#----#----#----#----#----#----#----#----#----#----#----#----#----#-
#----#----#----#----#----#----#----#----#----#----#----#----#----#----#----#----#----#----#----#----
---#----#----#----#----#----#----#----#----#----#----#----#----#----#----#----#----#----#----#----#-
---##---##---##---##---##---##---##---##---##---##---##---##---##---##---##---##---##---##---##---##
-##---##---##---##---##---##---##---##---##---##---##---##---##---##---##---##---##---##---##---##--
---#----#----#----#----#----#----#----#----#----#----#----#----#----#----#----#----#----#----#----#-
#----#----#----#----#----#----#----#----#----#----#----#----#----#----#----#----#----#----#----#----
---#----#----#----#----#----#----#----#----#----#----#----#----#----#----#----#----#----#----#----#-
---##---##---##---##---##---##---##---##---##---##---##---##---##---##---##---##---##---##---##---##
-##---##---##---##---##---##---##---##---##---##---##---##---##---##---##---##---##---##---##---##--
---#----#----#----#----#----#----#----#----#----#----#----#----#----#----#----#----#----#----#----#-
#----#----#----#----#----#----#----#----#----#----#----#----#----#----#----#----#----#----#----#----
---#----#----#----#----#----#----#----#----#----#----#----#----#----#----#----#----#----#----#----#-
---##---##---##---##---##---##---##---##---##---##---##---##---##---##---##---##---##---##---##---##
-##---##---##---##---##---##---##---##---##---##---##---##---##---##---##---##---##---##---##---##--
---#----#----#----#----#----#----#----#----#----#----#----#----#----#----#----#----#----#----#----#-
#----#----#----#----#----#----#----#----#----#----#----#----#----#----#----#----#----#----#----#----
---#----#----#----#----#----#----#----#----#----#----#----#----#----#----#----#----#----#----#----#-
---##---##---##---##---##---##---##---##---##---##---##---##---##---##---##---##---##---##---##---##
-##---##---##---##---##---##---##---##---##---##---##---##---##---##---##---##---##---##---##---##--
---#----#----#----#----#----#----#----#----#----#----#----#----#----#----#----#----#----#----#----#-
#----#----#----#----#----#----#----#----#----#----#----#----#----#----#----#----#----#----#----#----
---#----#----#----#----#----#----#----#----#----#----#----#----#----#----#----#----#----#----#----#-
---##---##---##---##---##---##---##---##---##---##---##---##---##---##---##---##---##---##---##---##
-##---##---##---##---##---##---##---##---##---##---##---##---##---##---##---##---##---##---##---##--
---#----#----#----#----#----#----#----#----#----#----#----#----#----#----#----#----#----#----#----#-
#----#----#----#----#----#----#----#----#----#----#----#----#----#----#----#----#----#----#----#----
---#----#----#----#----#----#----#----#----#----#----#----#----#----#----#----#----#----#----#----#-