?diagonal=Always;
----------------------------------------------------------------------------------------------------
-##-#-##-#-##-#-##-#-##-#-##-#-##-#-##-#-##-#-##-#-##-#-##-#-##-#-##-#-##-#-##-#-##-#-##-#-##-#-##-#
---#----#----#----#----#----#----#----#----#----#----#----#----#----#----#----#----#----#----#----#-
--#----#----#----#----#----#----#----#----#----#----#----#----#----#----#----#----#----#----#----#--
-#--#-#--#-#--#-#--#-#--#-#--#-#--#-#--#-#--#-#--#-#--#-#--#-#--#-#--#-#--#-#--#-#--#-#--#-#--#-#--#
------------------------------------------------E---------------------------------------------------
-##-#-##-#-##-#-##-#-##-#-##-#-##-#-##-#-##-#-##-#-##-#-##-#-##-#-##-#-##-#-##-#-##-#-##-#-##-#-##-#
---#----#----#----#----#----#----#----#----#----#----#----#----#----#----#----#----#----#----#----#-
--#----#----#----#----#----#----#----#----#----#----#----#----#----#----#----#----#----#----#----#--
-#--#-#--#-#--#-#--#-#--#-#--#-#--#-#--#-#--#-#--#-#--#-#--#-#--#-#--#-#--#-#--#-#--#-#--#-#--#-#--#
----------------------------------------------------------------------------------------------------
-##-#-##-#-##-#-##-#-##-#-##-#-##-#-##-#-##-#-##-#-##-#-##-#-##-#-##-#-##-#-##-#-##-#-##-#-##-#-##-#
---#----#----#----#----#----#----#----#----#----#----#----#----#----#----#----#----#----#----#----#-
--#----#----#----#----#----#----#----#----#----#----#----#----#----#----#----#----#----#----#----#--
-#--#-#--#-#--#-#--#-#--#-#--#-#--#-#--#-#--#-#--#-#--#-#--#-#--#-#--#-#--#-#--#-#--#-#--#-#--#-#--#
----------------------------------------------------------------------------------------------------
-##-#-##-#-##-#-##-#-##-#-##-#-##-#-##-#-##-#-##-#-##-#-##-#-##-#-##-#-##-#-##-#-##-#-##-#-##-#-##-#
---#----#----#----#----#----#----#----#----#----#----#----#----#----#----#----#----#----#----#----#-
--#----#----#----#----#----#----#----#----#----#----#----#----#----#----#----#----#----#----#----#--
-#--#-#--#-#--#-#--#-#--#-#--#-#--#-#--#-#--#-#--#-#--#-#--#-#--#-#--#-#--#-#--#-#--#-#--#-#--#-#--#
----------------------------------------------------------------------------------------------------
-##-#-##-#-##-#-##-#-##-#-##-#-##-#-##-#-##-#-##-#-##-#-##-#-##-#-##-#-##-#-##-#-##-#-##-#-##-#-##-#
---#----#----#----#----#----#----#----#----#----#----#----#----#----#----#----#----#----#----#----#-
--#----#----#----#----#----#----#----#----#----#----#----#----#----#----#----#----#----#----#----#--
-#--#-#--#-#--#-#--#-#--#-#--#-#--#-#--#-#--#-#--#-#--#-#--#-#--#-#--#-#--#-#--#-#--#-#--#-#--#-#--#
----------------------------------------------------------------------------------------------------
-##-#-##-#-##-#-##-#-##-#-##-#-##-#-##-#-##-#-##-#-##-#-##-#-##-#-##-#-##-#-##-#-##-#-##-#-##-#-##-#
---#----#----#----#----#----#----#----#----#----#----#----#----#----#----#----#----#----#----#----#-
--#----#----#----#----#----#----#----#----#----#----#----#----#----#----#----#----#----#----#----#--
-#--#-#--#-#--#-#--#-#--#-#--#-#--#-#--#-#--#-#--#-#--#-#--#-#--#-#--#-#--#-#--#-#--#-#--#-#--#-#--#
----------------------------------------------------------------------------------------------------
-##-#-##-#-##-#-##-#-##-#-##-#-##-#-##-#-##-#-##-#-##-#-##-#-##-#-##-#-##-#-##-#-##-#-##-#-##-#-##-#
---#----#----#----#----#----#----#----#----#----#----#----#----#----#----#----#----#----#----#----#-
--#----#----#----#----#----#----#----#----#----#----#----#----#----#----#----#----#----#----#-S--#--
-#--#-#--#-#--#-#--#-#--#-#--#-#--#-#--#-#--#-#--#-#--#-#--#-#--#-#--#-#--#-#--#-#--#-#--#-#--#-#--#
----------------------------------------------------------------------------------------------------
-##-#-##-#-##-#-##-#-##-#-##-#-##-#-##-#-##-#-##-#-##-#-##-#-##-#-##-#-##-#-##-#-##-#-##-#-##-#-##-#
---#----#----#----#----#----#----#----#----#----#----#----#----#----#----#----#----#----#----#----#-
--#----#----#----#----#----#----#----#----#----#----#----#----#----#----#----#----#----#----#----#--
-#--#-#--#-#--#-#--#-#--#-#--#-#--#-#--#-#--#-#--#-#--#-#--#-#--#-#--#-#--#-#--#-#--#-#--#-#--#-#--#
----------------------------------------------------------------------------------------------------
-##-#-##-#-##-#-##-#-##-#-##-#-##-#-##-#-##-#-##-#-##-#-##-#-##-#-##-#-##-#-##-#-##-#-##-#-##-#-##-#
---#----#----#----#----#----#----#----#----#----#----#----#----#----#----#----#----#----#----#----#-
--#----#----#----#----#----#----#----#----#----#----#----#----#----#----#----#----#----#----#----#--
-#--#-#--#-#--#-#--#-#--#-#--#-#--#-#--#-#--#-#--#-#--#-#--#-#--#-#--#-#--#-#--#-#--#-#--#-#--#-#--#
----------------------------------------------------------------------------------------------------
-##-#-##-#-##-#-##-#-##-#-##-#-##-#-##-#-##-#-##-#-##-#-##-#-##-#-##-#-##-#-##-#-##-#-##-#-##-#-##-#
---#----#----#----#----#----#----#----#----#----#----#----#----#----#----#----#----#----#----#----#-
--#----#----#----#----#----#----#----#----#----#----#----#----#----#----#----#----#----#----#----#--
-#--#-#--#-#--#-#--#-#--#-#--#-#--#-#--#-#--#-#--#-#--#-#--#-#--#-#--#-#--#-#--#-#--#-#--#-#--#-#--#
----------------------------------------------------------------------------------------------------
-##-#-##-#-##-#-##-#-##-#-##-#-##-#-##-#-##-#-##-#-##-#-##-#-##-#-##-#-##-#-##-#-##-#-##-#-##-#-##-#
---#----#----#----#----#----#----#----#----#----#----#----#----#----#----#----#----#----#----#----#-
--#----#----#----#----#----#----#----#----#----#----#----#----#----#----#----#----#----#----#----#--
-#--#-#--#-#--#-#--#-#--#-#--#-#--#-#--#-#--#-#--#-#--#-#--#-#--#-#--#-#--#-#--#-#--#-#--#-#--#-#--#
----------------------------------------------------------------------------------------------------
-##-#-##-#-##-#-##-#-##-#-##-#-##-#-##-#-##-#-##-#-##-#-##-#-##-#-##-#-##-#-##-#-##-#-##-#-##-#-##-#
---#----#----#----#----#----#----#----#----#----#----#----#----#----#----#----#----#----#----#----#-
--#----#----#----#----#----#----#----#----#----#----#----#----#----#----#----#----#----#----#----#--
-#--#-#--#-#--#-#--#-#--#-#--#-#--#-#--#-#--#-#--#-#--#-#--#-#--#-#--#-#--#-#--#-#--#-#--#-#--#-#--#
----------------------------------------------------------------------------------------------------
-##-#-##-#-##-#-##-#-##-#-##-#-##-#-##-#-##-#-##-#-##-#-##-#-##-#-##-#-##-#-##-#-##-#-##-#-##-#-##-#
---#----#----#----#----#----#----#----#----#----#----#----#----#----#----#----#----#----#----#----#-
--#----#----#----#----#----#----#----#----#----#----#----#----#----#----#----#----#----#----#----#--
-#--#-#--#-#--#-#--#-#--#-#--#-#--#-#--#-#--#-#--#-#--#-#--#-#--#-#--#-#--#-#--#-#--#-#--#-#--#-#--#
----------------------------------------------------------------------------------------------------
-##-#-##-#-##-#-##-#-##-#-##-#-##-#-##-#-##-#-##-#-##-#-##-#-##-#-##-#-##-#-##-#-##-#-##-#-##-#-##-#
---#----#----#----#----#----#----#----#----#----#----#----#----#----#----#----#----#----#----#----#-
--#----#----#----#----#----#----#----#----#----#----#----#----#----#----#----#----#----#----#----#--
-#--#-#--#-#--#-#--#-#--#-#--#-#--#-#--#-#--#-#--#-#--#-#--#-#--#-#--#-#--#-#--#-#--#-#--#-#--#-#--#
----------------------------------------------------------------------------------------------------
-##-#-##-#-##-#-##-#-##-#-##-#-##-#-##-#-##-#-##-#-##-#-##-#-##-#-##-#-##-#-##-#-##-#-##-#-##-#-##-#
---#----#----#----#----#----#----#----#----#----#----#----#----#----#----#----#----#----#----#----#-
--#----#----#----#----#----#----#----#----#----#----#----#----#----#----#----#----#----#----#----#--
-#--#-#--#-#--#-#--#-#--#-#--#-#--#-#--#-#--#-#--#-#--#-#--#-#--#-#--#-#--#-#--#-#--#-#--#-#--#-#--#
----------------------------------------------------------------------------------------------------
-##-#-##-#-##-#-##-#-##-#-##-#-##-#-##-#-##-#-##-#-##-#-##-#-##-#-##-#-##-#-##-#-##-#-##-#-##-#-##-#
---#----#----#----#----#----#----#----#----#----#----#----#----#----#----#----#----#----#----#----#-
--#----#----#----#----#----#----#----#----#----#----#----#----#----#----#----#----#----#----#----#--
-#--#-#--#-#--#-#--#-#--#-#--#-#--#-#--#-#--#-#--#-#--#-#--#-#--#-#--#-#--#-#--#-#--#-#--#-#--#-#--#
----------------------------------------------------------------------------------------------------
-##-#-##-#-##-#-##-#-##-#-##-#-##-#-##-#-##-#-##-#-##-#-##-#-##-#-##-#-##-#-##-#-##-#-##-#-##-#-##-#
---#----#----#----#----#----#----#----#----#----#----#----#----#----#----#----#----#----#----#----#-
--#----#----#----#----#----#----#----#----#----#----#----#----#----#----#----#----#----#----#----#--
-#--#-#--#-#--#-#--#-#--#-#--#-#--#-#--#-#--#-#--#-#--#-#--#-#--#-#--#-#--#-#--#-#--#-#--#-#--#-#--#
----------------------------------------------------------------------------------------------------
-##-#-##-#-##-#-##-#-##-#-##-#-##-#-##-#-##-#-##-#-##-#-##-#-##-#-##-#-##-#-##-#-##-#-##-#-##-#-##-#
---#----#----#----#----#----#----#----#----#----#----#----#----#----#----#----#----#----#----#----#-
--#----#----#----#----#----#----#----#----#----#----#----#----#----#----#----#----#----#----#----#--
-#--#-#--#-#--#-#--#-#--#-#--#-#--#-#--#-#--#-#--#-#--#-#--#-#--#-#--#-#--#-#--#-#--#-#--#-#--#-#--#
----------------------------------------------------------------------------------------------------
-##-#-##-#-##-#-##-#-##-#-##-#-##-#-##-#-##-#-##-#-##-#-##-#-##-#-##-#-##-#-##-#-##-#-##-#-##-#-##-#
---#----#----#----#----#----#----#----#----#----#----#----#----#----#----#----#----#----#----#----#-
--#----#----#----#----#----#----#----#----#----#----#----#----#----#----#----#----#----#----#----#--
-#--#-#--#-#--#-#--#-#--#-#--#-#--#-#--#-#--#-#--#-#--#-#--#-#--#-#--#-#--#-#--#-#--#-#--#-#--#-#--#
----------------------------------------------------------------------------------------------------
-##-#-##-#-##-#-##-#-##-#-##-#-##-#-##-#-##-#-##-#-##-#-##-#-##-#-##-#-##-#-##-#-##-#-##-#-##-#-##-#
---#----#----#----#----#----#----#----#----#----#----#----#----#----#----#----#----#----#----#----#-
--#----#----#----#----#----#----#----#----#----#----#----#----#----#----#----#----#----#----#----#--
-#--#-#--#-#--#-#--#-#--#-#--#-#--#-#--#-#--#-#--#-#--#-#--#-#--#-#--#-#--#-#--#-#--#-#--#-#--#-#--#