?diagonal=Always;
#-#--#-#--#-#--#-#--#-#--#-#--#-#--#-#--#-#--#-#--#-#--#-#--#-#--#-#--#-#--#-#--#-#--#-#--#-#--#-#--
----------------------------------------------------------------------------------------------------
#----#----#----#----#----#----#----#----#----#----#----#----#----#----#----#----#----#----#----#----
##---##---##---##---##---##---##---##---##---##---##---##---##---##---##---##---##---##---##---##---
---#----#----#----#----#----#----#----#----#----#----#----#----#----#----#----#----#----#----#----#-
#-#--#-#--#-#--#-#--#-#--#-#--#-#--#-#--#-#--#-#--#-#--#-#--#-#--#-#--#-#--#-#--#-#--#-#--#-#--#-#--
----------------------------------------------------------------------------------------------------
#----#----#----#----#----#----#----#----#----#----#----#----#----#----#----#----#----#----#----#----
##---##---##---##---##---##---##---##---##---##---##---##---##---##---##---##---##---##---##---##---
---#----#----#----#----#----#----#----#----#----#----#----#----#----#----#----#----#----#----#----#-
#-#--#-#--#-#--#-#--#-#--#-#--#-#--#-#--#-#--#-#--#-#--#-#--#-#--#-#--#-#--#-#--#-#--#-#--#-#--#-#--
----------------------------------------------------------------------------------------------------
#----#----#----#----#----#----#----#----#----#----#----#----#----#----#----#----#----#----#----#----
##---##---##---##---##---##---##---##---##---##---##---##---##---##---##---##---##---##---##---##---
---#----#----#----#----#----#----#----#----#----#----#----#----#----#----#----#----#----#----#----#-
#-#--#-#--#-#--#-#--#-#--#-#--#-#--#-#--#-#--#-#--#-#--#-#--#-#--#-#--#-#--#-#--#-#--#-#--#-#--#-#--
----------------------------------------------------------------------------------------------------
#----#----#----#----#----#----#----#----#----#----#----#----#----#----#----#----#----#----#----#----
##---##---##---##---##---##---##---##---##---##---##---##---##---##---##---##---##---##---##---##---
---#----#----#----#----#----#----#----#----#----#----#----#----#----#----#----#----#----#----#---E#-
#-#--#-#--#-#--#-#--#-#--#-#--#-#--#-#--#-#--#-#--#-#--#-#--#-#--#-#--#-#--#-#--#-#--#-#--#-#--#-#--
----------------------------------------------------------------------------------------------------
#----#----#----#----#----#----#----#----#----#----#----#----#----#----#----#----#----#----#----#----
##---##---##---##---##---##---##---##---##---##---##---##---##---##---##---##---##---##---##---##---
---#----#----#----#----#----#----#----#----#----#----#----#----#----#----#----#----#----#----#----#-
#-#--#-#--#-#--#-#--#-#--#-#--#-#--#-#--#-#--#-#--#-#--#-#--#-#--#-#--#-#--#-#--#-#--#-#--#-#--#-#--
----------------------------------------------------------------------------------------------------
#----#----#----#----#----#----#----#----#----#----#----#----#----#----#----#----#----#----#----#----
##---##---##---##---##---##---##---##---##---##---##---##---##---##---##---##---##---##---##---##---
---#----#----#----#----#----#----#----#----#----#----#----#----#----#----#----#----#----#----#----#-
#-#--#-#--#-#--#-#--#-#--#-#--#-#--#-#--#-#--#-#--#-#--#-#--#-#--#-#--#-#--#-#--#-#--#-#--#-#--#-#--
----------------------------------------------------------------------------------------------------
#----#----#----#----#----#----#----#----#----#-S--#----#----#----#----#----#----#----#----#----#----
##---##---##---##---##---##---##---##---##---##---##---##---##---##---##---##---##---##---##---##---
---#----#----#----#----#----#----#----#----#----#----#----#----#----#----#----#----#----#----#----#-
#-#--#-#--#-#--#-#--#-#--#-#--#-#--#-#--#-#--#-#--#-#--#-#--#-#--#-#--#-#--#-#--#-#--#-#--#-#--#-#--
----------------------------------------------------------------------------------------------------
#----#----#----#----#----#----#----#----#----#----#----#----#----#----#----#----#----#----#----#----
##---##---##---##---##---##---##---##---##---##---##---##---##---##---##---##---##---##---##---##---
---#----#----#----#----#----#----#----#----#----#----#----#----#----#----#----#----#----#----#----#-
#-#--#-#--#-#--#-#--#-#--#-#--#-#--#-#--#-#--#-#--#-#--#-#--#-#--#-#--#-#--#-#--#-#--#-#--#-#--#-#--
----------------------------------------------------------------------------------------------------
#----#----#----#----#----#----#----#----#----#----#----#----#----#----#----#----#----#----#----#----
##---##---##---##---##---##---##---##---##---##---##---##---##---##---##---##---##---##---##---##---
---#----#----#----#----#----#----#----#----#----#----#----#----#----#----#----#----#----#----#----#-
#-#--#-#--#-#--#-#--#-#--#-#--#-#--#-#--#-#--#-#--#-#--#-#--#-#--#-#--#-#--#-#--#-#--#-#--#-#--#-#--
----------------------------------------------------------------------------------------------------
#----#----#----#----#----#----#----#----#----#----#----#----#----#----#----#----#----#----#----#----
##---##---##---##---##---##---##---##---##---##---##---##---##---##---##---##---##---##---##---##---
---#----#----#----#----#----#----#----#----#----#----#----#----#----#----#----#----#----#----#----#-
#-#--#-#--#-#--#-#--#-#--#-#--#-#--#-#--#-#--#-#--#-#--#-#--#-#--#-#--#-#--#-#--#-#--#-#--#-#--#-#--
----------------------------------------------------------------------------------------------------
#----#----#----#----#----#----#----#----#----#----#----#----#----#----#----#----#----#----#----#----
##---##---##---##---##---##---##---##---##---##---##---##---##---##---##---##---##---##---##---##---
---#----#----#----#----#----#----#----#----#----#----#----#----#----#----#----#----#----#----#----#-
#-#--#-#--#-#--#-#--#-#--#-#--#-#--#-#--#-#--#-#--#-#--#-#--#-#--#-#--#-#--#-#--#-#--#-#--#-#--#-#--
----------------------------------------------------------------------------------------------------
#----#----#----#----#----#----#----#----#----#----#----#----#----#----#----#----#----#----#----#----
##---##---##---##---##---##---##---##---##---##---##---##---##---##---##---##---##---##---##---##---
---#----#----#----#----#----#----#----#----#----#----#----#----#----#----#----#----#----#----#----#-
#-#--#-#--#-#--#-#--#-#--#-#--#-#--#-#--#-#--#-#--#-#--#-#--#-#--#-#--#-#--#-#--#-#--#-#--#-#--#-#--
----------------------------------------------------------------------------------------------------
#----#----#----#----#----#----#----#----#----#----#----#----#----#----#----#----#----#----#----#----
##---##---##---##---##---##---##---##---##---##---##---##---##---##---##---##---##---##---##---##---
---#----#----#----#----#----#----#----#----#----#----#----#----#----#----#----#----#----#----#----#-
#-#--#-#--#-#--#-#--#-#--#-#--#-#--#-#--#-#--#-#--#-#--#-#--#-#--#-#--#-#--#-#--#-#--#-#--#-#--#-#--
----------------------------------------------------------------------------------------------------
#----#----#----#----#----#----#----#----#----#----#----#----#----#----#----#----#----#----#----#----
##---##---##---##---##---##---##---##---##---##---##---##---##---##---##---##---##---##---##---##---
---#----#----#----#----#----#----#----#----#----#----#----#----#----#----#----#----#----#----#----#-
#-#--#-#--#-#--#-#--#-#--#-#--#-#--#-#--#-#--#-#--#-#--#-#--#-#--#-#--#-#--#-#--#-#--#-#--#-#--#-#--
----------------------------------------------------------------------------------------------------
#----#----#----#----#----#----#----#----#----#----#----#----#----#----#----#----#----#----#----#----
##---##---##---##---##---##---##---##---##---##---##---##---##---##---##---##---##---##---##---##---
---#----#----#----#----#----#----#----#----#----#----#----#----#----#----#----#----#----#----#----#-
#-#--#-#--#-#--#-#--#-#--#-#--#-#--#-#--#-#--#-#--#-#--#-#--#-#--#-#--#-#--#-#--#-#--#-#--#-#--#-#--
----------------------------------------------------------------------------------------------------
#----#----#----#----#----#----#----#----#----#----#----#----#----#----#----#----#----#----#----#----
##---##---##---##---##---##---##---##---##---##---##---##---##---##---##---##---##---##---##---##---
---#----#----#----#----#----#----#----#----#----#----#----#----#----#----#----#----#----#----#----#-
#-#--#-#--#-#--#-#--#-#--#-#--#-#--#-#--#-#--#-#--#-#--#-#--#-#--#-#--#-#--#-#--#-#--#-#--#-#--#-#--
----------------------------------------------------------------------------------------------------
#----#----#----#----#----#----#----#----#----#----#----#----#----#----#----#----#----#----#----#----
##---##---##---##---##---##---##---##---##---##---##---##---##---##---##---##---##---##---##---##---
---#----#----#----#----#----#----#----#----#----#----#----#----#----#----#----#----#----#----#----#-
#-#--#-#--#-#--#-#--#-#--#-#--#-#--#-#--#-#--#-#--#-#--#-#--#-#--#-#--#-#--#-#--#-#--#-#--#-#--#-#--
----------------------------------------------------------------------------------------------------
#----#----#----#----#----#----#----#----#----#----#----#----#----#----#----#----#----#----#----#----
##---##---##---##---##---##---##---##---##---##---##---##---##---##---##---##---##---##---##---##---
---#----#----#----#----#----#----#----#----#----#----#----#----#----#----#----#----#----#----#----#-
#-#--#-#--#-#--#-#--#-#--#-#--#-#--#-#--#-#--#-#--#-#--#-#--#-#--#-#--#-#--#-#--#-#--#-#--#-#--#-#--
----------------------------------------------------------------------------------------------------
#----#----#----#----#----#----#----#----#----#----#----#----#----#----#----#----#----#----#----#----
##---##---##---##---##---##---##---##---##---##---##---##---##---##---##---##---##---##---##---##---
---#----#----#----#----#----#----#----#----#----#----#----#----#----#----#----#----#----#----#----#-
#-#--#-#--#-#--#-#--#-#--#-#--#-#--#-#--#-#--#-#--#-#--#-#--#-#--#-#--#-#--#-#--#-#--#-#--#-#--#-#--
----------------------------------------------------------------------------------------------------
#----#----#----#----#----#----#----#----#----#----#----#----#----#----#----#----#----#----#----#----
##---##---##---##---##---##---##---##---##---##---##---##---##---##---##---##---##---##---##---##---
---#----#----#----#----#----#----#----#----#----#----#----#----#----#----#----#----#----#----#----#-