?diagonal=Always;
----#----#----#----#----#----#----#----#----#----#----#----#----#----#----#----#----#----#----#----#
#---##---##---##---##---##---##---##---##---##---##---##---##---##---##---##---##---##---##---##---#
-#----#----#----#----#----#----#----#----#----#----#----#----#----#----#----#----#----#----#----#---
#----#----#----#----#----#----#----#----#----#----#----#----#----#----#----#----#----#----#----#----
----#----#----#----#----#----#----#----#----#----#----#----#----#----#----#----#----#----#----#----#
----#----#----#----#----#----#----#----#----#----#----#----#----#----#----#----#----#----#----#----#
#---##---##---##---##---##---##---##---##---##---##---##---##---##---##---##---##---##---##---##---#
-#----#----#----#----#----#----#----#----#----#----#----#----#----#----#----#----#----#----#----#---
#----#----#----#----#----#----#----#----#----#----#----#----#----#----#----#----#----#----#----#----
----#----#----#----#----#----#----#----#----#----#----#----#----#----#----#----#----#----#----#----#
----#----#----#----#----#----#----#----#----#----#----#----#----#----#----#----#----#----#----#----#
#---##---##---##---##---##---##---##---##---##---##---##---##---##---##---##---##---##---##---##---#
-#----#----#----#----#----#----#----#----#----#----#----#----#----#----#----#----#----#----#----#---
#----#----#----#----#----#----#----#----#----#----#----#----#----#----#----#----#----#----#----#----
----#----#----#----#----#----#----#----#----#----#----#----#----#----#----#----#----#----#----#----#
----#----#----#----#----#----#----#----#----#----#----#----#----#----#----#----#----#----#----#----#
#---##---##---##---##---##---##---##---##---##---##---##---##---##---##---##---##---##---##---##---#
-#----#----#----#----#----#----#----#----#----#----#----#----#----#----#----#----#----#----#----#---
#----#----#----#----#----#----#----#----#----#----#----#----#----#----#----#----#----#----#----#----
----#----#----#----#----#----#----#----#----#----#----#----#----#----#----#----#----#----#----#----#
----#----#----#----#----#----#----#----#----#----#----#----#----#----#----#----#----#----#----#----#
#---##---##---##---##---##---##---##---##---##---##---##---##---##---##---##---##---##---##---##---#
-#----#----#----#----#----#----#----#----#----#----#----#----#----#----#----#----#----#----#----#---
#----#----#----#----#----#----#----#----#----#----#----#----#----#----#----#----#----#----#----#----
----#----#----#----#----#----#----#----#----#----#----#----#----#----#----#----#----#----#----#----#
----#----#----#----#----#----#----#----#----#----#----#----#----#----#----#----#----#----#----#----#
#---##---##---##---##---##---##---##---##---##---##---##---##---##---##---##---##---##---##---##---#
-#----#----#----#----#----#----#----#----#----#----#----#----#----#----#----#----#----#----#----#---
#----#----#----#----#----#----#----#----#----#----#----#----#----#----#----#----#----#----#----#----
----#----#----#----#----#----#----#----#----#----#----#----#----#----#----#----#----#----#----#----#
----#----#----#----#----#----#----#----#----#----#----#----#----#----#----#----#----#----#----#----#
#---##---##---##---##---##---##---##---##---##---##---##---##---##---##---##---##---##---##---##---#
-#----#-S--#----#----#----#----#----#----#----#----#----#----#----#----#----#----#----#----#----#---
#----#----#----#----#----#----#----#----#----#----#----#----#----#----#----#----#----#----#----#----
----#----#----#----#----#----#----#----#----#----#----#----#----#----#----#----#----#----#----#----#
----#----#----#----#----#----#----#----#----#----#----#----#----#----#----#----#----#----#----#----#
#---##---##---##---##---##---##---##---##---##---##---##---##---##---##---##---##---##---##---##---#
-#----#----#----#----#----#----#----#----#----#----#----#----#----#----#----#----#----#----#----#---
#----#----#----#----#----#----#----#----#----#----#----#----#----#----#----#----#----#----#----#----
----#----#----#----#----#----#----#----#----#----#----#----#----#----#----#----#----#----#----#----#
----#----#----#----#----#----#----#----#----#----#----#----#----#----#----#----#----#----#----#----#
#---##---##---##---##---##---##---##---##---##---##---##---##---##---##---##---##---##---##---##---#
-#----#----#----#----#-E--#----#----#----#----#----#----#----#----#----#----#----#----#----#----#---
#----#----#----#----#----#----#----#----#----#----#----#----#----#----#----#----#----#----#----#----
----#----#----#----#----#----#----#----#----#----#----#----#----#----#----#----#----#----#----#----#
----#----#----#----#----#----#----#----#----#----#----#----#----#----#----#----#----#----#----#----#
#---##---##---##---##---##---##---##---##---##---##---##---##---##---##---##---##---##---##---##---#
-#----#----#----#----#----#----#----#----#----#----#----#----#----#----#----#----#----#----#----#---
#----#----#----#----#----#----#----#----#----#----#----#----#----#----#----#----#----#----#----#----
----#----#----#----#----#----#----#----#----#----#----#----#----#----#----#----#----#----#----#----#
----#----#----#----#----#----#----#----#----#----#----#----#----#----#----#----#----#----#----#----#
#---##---##---##---##---##---##---##---##---##---##---##---##---##---##---##---##---##---##---##---#
-#----#----#----#----#----#----#----#----#----#----#----#----#----#----#----#----#----#----#----#---
#----#----#----#----#----#----#----#----#----#----#----#----#----#----#----#----#----#----#----#----
----#----#----#----#----#----#----#----#----#----#----#----#----#----#----#----#----#----#----#----#
----#----#----#----#----#----#----#----#----#----#----#----#----#----#----#----#----#----#----#----#
#---##---##---##---##---##---##---##---##---##---##---##---##---##---##---##---##---##---##---##---#
-#----#----#----#----#----#----#----#----#----#----#----#----#----#----#----#----#----#----#----#---
#----#----#----#----#----#----#----#----#----#----#----#----#----#----#----#----#----#----#----#----
----#----#----#----#----#----#----#----#----#----#----#----#----#----#----#----#----#----#----#----#
----#----#----#----#----#----#----#----#----#----#----#----#----#----#----#----#----#----#----#----#
#---##---##---##---##---##---##---##---##---##---##---##---##---##---##---##---##---##---##---##---#
-#----#----#----#----#----#----#----#----#----#----#----#----#----#----#----#----#----#----#----#---
#----#----#----#----#----#----#----#----#----#----#----#----#----#----#----#----#----#----#----#----
----#----#----#----#----#----#----#----#----#----#----#----#----#----#----#----#----#----#----#----#
----#----#----#----#----#----#----#----#----#----#----#----#----#----#----#----#----#----#----#----#
#---##---##---##---##---##---##---##---##---##---##---##---##---##---##---##---##---##---##---##---#
-#----#----#----#----#----#----#----#----#----#----#----#----#----#----#----#----#----#----#----#---
#----#----#----#----#----#----#----#----#----#----#----#----#----#----#----#----#----#----#----#----
----#----#----#----#----#----#----#----#----#----#----#----#----#----#----#----#----#----#----#----#
----#----#----#----#----#----#----#----#----#----#----#----#----#----#----#----#----#----#----#----#
#---##---##---##---##---##---##---##---##---##---##---##---##---##---##---##---##---##---##---##---#
-#----#----#----#----#----#----#----#----#----#----#----#----#----#----#----#----#----#----#----#---
#----#----#----#----#----#----#----#----#----#----#----#----#----#----#----#----#----#----#----#----
----#----#----#----#----#----#----#----#----#----#----#----#----#----#----#----#----#----#----#----#
----#----#----#----#----#----#----#----#----#----#----#----#----#----#----#----#----#----#----#----#
#---##---##---##---##---##---##---##---##---##---##---##---##---##---##---##---##---##---##---##---#
-#----#----#----#----#----#----#----#----#----#----#----#----#----#----#----#----#----#----#----#---
#----#----#----#----#----#----#----#----#----#----#----#----#----#----#----#----#----#----#----#----
----#----#----#----#----#----#----#----#----#----#----#----#----#----#----#----#----#----#----#----#
----#----#----#----#----#----#----#----#----#----#----#----#----#----#----#----#----#----#----#----#
#---##---##---##---##---##---##---##---##---##---##---##---##---##---##---##---##---##---##---##---#
-#----#----#----#----#----#----#----#----#----#----#----#----#----#----#----#----#----#----#----#---
#----#----#----#----#----#----#----#----#----#----#----#----#----#----#----#----#----#----#----#----
----#----#----#----#----#----#----#----#----#----#----#----#----#----#----#----#----#----#----#----#
----#----#----#----#----#----#----#----#----#----#----#----#----#----#----#----#----#----#----#----#
#---##---##---##---##---##---##---##---##---##---##---##---##---##---##---##---##---##---##---##---#
-#----#----#----#----#----#----#----#----#----#----#----#----#----#----#----#----#----#----#----#---
#----#----#----#----#----#----#----#----#----#----#----#----#----#----#----#----#----#----#----#----
----#----#----#----#----#----#----#----#----#----#----#----#----#----#----#----#----#----#----#----#
----#----#----#----#----#----#----#----#----#----#----#----#----#----#----#----#----#----#----#----#
#---##---##---##---##---##---##---##---##---##---##---##---##---##---##---##---##---##---##---##---#
-#----#----#----#----#----#----#----#----#----#----#----#----#----#----#----#----#----#----#----#---
#----#----#----#----#----#----#----#----#----#----#----#----#----#----#----#----#----#----#----#----
----#----#----#----#----#----#----#----#----#----#----#----#----#----#----#----#----#----#----#----#
----#----#----#----#----#----#----#----#----#----#----#----#----#----#----#----#----#----#----#----#
#---##---##---##---##---##---##---##---##---##---##---##---##---##---##---##---##---##---##---##---#
-#----#----#----#----#----#----#----#----#----#----#----#----#----#----#----#----#----#----#----#---
#----#----#----#----#----#----#----#----#----#----#----#----#----#----#----#----#----#----#----#----
----#----#----#----#----#----#----#----#----#----#----#----#----#----#----#----#----#----#----#----#