?diagonal=Always;
----#----#----#----#----#----#----#----#----#----#----#----#----#----#----#----#----#----#----#----#
#--#-#--#-#--#-#--#-#--#-#--#-#--#-#--#-#--#-#--#-#--#-#--#-#--#-#--#-#--#-#--#-#--#-#--#-#--#-#--#-
#----#----#----#----#----#----#----#----#----#----#----#----#----#----#----#----#----#----#----#----
--##---##---##---##---##---##---##---##---##---##---##---##---##---##---##---##---##---##---##---##-
--#----#----#----#----#----#----#----#----#----#----#----#----#----#----#----#----#----#----#----#--
----#----#----#----#----#----#----#----#----#----#----#----#----#----#----#----#----#----#----#----#
#--#-#--#-#--#-#--#-#--#-#--#-#--#-#--#-#--#-#--#-#--#-#--#-#--#-#--#-#--#-#--#-#--#-#--#-#--#-#--#-
#----#----#----#----#----#----#----#----#----#----#----#----#----#----#----#----#----#----#----#----
--##---##---##---##---##---##---##---##---##---##---##---##---##---##---##---##---##---##---##---##-
--#----#----#----#----#----#----#----#----#----#----#----#----#----#----#----#----#----#----#----#--
----#----#----#----#----#----#----#----#----#----#----#----#----#----#----#----#----#----#----#----#
#--#-#--#-#--#-#--#-#--#-#--#-#--#-#--#-#--#-#--#-#--#-#--#-#--#-#--#-#--#-#--#-#--#-#--#-#--#-#--#-
#----#----#----#----#----#----#----#----#----#----#----#----#----#----#----#----#----#----#----#----
--##---##---##---##---##---##---##---##---##---##---##---##---##---##---##---##---##---##---##---##-
--#----#----#----#----#----#----#----#----#----#----#----#----#----#----#----#----#----#----#----#--
----#----#----#----#----#----#----#----#----#----#----#----#----#----#----#----#----#----#----#----#
#--#-#--#-#--#-#--#-#--#-#--#-#--#-#--#-#--#-#--#-#--#-#--#-#--#-#--#-#--#-#--#-#--#-#--#-#--#-#--#-
#----#----#----#----#----#----#----#----#----#----#----#----#----#----#----#----#----#----#----#----
--##---##---##---##---##---##---##---##---##---##---##---##---##---##---##---##---##---##---##---##-
--#----#----#----#----#----#----#----#----#----#----#----#----#----#----#----#----#----#----#----#--
----#----#----#----#----#----#----#----#----#----#----#----#----#----#----#----#----#----#----#----#
#--#-#--#-#--#-#--#-#--#-#--#-#--#-#--#-#--#-#--#-#--#-#--#-#--#-#--#-#--#-#--#-#--#-#--#-#--#-#--#-
#----#----#----#----#----#----#----#----#----#----#----#----#----#----#----#----#----#----#----#----
--##---##---##---##---##---##---##---##---##---##---##---##---##---##---##---##---##---##---##---##-
--#----#----#----#----#----#----#----#----#----#----#----#----#----#----#----#----#----#----#----#--
----#----#----#----#----#----#----#----#----#----#----#----#----#----#----#----#----#----#----#----#
#--#-#--#-#--#-#--#-#--#-#--#-#--#-#--#-#--#-#--#-#--#-#--#-#--#-#--#-#--#-#--#-#--#-#--#-#--#-#--#-
#----#----#----#----#----#----#----#----#----#----#----#----#----#----#----#----#----#----#----#----
--##---##---##---##---##---##---##---##---##---##---##---##---##---##---##---##---##---##---##---##-
--#----#----#----#----#----#----#----#----#----#----#----#----#----#----#----#----#----#----#----#--
----#----#----#----#----#----#----#----#----#----#----#----#----#----#----#----#----#----#----#----#
#--#-#--#-#--#-#--#-#--#-#--#-#--#-#--#-#--#-#--#-#--#-#--#-#--#-#--#-#--#-#--#-#--#-#--#-#--#-#--#-
#----#----#----#----#----#----#----#----#----#----#----#----#----#----#----#----#----#----#----#----
--##---##---##---##---##---##---##---##---##---##---##---##---##---##---##---##---##---##---##---##-
--#----#----#----#----#----#----#----#----#----#----#----#----#----#----#----#----#----#----#----#--
----#----#----#----#----#----#----#----#----#----#----#----#----#----#----#----#----#----#----#----#
#--#-#--#-#--#-#--#-#--#-#--#-#--#-#--#-#--#-#--#-#--#-#--#-#--#-#--#-#--#-#--#-#--#-#--#-#--#-#--#-
#----#----#----#----#----#----#----#----#----#----#----#----#----#----#----#----#----#----#----#----
--##---##---##---##---##---##---##---##---##---##---##---##---##---##---##---##---##---##---##---##-
--#----#----#----#----#----#----#----#----#----#----#----#----#----#----#----#----#----#----#----#--
----#----#----#----#----#----#----#----#----#----#----#----#----#----#----#----#----#----#----#----#
#--#-#--#-#--#-#--#-#--#-#--#-#--#-#--#-#--#-#--#-#--#-#--#-#--#-#--#-#--#-#--#-#--#-#--#-#--#-#--#-
#----#----#----#----#----#-E--#----#----#----#----#----#----#----#----#----#----#----#----#----#----
--##---##---##---##---##---##---##---##---##---##---##---##---##---##---##---##---##---##---##---##-
--#----#----#----#----#----#----#----#----#----#----#----#----#----#----#----#----#----#----#----#--
----#----#----#----#----#----#----#----#----#----#----#----#----#----#----#----#----#----#----#----#
#--#-#--#-#--#-#--#-#--#-#--#-#--#-#--#-#--#-#--#-#--#-#--#-#--#-#--#-#--#-#--#-#--#-#--#-#-S#-#--#-
#----#----#----#----#----#----#----#----#----#----#----#----#----#----#----#----#----#----#----#----
--##---##---##---##---##---##---##---##---##---##---##---##---##---##---##---##---##---##---##---##-
--#----#----#----#----#----#----#----#----#----#----#----#----#----#----#----#----#----#----#----#--
----#----#----#----#----#----#----#----#----#----#----#----#----#----#----#----#----#----#----#----#
#--#-#--#-#--#-#--#-#--#-#--#-#--#-#--#-#--#-#--#-#--#-#--#-#--#-#--#-#--#-#--#-#--#-#--#-#--#-#--#-
#----#----#----#----#----#----#----#----#----#----#----#----#----#----#----#----#----#----#----#----
--##---##---##---##---##---##---##---##---##---##---##---##---##---##---##---##---##---##---##---##-
--#----#----#----#----#----#----#----#----#----#----#----#----#----#----#----#----#----#----#----#--
----#----#----#----#----#----#----#----#----#----#----#----#----#----#----#----#----#----#----#----#
#--#-#--#-#--#-#--#-#--#-#--#-#--#-#--#-#--#-#--#-#--#-#--#-#--#-#--#-#--#-#--#-#--#-#--#-#--#-#--#-
#----#----#----#----#----#----#----#----#----#----#----#----#----#----#----#----#----#----#----#----
--##---##---##---##---##---##---##---##---##---##---##---##---##---##---##---##---##---##---##---##-
--#----#----#----#----#----#----#----#----#----#----#----#----#----#----#----#----#----#----#----#--
----#----#----#----#----#----#----#----#----#----#----#----#----#----#----#----#----#----#----#----#
#--#-#--#-#--#-#--#-#--#-#--#-#--#-#--#-#--#-#--#-#--#-#--#-#--#-#--#-#--#-#--#-#--#-#--#-#--#-#--#-
#----#----#----#----#----#----#----#----#----#----#----#----#----#----#----#----#----#----#----#----
--##---##---##---##---##---##---##---##---##---##---##---##---##---##---##---##---##---##---##---##-
--#----#----#----#----#----#----#----#----#----#----#----#----#----#----#----#----#----#----#----#--
----#----#----#----#----#----#----#----#----#----#----#----#----#----#----#----#----#----#----#----#
#--#-#--#-#--#-#--#-#--#-#--#-#--#-#--#-#--#-#--#-#--#-#--#-#--#-#--#-#--#-#--#-#--#-#--#-#--#-#--#-
#----#----#----#----#----#----#----#----#----#----#----#----#----#----#----#----#----#----#----#----
--##---##---##---##---##---##---##---##---##---##---##---##---##---##---##---##---##---##---##---##-
--#----#----#----#----#----#----#----#----#----#----#----#----#----#----#----#----#----#----#----#--
----#----#----#----#----#----#----#----#----#----#----#----#----#----#----#----#----#----#----#----#
#--#-#--#-#--#-#--#-#--#-#--#-#--#-#--#-#--#-#--#-#--#-#--#-#--#-#--#-#--#-#--#-#--#-#--#-#--#-#--#-
#----#----#----#----#----#----#----#----#----#----#----#----#----#----#----#----#----#----#----#----
--##---##---##---##---##---##---##---##---##---##---##---##---##---##---##---##---##---##---##---##-
--#----#----#----#----#----#----#----#----#----#----#----#----#----#----#----#----#----#----#----#--
----#----#----#----#----#----#----#----#----#----#----#----#----#----#----#----#----#----#----#----#
#--#-#--#-#--#-#--#-#--#-#--#-#--#-#--#-#--#-#--#-#--#-#--#-#--#-#--#-#--#-#--#-#--#-#--#-#--#-#--#-
#----#----#----#----#----#----#----#----#----#----#----#----#----#----#----#----#----#----#----#----
--##---##---##---##---##---##---##---##---##---##---##---##---##---##---##---##---##---##---##---##-
--#----#----#----#----#----#----#----#----#----#----#----#----#----#----#----#----#----#----#----#--
----#----#----#----#----#----#----#----#----#----#----#----#----#----#----#----#----#----#----#----#
#--#-#--#-#--#-#--#-#--#-#--#-#--#-#--#-#--#-#--#-#--#-#--#-#--#-#--#-#--#-#--#-#--#-#--#-#--#-#--#-
#----#----#----#----#----#----#----#----#----#----#----#----#----#----#----#----#----#----#----#----
--##---##---##---##---##---##---##---##---##---##---##---##---##---##---##---##---##---##---##---##-
--#----#----#----#----#----#----#----#----#----#----#----#----#----#----#----#----#----#----#----#--
----#----#----#----#----#----#----#----#----#----#----#----#----#----#----#----#----#----#----#----#
#--#-#--#-#--#-#--#-#--#-#--#-#--#-#--#-#--#-#--#-#--#-#--#-#--#-#--#-#--#-#--#-#--#-#--#-#--#-#--#-
#----#----#----#----#----#----#----#----#----#----#----#----#----#----#----#----#----#----#----#----
--##---##---##---##---##---##---##---##---##---##---##---##---##---##---##---##---##---##---##---##-
--#----#----#----#----#----#----#----#----#----#----#----#----#----#----#----#----#----#----#----#--
----#----#----#----#----#----#----#----#----#----#----#----#----#----#----#----#----#----#----#----#
#--#-#--#-#--#-#--#-#--#-#--#-#--#-#--#-#--#-#--#-#--#-#--#-#--#-#--#-#--#-#--#-#--#-#--#-#--#-#--#-
#----#----#----#----#----#----#----#----#----#----#----#----#----#----#----#----#----#----#----#----
--##---##---##---##---##---##---##---##---##---##---##---##---##---##---##---##---##---##---##---##-
--#----#----#----#----#----#----#----#----#----#----#----#----#----#----#----#----#----#----#----#--
----#----#----#----#----#----#----#----#----#----#----#----#----#----#----#----#----#----#----#----#
#--#-#--#-#--#-#--#-#--#-#--#-#--#-#--#-#--#-#--#-#--#-#--#-#--#-#--#-#--#-#--#-#--#-#--#-#--#-#--#-
#----#----#----#----#----#----#----#----#----#----#----#----#----#----#----#----#----#----#----#----
--##---##---##---##---##---##---##---##---##---##---##---##---##---##---##---##---##---##---##---##-
--#----#----#----#----#----#----#----#----#----#----#----#----#----#----#----#----#----#----#----#--