?diagonal=Always;
--#----#----#----#----#----#----#----#----#----#----#----#----#----#----#----#----#----#----#----#--
----#----#----#----#----#----#----#----#----#----#----#----#----#----#----#----#----#----#----#----#
-#----#----#----#----#----#----#----#----#----#----#----#----#----#----#----#----#----#----#----#---
----------------------------------------------------------------------------------------------------
#-##-#-##-#-##-#-##-#-##-#-##-#-##-#-##-#-##-#-##-#-##-#-##-#-##-#-##-#-##-#-##-#-##-#-##-#-##-#-##-
--#----#----#----#----#----#----#----#----#----#----#----#----#----#----#----#----#----#----#----#--
----#----#----#----#----#----#----#----#----#----#----#----#----#----#----#----#----#----#----#----#
-#----#----#----#----#----#----#----#----#----#----#----#----#----#----#----#----#----#----#----#---
----------------------------------------------------------------------------------------------------
#-##-#-##-#-##-#-##-#-##-#-##-#-##-#-##-#-##-#-##-#-##-#-##-#-##-#-##-#-##-#-##-#-##-#-##-#-##-#-##-
--#----#----#----#----#----#----#----#----#----#----#----#----#----#----#----#----#----#----#----#--
----#----#----#----#----#----#----#----#----#----#----#----#----#----#----#----#----#----#----#----#
-#----#----#----#----#----#----#----#----#----#----#----#----#----#----#----#----#----#----#----#---
----------------------------------------------------------------------------------------------------
#-##-#-##-#-##-#-##-#-##-#-##-#-##-#-##-#-##-#-##-#-##-#-##-#-##-#-##-#-##-#-##-#-##-#-##-#-##-#-##-
--#----#----#----#----#----#----#----#----#----#----#----#----#----#----#----#----#----#----#----#--
----#----#----#----#----#----#----#----#----#----#----#----#----#----#----#----#----#----#----#----#
-#----#----#----#----#----#----#----#----#----#----#----#----#----#----#----#----#----#----#----#---
----------------------------------------------------------------------------------------------------
#-##-#-##-#-##-#-##-#-##-#-##-#-##-#-##-#-##-#-##-#-##-#-##-#-##-#-##-#-##-#-##-#-##-#-##-#-##-#-##-
--#----#----#----#----#----#----#----#----#----#----#----#----#----#----#----#----#----#----#----#--
----#----#----#----#----#----#----#----#----#----#----#----#----#----#----#----#----#----#----#----#
-#----#----#----#----#----#----#----#----#----#----#----#----#----#----#----#----#----#----#----#---
----------------------------------------------------------------------------------------------------
#-##-#-##-#-##-#-##-#-##-#-##-#-##-#-##-#-##-#-##-#-##-#-##-#-##-#-##-#-##-#-##-#-##-#-##-#-##-#-##-
--#----#----#----#----#----#----#----#----#----#---E#----#----#----#----#----#----#----#----#----#--
----#----#----#----#----#----#----#----#----#----#----#----#----#----#----#----#----#----#----#----#
-#----#----#----#----#----#----#----#----#----#----#----#----#----#----#----#----#----#----#----#---
----------------------------------------------------------------------------------------------------
#-##-#-##-#-##-#-##-#-##-#-##-#-##-#-##-#-##-#-##-#-##-#-##-#-##-#-##-#-##-#-##-#-##-#-##-#-##-#-##-
--#----#----#----#----#----#----#----#----#----#----#----#----#----#----#----#----#----#----#----#--
----#----#----#----#----#----#----#----#----#----#----#----#----#----#----#----#----#----#----#----#
-#----#----#----#----#----#----#----#----#----#----#----#----#----#----#----#----#----#----#----#---
----------------------------------------------------------------------------------------------------
#-##-#-##-#-##-#-##-#-##-#-##-#-##-#-##-#-##-#-##-#-##-#-##-#-##-#-##-#-##-#-##-#-##-#-##-#-##-#-##-
--#----#----#----#----#----#----#----#----#----#----#----#----#----#----#----#----#----#----#----#--
----#----#----#----#----#----#----#----#----#----#----#----#----#----#----#----#----#----#----#----#
-#----#----#----#----#----#----#----#----#----#----#----#----#----#----#----#----#----#----#----#---
----------------------------------------------------------------------------------------------------
#-##-#-##-#-##-#-##-#-##-#-##-#-##-#-##-#-##-#-##-#-##-#-##-#-##-#-##-#-##-#-##-#-##-#-##-#-##-#-##-
--#----#----#----#----#----#----#----#----#----#----#----#----#----#----#----#----#----#----#----#--
----#----#----#----#----#----#----#----#----#----#----#----#----#----#----#----#----#----#----#----#
-#----#----#----#----#----#----#----#----#----#----#----#----#----#----#----#----#----#----#----#---
----------------------------------------------------------------------------------------------------
#-##-#-##-#-##-#-##-#-##-#-##-#-##-#-##-#-##-#-##-#-##-#-##-#-##-#-##-#-##-#-##-#-##-#-##-#-##-#-##-
--#----#----#----#----#----#----#----#----#----#----#----#----#----#----#----#----#----#----#----#--
----#----#----#----#----#----#----#----#----#----#----#----#----#----#----#----#----#----#----#----#
-#----#----#----#----#----#----#----#----#----#----#----#----#----#----#----#----#----#----#----#---
----------------------------------------------------------------------------------------------------
#-##-#-##-#-##-#-##-#-##-#-##-#-##-#-##-#-##-#-##-#-##-#-##-#-##-#-##-#-##-#-##-#-##-#-##-#-##-#-##-
--#----#----#----#----#----#----#----#----#----#----#----#----#----#----#----#----#----#----#----#--
----#----#----#----#----#----#----#----#----#----#----#----#----#----#----#----#----#----#----#----#
-#----#----#----#----#----#----#----#----#----#----#----#----#----#----#----#----#----#----#----#---
----------------------------------------------------------------------------------------------------
#-##-#-##-#-##-#-##-#-##-#-##-#-##-#-##-#-##-#-##-#-##-#-##-#-##-#-##-#-##-#-##-#-##-#-##-#-##-#-##-
--#----#----#----#----#----#----#----#----#----#----#----#----#----#----#----#----#----#----#----#--
----#----#----#----#----#----#----#----#----#----#----#----#----#----#----#----#----#----#----#----#
-#----#----#----#----#----#----#----#----#----#----#----#----#----#----#----#----#----#----#----#---
----------------------------------------------------------------------------------------------------
#-##-#-##-#-##-#-##-#-##-#-##-#-##-#-##-#-##-#-##-#-##-#-##-#-##-#-##-#-##-#-##-#-##-#-##-#-##-#-##-
--#----#----#----#----#----#----#----#----#----#----#----#----#----#----#----#----#----#----#----#--
----#----#----#----#----#----#----#----#----#----#----#----#----#----#----#----#----#----#----#----#
-#----#----#----#----#----#----#----#----#----#----#----#----#----#----#----#----#----#----#----#---
----------------------------------------------------------------------------------------------------
#-##-#-##-#-##-#-##-#-##-#-##-#-##-#-##-#-##-#-##-#-##-#-##-#-##-#-##-#-##-#-##-#-##-#-##-#-##-#-##-
--#----#----#----#----#----#----#----#----#----#----#----#----#----#----#----#----#----#----#----#--
----#----#----#----#----#----#----#----#----#----#----#----#----#----#----#----#----#----#----#----#
-#----#----#----#----#----#----#----#----#----#----#----#----#----#----#----#----#----#----#----#---
----------------------------------------------------------------------------------------------------
#-##-#-##-#-##-#-##-#-##-#-##-#-##-#-##-#-##-#-##-#-##-#-##-#-##-#-##-#-##-#-##-#-##-#-##-#-##-#-##-
--#----#----#----#----#----#----#----#----#----#----#----#----#----#----#----#----#----#----#----#--
----#----#----#----#----#----#----#----#----#----#----#----#----#----#----#----#----#----#----#----#
-#----#----#----#----#----#----#----#----#----#----#----#----#----#----#----#----#----#----#----#---
----------------------------------------------------------------------------------------------------
#-##-#-##-#-##-#-##-#-##-#-##-#-##-#-##-#-##-#-##-#-##-#-##-#-##-#-##-#-##-#-##-#-##-#-##-#-##-#-##-
--#----#----#----#----#----#----#----#----#----#----#----#----#----#----#----#----#----#----#----#--
----#----#----#----#----#----#----#----#----#----#----#----#----#----#----#----#----#----#----#----#
-#----#----#----#----#----#----#----#----#----#----#----#----#----#----#----#----#----#----#----#---
----------------------------------------------------------------------------------------------------
#-##-#-##-#-##-#-##-#-##-#-##-#-##-#-##-#-##-#-##-#-##-#-##-#-##-#-##-#-##-#-##-#-##-#-##-#-##-#-##-
--#----#----#----#----#----#----#----#----#----#----#----#----#----#----#----#----#----#----#----#--
----#----#----#----#----#----#----#----#----#----#----#----#----#----#----#----#----#----#----#----#
-#----#----#----#----#----#----#----#----#----#----#----#----#----#----#----#----#----#----#----#---
----------------------------------------------------------------------------------------------------
#-##-#-##-#-##-#-##-#-##-#-##-#-##-#-##-#-##-#-##-#-##-#-##-#-##-#-##-#-##-#-##-#-##-#-##-#-##-#-##-
--#----#----#----#----#----#----#----#----#----#----#----#----#----#----#----#----#----#----#----#--
----#----#----#----#----#----#----#----#----#----#----#----#----#----#----#----#----#----#----#----#
-#----#----#----#----#----#----#---S#----#----#----#----#----#----#----#----#----#----#----#----#---
----------------------------------------------------------------------------------------------------
#-##-#-##-#-##-#-##-#-##-#-##-#-##-#-##-#-##-#-##-#-##-#-##-#-##-#-##-#-##-#-##-#-##-#-##-#-##-#-##-
--#----#----#----#----#----#----#----#----#----#----#----#----#----#----#----#----#----#----#----#--
----#----#----#----#----#----#----#----#----#----#----#----#----#----#----#----#----#----#----#----#
-#----#----#----#----#----#----#----#----#----#----#----#----#----#----#----#----#----#----#----#---
----------------------------------------------------------------------------------------------------
#-##-#-##-#-##-#-##-#-##-#-##-#-##-#-##-#-##-#-##-#-##-#-##-#-##-#-##-#-##-#-##-#-##-#-##-#-##-#-##-
--#----#----#----#----#----#----#----#----#----#----#----#----#----#----#----#----#----#----#----#--
----#----#----#----#----#----#----#----#----#----#----#----#----#----#----#----#----#----#----#----#
-#----#----#----#----#----#----#----#----#----#----#----#----#----#----#----#----#----#----#----#---
----------------------------------------------------------------------------------------------------
#-##-#-##-#-##-#-##-#-##-#-##-#-##-#-##-#-##-#-##-#-##-#-##-#-##-#-##-#-##-#-##-#-##-#-##-#-##-#-##-