?diagonal=Always;
---#----#----#----#----#----#----#----#----#----#----#----#----#----#----#----#----#----#----#----#-
--#----#----#----#----#----#----#----#----#----#----#----#----#----#----#----#----#----#----#----#--
--#----#----#----#----#----#----#----#----#----#----#----#----#----#----#----#----#----#----#----#--
--#----#----#----#----#----#----#----#----#----#----#----#----#----#----#----#----#----#----#----#--
##--###--###--###--###--###--###--###--###--###--###--###--###--###--###--###--###--###--###--###--#
---#----#----#----#----#----#----#----#----#----#----#----#----#----#----#----#----#----#----#----#-
--#----#----#----#----#----#----#----#----#----#----#----#----#----#----#----#----#----#----#----#--
--#----#----#----#----#----#----#----#----#----#----#----#----#----#----#----#----#----#----#----#--
--#----#----#----#----#----#----#----#----#----#----#----#----#----#----#----#----#----#----#----#--
##--###--###--###--###--###--###--###--###--###--###--###--###--###--###--###--###--###--###--###--#
---#----#----#----#----#----#----#----#----#----#----#----#----#----#----#----#----#----#----#----#-
--#----#----#----#----#----#----#----#----#----#----#----#----#----#----#----#----#----#----#----#--
--#----#----#----#----#----#----#----#----#----#----#----#----#----#----#----#----#----#----#----#--
--#----#----#----#----#----#----#----#----#----#----#----#----#----#----#----#----#----#----#----#--
##--###--###--###--###--###--###--###--###--###--###--###--###--###--###--###--###--###--###--###--#
---#----#----#----#----#----#----#----#----#----#----#----#----#----#----#----#----#----#----#----#-
--#----#----#----#----#----#----#----#----#----#----#----#----#----#----#----#----#----#----#----#--
--#----#----#----#----#----#----#----#----#----#----#----#----#----#----#----#----#----#----#----#--
--#----#----#----#----#----#----#----#----#----#----#----#----#----#----#----#----#----#----#----#--
##--###--###--###--###--###--###--###--###--###--###--###--###--###--###--###--###--###--###--###--#
---#----#----#----#----#----#----#----#----#----#----#----#----#----#----#----#----#----#----#----#-
--#----#----#----#----#----#----#----#----#----#----#----#----#----#----#----#----#----#----#----#--
--#----#----#----#----#----#----#----#----#----#----#----#----#----#----#----#----#----#----#----#--
--#----#----#----#----#----#----#----#----#----#----#----#----#----#----#----#----#----#----#----#--
##--###--###--###--###--###--###--###--###--###--###--###--###--###--###--###--###--###--###--###--#
---#----#----#----#----#----#----#----#----#----#----#----#----#----#----#----#----#----#----#----#-
--#---E#----#----#----#----#----#----#----#----#----#----#----#----#----#----#----#----#----#----#--
--#----#----#----#----#----#----#----#----#----#----#----#----#----#----#----#----#----#----#----#--
--#----#----#----#----#----#----#----#----#----#----#----#----#----#----#----#----#----#----#----#--
##--###--###--###--###--###--###--###--###--###--###--###--###--###--###--###--###--###--###--###--#
---#----#----#----#----#----#----#----#----#----#----#----#----#----#----#----#----#----#----#----#-
--#----#----#----#----#----#----#----#----#----#----#----#----#----#----#----#----#----#----#----#--
--#----#----#----#----#----#----#----#----#----#----#----#----#----#----#----#----#----#----#----#--
--#----#----#----#----#----#----#----#----#----#----#----#----#----#----#----#----#----#----#----#--
##--###--###--###--###--###--###--###--###--###--###--###--###--###--###--###--###--###--###--###--#
---#----#----#----#----#----#----#----#----#----#----#----#----#----#----#----#----#----#----#----#-
--#----#----#----#----#----#----#----#----#----#----#----#----#----#----#----#----#----#----#----#--
--#----#----#----#----#----#----#----#----#----#----#----#----#----#----#----#----#----#----#----#--
--#----#----#----#----#----#----#----#----#----#----#----#----#----#----#----#----#----#----#----#--
##--###--###--###--###--###--###--###--###--###--###--###--###--###--###--###--###--###--###--###--#
---#----#----#----#----#----#----#----#----#----#----#----#----#----#----#----#----#----#----#----#-
--#----#----#----#----#----#----#----#----#----#----#----#----#----#----#----#----#----#----#----#--
--#----#----#----#----#----#----#----#----#----#----#----#----#----#----#----#----#----#----#----#--
--#----#----#----#----#----#----#----#----#----#----#----#----#----#----#----#----#----#----#----#--
##--###--###--###--###--###--###--###--###--###--###--###--###--###--###--###--###--###--###--###--#
---#----#----#----#----#----#----#----#----#----#----#----#----#----#--S-#----#----#----#----#----#-
--#----#----#----#----#----#----#----#----#----#----#----#----#----#----#----#----#----#----#----#--
--#----#----#----#----#----#----#----#----#----#----#----#----#----#----#----#----#----#----#----#--
--#----#----#----#----#----#----#----#----#----#----#----#----#----#----#----#----#----#----#----#--
##--###--###--###--###--###--###--###--###--###--###--###--###--###--###--###--###--###--###--###--#
---#----#----#----#----#----#----#----#----#----#----#----#----#----#----#----#----#----#----#----#-
--#----#----#----#----#----#----#----#----#----#----#----#----#----#----#----#----#----#----#----#--
--#----#----#----#----#----#----#----#----#----#----#----#----#----#----#----#----#----#----#----#--
--#----#----#----#----#----#----#----#----#----#----#----#----#----#----#----#----#----#----#----#--
##--###--###--###--###--###--###--###--###--###--###--###--###--###--###--###--###--###--###--###--#
---#----#----#----#----#----#----#----#----#----#----#----#----#----#----#----#----#----#----#----#-
--#----#----#----#----#----#----#----#----#----#----#----#----#----#----#----#----#----#----#----#--
--#----#----#----#----#----#----#----#----#----#----#----#----#----#----#----#----#----#----#----#--
--#----#----#----#----#----#----#----#----#----#----#----#----#----#----#----#----#----#----#----#--
##--###--###--###--###--###--###--###--###--###--###--###--###--###--###--###--###--###--###--###--#
---#----#----#----#----#----#----#----#----#----#----#----#----#----#----#----#----#----#----#----#-
--#----#----#----#----#----#----#----#----#----#----#----#----#----#----#----#----#----#----#----#--
--#----#----#----#----#----#----#----#----#----#----#----#----#----#----#----#----#----#----#----#--
--#----#----#----#----#----#----#----#----#----#----#----#----#----#----#----#----#----#----#----#--
##--###--###--###--###--###--###--###--###--###--###--###--###--###--###--###--###--###--###--###--#
---#----#----#----#----#----#----#----#----#----#----#----#----#----#----#----#----#----#----#----#-
--#----#----#----#----#----#----#----#----#----#----#----#----#----#----#----#----#----#----#----#--
--#----#----#----#----#----#----#----#----#----#----#----#----#----#----#----#----#----#----#----#--
--#----#----#----#----#----#----#----#----#----#----#----#----#----#----#----#----#----#----#----#--
##--###--###--###--###--###--###--###--###--###--###--###--###--###--###--###--###--###--###--###--#
---#----#----#----#----#----#----#----#----#----#----#----#----#----#----#----#----#----#----#----#-
--#----#----#----#----#----#----#----#----#----#----#----#----#----#----#----#----#----#----#----#--
--#----#----#----#----#----#----#----#----#----#----#----#----#----#----#----#----#----#----#----#--
--#----#----#----#----#----#----#----#----#----#----#----#----#----#----#----#----#----#----#----#--
##--###--###--###--###--###--###--###--###--###--###--###--###--###--###--###--###--###--###--###--#
---#----#----#----#----#----#----#----#----#----#----#----#----#----#----#----#----#----#----#----#-
--#----#----#----#----#----#----#----#----#----#----#----#----#----#----#----#----#----#----#----#--
--#----#----#----#----#----#----#----#----#----#----#----#----#----#----#----#----#----#----#----#--
--#----#----#----#----#----#----#----#----#----#----#----#----#----#----#----#----#----#----#----#--
##--###--###--###--###--###--###--###--###--###--###--###--###--###--###--###--###--###--###--###--#
---#----#----#----#----#----#----#----#----#----#----#----#----#----#----#----#----#----#----#----#-
--#----#----#----#----#----#----#----#----#----#----#----#----#----#----#----#----#----#----#----#--
--#----#----#----#----#----#----#----#----#----#----#----#----#----#----#----#----#----#----#----#--
--#----#----#----#----#----#----#----#----#----#----#----#----#----#----#----#----#----#----#----#--
##--###--###--###--###--###--###--###--###--###--###--###--###--###--###--###--###--###--###--###--#
---#----#----#----#----#----#----#----#----#----#----#----#----#----#----#----#----#----#----#----#-
--#----#----#----#----#----#----#----#----#----#----#----#----#----#----#----#----#----#----#----#--
--#----#----#----#----#----#----#----#----#----#----#----#----#----#----#----#----#----#----#----#--
--#----#----#----#----#----#----#----#----#----#----#----#----#----#----#----#----#----#----#----#--
##--###--###--###--###--###--###--###--###--###--###--###--###--###--###--###--###--###--###--###--#
---#----#----#----#----#----#----#----#----#----#----#----#----#----#----#----#----#----#----#----#-
--#----#----#----#----#----#----#----#----#----#----#----#----#----#----#----#----#----#----#----#--
--#----#----#----#----#----#----#----#----#----#----#----#----#----#----#----#----#----#----#----#--
--#----#----#----#----#----#----#----#----#----#----#----#----#----#----#----#----#----#----#----#--
##--###--###--###--###--###--###--###--###--###--###--###--###--###--###--###--###--###--###--###--#
---#----#----#----#----#----#----#----#----#----#----#----#----#----#----#----#----#----#----#----#-
--#----#----#----#----#----#----#----#----#----#----#----#----#----#----#----#----#----#----#----#--
--#----#----#----#----#----#----#----#----#----#----#----#----#----#----#----#----#----#----#----#--
--#----#----#----#----#----#----#----#----#----#----#----#----#----#----#----#----#----#----#----#--
##--###--###--###--###--###--###--###--###--###--###--###--###--###--###--###--###--###--###--###--#