?diagonal=Always;
--#----#----#----#----#----#----#----#----#----#----#----#----#----#----#----#----#----#----#----#--
----#----#----#----#----#----#----#----#----#----#----#----#----#----#----#----#----#----#----#----#
-#----#----#----#----#----#----#----#----#----#----#----#----#----#----#----#----#----#----#----#---
-#----#----#----#----#----#----#----#----#----#----#----#----#----#----#----#----#----#----#----#---
--#-#--#-#--#-#--#-#--#-#--#-#--#-#--#-#--#-#--#-#--#-#--#-#--#-#--#-#--#-#--#-#--#-#--#-#--#-#--#-#
--#----#----#----#----#----#----#----#----#----#----#----#----#----#----#----#----#----#----#----#--
----#----#----#----#----#----#----#----#----#----#----#----#----#----#----#----#----#----#----#----#
-#----#----#----#----#----#----#----#----#----#----#----#----#----#----#----#----#----#----#----#---
-#----#----#----#----#----#----#----#----#----#----#----#----#----#----#----#----#----#----#----#---
--#-#--#-#--#-#--#-#--#-#--#-#--#-#--#-#--#-#--#-#--#-#--#-#--#-#--#-#--#-#--#-#--#-#--#-#--#-#--#-#
--#----#----#----#----#----#----#----#----#----#----#----#----#----#----#----#----#----#----#----#--
----#----#----#----#----#----#----#----#----#----#----#----#----#----#----#----#----#----#----#----#
-#----#----#----#----#----#----#----#----#----#----#----#----#----#----#----#----#----#----#----#---
-#----#----#----#----#----#----#----#----#----#----#----#----#----#----#----#----#----#----#----#---
--#-#--#-#--#-#--#-#--#-#--#-#--#-#--#-#--#-#--#-#--#-#--#-#--#-#--#-#--#-#--#-#--#-#--#-#--#-#--#-#
--#----#----#----#----#----#----#----#----#----#----#----#----#----#----#----#----#----#----#----#--
----#----#----#----#----#----#----#----#----#----#----#----#----#----#----#----#----#----#----#----#
-#----#----#----#----#----#----#----#----#----#----#----#----#----#----#----#----#----#----#----#---
-#----#----#----#----#----#----#----#----#----#----#----#----#----#----#----#----#----#----#----#---
--#-#--#-#--#-#--#-#--#-#--#-#--#-#--#-#--#-#--#-#--#-#--#-#--#-#--#-#--#-#--#-#--#-#--#-#--#-#--#-#
--#----#----#----#----#----#----#----#----#----#----#----#----#----#----#----#----#----#----#----#--
----#----#----#----#----#----#----#----#----#----#----#----#----#----#----#----#----#----#----#----#
-#----#----#----#----#----#----#----#----#----#----#----#----#----#----#----#----#----#----#----#---
-#----#----#----#----#----#----#----#----#----#----#----#----#----#----#----#----#----#----#----#---
--#-#--#-#--#-#--#-#--#-#--#-#--#-#--#-#--#-#--#-#--#-#--#-#--#-#--#-#--#-#--#-#--#-#--#-#--#-#--#-#
--#----#----#----#----#----#----#----#----#----#----#----#----#----#----#----#----#----#----#----#--
----#----#----#----#----#----#----#----#----#----#----#----#----#----#----#----#----#----#----#----#
-#----#----#----#----#----#----#----#----#----#----#----#----#----#----#----#----#----#----#----#---
-#----#----#----#----#----#----#----#----#----#----#----#----#----#----#----#----#----#----#----#---
--#-#--#-#--#-#--#-#--#-#--#-#--#-#--#-#--#-#--#-#--#-#--#-#--#-#--#-#--#-#--#-#--#-#--#-#--#-#--#-#
--#----#----#----#----#----#----#----#----#----#----#----#----#----#----#----#----#----#----#----#--
----#----#----#----#----#----#----#----#----#----#----#----#----#----#----#----#----#----#----#----#
-#----#----#----#----#----#----#----#----#----#----#----#----#----#----#----#----#----#----#----#---
-#----#----#----#----#----#----#----#----#----#----#----#----#----#----#----#----#----#----#----#---
--#-#--#-#--#-#--#-#--#-#--#-#--#-#--#-#--#-#--#-#--#-#--#-#--#-#--#-#--#-#--#-#--#-#--#-#--#-#--#-#
--#----#----#----#----#----#----#----#----#----#----#----#----#----#----#----#----#----#----#----#--
----#----#----#----#----#----#----#----#----#----#----#----#----#----#----#----#----#----#----#----#
-#----#----#----#----#----#----#----#----#----#----#----#----#----#----#----#----#----#----#----#---
-#----#----#----#----#----#----#----#----#----#----#----#----#----#----#----#----#----#----#----#---
--#-#--#-#--#-#--#-#--#-#--#-#--#-#--#-#--#-#--#-#--#-#--#-#--#-#--#-#--#-#--#-#--#-#--#-#--#-#--#-#
--#----#----#----#----#----#----#----#----#----#----#----#----#----#----#----#----#----#----#----#--
----#----#----#----#----#----#----#----#----#----#----#----#----#----#----#----#----#----#----#----#
-#----#----#----#----#----#----#----#----#----#----#----#----#----#----#----#----#----#----#----#---
-#----#----#----#----#----#----#----#----#----#----#----#----#----#----#----#----#----#----#----#---
--#-#--#-#--#-#--#-#--#-#--#-#--#-#--#-#--#-#--#-#--#-#--#-#--#-#--#-#--#-#--#-#--#-#--#-#--#-#--#-#
--#----#----#----#----#----#----#----#----#----#----#----#----#----#----#----#----#----#----#----#--
----#----#----#----#----#----#----#----#----#----#----#----#----#----#----#----#----#----#----#----#
-#----#----#----#----#----#----#----#----#----#----#----#----#----#----#----#----#----#----#----#---
-#----#----#----#----#----#----#----#----#----#----#----#----#----#----#----#----#----#----#----#---
--#-#--#-#--#-#--#-#--#-#--#-#--#-#--#-#--#-#--#-#--#-#--#-#--#-#--#-#--#-#--#-#--#-#--#-#--#-#--#-#
--#----#----#----#----#----#----#----#----#----#----#----#----#----#----#----#----#----#----#----#--
----#----#--E-#----#----#----#----#----#----#----#----#----#----#----#----#----#----#----#----#----#
-#----#----#----#----#----#----#----#----#----#----#----#----#----#----#----#----#----#----#----#---
-#----#----#----#----#----#----#----#----#----#----#----#----#----#----#----#----#----#----#----#---
--#-#--#-#--#-#--#-#--#-#--#-#--#-#--#-#--#-#--#-#--#-#--#-#--#-#--#-#--#-#--#-#--#-#--#-#--#-#--#-#
--#----#----#----#----#----#----#----#----#----#----#----#----#----#----#----#----#----#----#----#--
----#----#----#----#----#----#----#----#----#----#----#----#----#----#----#----#----#----#----#----#
-#----#----#----#----#----#----#----#----#----#----#----#----#----#----#----#----#----#----#----#---
-#----#----#----#----#----#----#----#----#----#----#----#----#----#----#----#----#----#----#----#---
--#-#--#-#--#-#--#-#--#-#--#-#--#-#--#-#--#-#--#-#--#-#--#-#--#-#--#-#--#-#--#-#--#-#--#-#--#-#--#-#
--#----#----#----#----#----#----#----#----#----#----#----#----#----#----#----#----#----#----#----#--
----#----#----#----#----#----#----#----#----#----#----#----#----#----#----#----#----#----#----#----#
-#----#----#----#----#----#----#----#----#----#----#----#----#----#----#----#----#----#----#----#---
-#----#----#----#----#----#----#----#----#----#----#----#----#----#----#----#----#----#----#----#---
--#-#--#-#--#-#--#-#--#-#--#-#--#-#--#-#--#-#--#-#--#-#--#-#--#-#--#-#--#-#--#-#--#-#--#-#--#-#--#-#
--#----#----#----#----#----#----#----#----#----#----#----#----#----#----#----#----#----#----#----#--
----#----#----#----#----#----#----#----#----#----#----#----#----#----#----#----#----#----#----#----#
-#----#----#----#----#----#----#----#----#----#----#----#----#----#----#----#----#----#----#----#---
-#----#----#----#----#----#----#----#----#----#----#----#----#----#----#----#----#----#----#----#---
--#-#--#-#--#-#--#-#--#-#--#-#--#-#--#-#--#-#--#-#--#-#--#-#--#-#--#-#--#-#--#-#--#-#--#-#--#-#--#-#
--#----#----#----#----#----#----#----#----#----#----#----#----#----#----#----#----#----#----#----#--
----#----#----#----#----#----#----#----#----#----#----#----#----#----#----#----#----#----#----#----#
-#----#----#----#----#----#----#----#----#----#----#----#----#----#----#----#----#----#----#----#---
-#----#----#----#----#----#----#----#----#----#----#----#----#----#----#----#----#----#----#----#---
--#-#--#-#--#-#--#-#--#-#--#-#--#-#--#-#--#-#--#-#--#-#--#-#--#-#--#-#--#-#--#-#--#-#--#-#--#-#--#-#
--#----#----#----#----#----#----#----#----#----#----#----#----#----#----#----#----#----#----#----#--
----#----#----#----#----#----#----#----#----#----#----#----#----#----#----#----#----#----#----#----#
-#----#----#----#----#----#----#----#----#----#----#----#----#----#----#----#----#----#----#----#---
-#----#----#----#----#----#----#----#----#----#----#----#----#----#----#----#----#----#----#----#---
--#-#--#-#--#-#--#-#--#-#--#-#--#-#--#-#--#-#--#-#--#-#--#-#--#-#--#-#--#-#--#-#--#-#--#-#--#-#--#-#
--#----#----#----#----#----#----#----#----#----#----#----#----#----#----#----#----#----#----#----#--
----#----#----#----#----#----#----#----#----#----#----#----#----#----#----#----#----#----#----#----#
-#----#----#----#----#----#----#----#----#----#----#----#----#----#----#----#----#----#----#----#---
-#----#----#----#----#----#----#----#----#----#----#----#----#----#----#----#----#----#----#----#---
--#-#--#-#--#-#--#-#--#-#--#-#--#-#--#-#--#-#--#-#--#-#--#-#--#-#--#-#--#-#--#-#--#-#--#-#--#-#--#-#
--#----#----#----#----#----#----#----#----#----#----#----#----#----#----#----#----#----#----#----#--
----#----#----#----#----#----#----#----#----#----#----#----#----#----#----#S---#----#----#----#----#
-#----#----#----#----#----#----#----#----#----#----#----#----#----#----#----#----#----#----#----#---
-#----#----#----#----#----#----#----#----#----#----#----#----#----#----#----#----#----#----#----#---
--#-#--#-#--#-#--#-#--#-#--#-#--#-#--#-#--#-#--#-#--#-#--#-#--#-#--#-#--#-#--#-#--#-#--#-#--#-#--#-#
--#----#----#----#----#----#----#----#----#----#----#----#----#----#----#----#----#----#----#----#--
----#----#----#----#----#----#----#----#----#----#----#----#----#----#----#----#----#----#----#----#
-#----#----#----#----#----#----#----#----#----#----#----#----#----#----#----#----#----#----#----#---
-#----#----#----#----#----#----#----#----#----#----#----#----#----#----#----#----#----#----#----#---
--#-#--#-#--#-#--#-#--#-#--#-#--#-#--#-#--#-#--#-#--#-#--#-#--#-#--#-#--#-#--#-#--#-#--#-#--#-#--#-#
--#----#----#----#----#----#----#----#----#----#----#----#----#----#----#----#----#----#----#----#--
----#----#----#----#----#----#----#----#----#----#----#----#----#----#----#----#----#----#----#----#
-#----#----#----#----#----#----#----#----#----#----#----#----#----#----#----#----#----#----#----#---
-#----#----#----#----#----#----#----#----#----#----#----#----#----#----#----#----#----#----#----#---
--#-#--#-#--#-#--#-#--#-#--#-#--#-#--#-#--#-#--#-#--#-#--#-#--#-#--#-#--#-#--#-#--#-#--#-#--#-#--#-#