?diagonal=Always;
-------------E--------------------------------------------------------------------------------------
----------------------------------------------------------------------------------------------------
#-##-#-##-#-##-#-##-#-##-#-##-#-##-#-##-#-##-#-##-#-##-#-##-#-##-#-##-#-##-#-##-#-##-#-##-#-##-#-##-
#---##---##---##---##---##---##---##---##---##---##---##---##---##---##---##---##---##---##---##---#
--#-#--#-#--#-#--#-#--#-#--#-#--#-#--#-#--#-#--#-#--#-#--#-#--#-#--#-#--#-#--#-#--#-#--#-#--#-#--#-#
----------------------------------------------------------------------------------------------------
----------------------------------------------------------------------------------------------------
#-##-#-##-#-##-#-##-#-##-#-##-#-##-#-##-#-##-#-##-#-##-#-##-#-##-#-##-#-##-#-##-#-##-#-##-#-##-#-##-
#---##---##---##---##---##---##---##---##---##---##---##---##---##---##---##---##---##---##---##---#
--#-#--#-#--#-#--#-#--#-#--#-#--#-#--#-#--#-#--#-#--#-#--#-#--#-#--#-#--#-#--#-#--#-#--#-#--#-#--#-#
----------------------------------------------------------------------------------------------------
----------------------------------------------------------------------------------------------------
#-##-#-##-#-##-#-##-#-##-#-##-#-##-#-##-#-##-#-##-#-##-#-##-#-##-#-##-#-##-#-##-#-##-#-##-#-##-#-##-
#---##---##---##---##---##---##---##---##---##---##---##---##---##---##---##---##---##---##---##---#
--#-#--#-#--#-#--#-#--#-#--#-#--#-#--#-#--#-#--#-#--#-#--#-#--#-#--#-#--#-#--#-#--#-#--#-#--#-#--#-#
----------------------------------------------------------------------------------------------------
----------------------------------------------------------------------------------------------------
#-##-#-##-#-##-#-##-#-##-#-##-#-##-#-##-#-##-#-##-#-##-#-##-#-##-#-##-#-##-#-##-#-##-#-##-#-##-#-##-
#---##---##---##---##---##---##---##---##---##---##---##---##---##---##---##---##---##---##---##---#
--#-#--#-#--#-#--#-#--#-#--#-#--#-#--#-#--#-#--#-#--#-#--#-#--#-#--#-#--#-#--#-#--#-#--#-#--#-#--#-#
----------------------------------------------------------------------------------------------------
----------------------------------------------------------------------------------------------------
#-##-#-##-#-##-#-##-#-##-#-##-#-##-#-##-#-##-#-##-#-##-#-##-#-##-#-##-#-##-#-##-#-##-#-##-#-##-#-##-
#---##---##---##---##---##---##---##---##---##---##---##---##---##---##---##---##---##---##---##---#
--#-#--#-#--#-#--#-#--#-#--#-#--#-#--#-#--#-#--#-#--#-#--#-#--#-#--#-#--#-#--#-#--#-#--#-#--#-#--#-#
----------------------------------------------------------------------------------------------------
----------------------------------------------------------------------------------------------------
#-##-#-##-#-##-#-##-#-##-#-##-#-##-#-##-#-##-#-##-#-##-#-##-#-##-#-##-#-##-#-##-#-##-#-##-#-##-#-##-
#---##---##---##---##---##---##---##---##---##---##---##---##---##---##---##---##---##---##---##---#
--#-#--#-#--#-#--#-#--#-#--#-#--#-#--#-#--#-#--#-#--#-#--#-#--#-#--#-#--#-#--#-#--#-#--#-#--#-#--#-#
----------------------------------------------------------------------------------------------------
----------------------------------------------------------------------------------------------------
#-##-#-##-#-##-#-##-#-##-#-##-#-##-#-##-#-##-#-##-#-##-#-##-#-##-#-##-#-##-#-##-#-##-#-##-#-##-#-##-
#---##---##---##---##---##---##---##---##---##---##---##---##---##---##---##---##---##---##---##---#
--#-#--#-#--#-#--#-#--#-#--#-#--#-#--#-#--#-#--#-#--#-#--#-#--#-#--#-#--#-#--#-#--#-#--#-#--#-#--#-#
----------------------------------------------------------------------------------------------------
----------------------------------------------------------------------------------------------------
#-##-#-##-#-##-#-##-#-##-#-##-#-##-#-##-#-##-#-##-#-##-#-##-#-##-#-##-#-##-#-##-#-##-#-##-#-##-#-##-
#---##---##---##---##---##---##---##---##---##---##---##---##---##---##---##---##---##---##---##---#
--#-#--#-#--#-#--#-#--#-#--#-#--#-#--#-#--#-#--#-#--#-#--#-#--#-#--#-#--#-#--#-#--#-#--#-#--#-#--#-#
----------------------------------------------------------------------------------------------------
----------------------------------------------------------------------------------------------------
#-##-#-##-#-##-#-##-#-##-#-##-#-##-#-##-#-##-#-##-#-##-#-##-#-##-#-##-#-##-#-##-#-##-#-##-#-##-#-##-
#---##---##---##---##---##---##---##---##---##---##---##---##---##---##---##---##---##---##---##---#
--#-#--#-#--#-#--#-#--#-#--#-#--#-#--#-#--#-#--#-#--#-#--#-#--#-#--#-#--#-#--#-#--#-#--#-#--#-#--#-#
----------------------------------------------------------------------------------------------------
----------------------------------------------------------------------------------------------------
#-##-#-##-#-##-#-##-#-##-#-##-#-##-#-##-#-##-#-##-#-##-#-##-#-##-#-##-#-##-#-##-#-##-#-##-#-##-#-##-
#---##---##---##---##---##---##---##---##---##---##---##---##---##---##---##---##---##---##---##---#
--#-#--#-#--#-#--#-#--#-#--#-#--#-#--#-#--#-#--#-#--#-#--#-#--#-#--#-#--#-#--#-#--#-#--#-#--#-#--#-#
----------------------------------------------------------------------------------------------------
----------------------------------------------------------------------------------------------------
#-##-#-##-#-##-#-##-#-##-#-##-#-##-#-##-#-##-#-##-#-##-#-##-#-##-#-##-#-##-#-##-#-##-#-##-#-##-#-##-
#---##---##---##---##---##---##---##---##---##---##---##---##---##---##---##---##---##---##---##---#
--#-#--#-#--#-#--#-#--#-#--#-#--#-#--#-#--#-#--#-#--#-#--#-#--#-#--#-#--#-#--#-#--#-#--#-#--#-#--#-#
----------------------------------------------------------------------------------------------------
----------------------------------------------------------------------------------------------------
#-##-#-##-#-##-#-##-#-##-#-##-#-##-#-##-#-##-#-##-#-##-#-##-#-##-#-##-#-##-#-##-#-##-#-##-#-##-#-##-
#---##---##---##---##---##---##---##---##---##---##---##---##---##---##---##---##---##---##---##---#
--#-#--#-#--#-#--#-#--#-#--#-#--#-#--#-#--#-#--#-#--#-#--#-#--#-#--#-#--#-#--#-#--#-#--#-#--#-#--#-#
----------------------------------------------------------------------------------------------------
----------------------------------------------------------------------------------------------------
#-##-#-##-#-##-#-##-#-##-#-##-#-##-#-##-#-##-#-##-#-##-#-##-#-##-#-##-#-##-#-##-#-##-#-##-#-##-#-##-
#---##---##---##---##---##---##---##---##---##---##---##---##---##---##---##---##---##---##---##---#
--#-#--#-#--#-#--#-#--#-#--#-#--#-#--#-#--#-#--#-#--#-#--#-#--#-#--#-#--#-#--#-#--#-#--#-#--#-#--#-#
----------------------------------------------------------------------------------------------------
----------------------------------------------------------------------------------------------------
#-##-#-##-#-##-#-##-#-##-#-##-#-##-#-##-#-##-#-##-#-##-#-##-#-##-#-##-#-##-#-##-#-##-#-##-#-##-#-##-
#---##---##---##---##---##---##---##---##---##---##---##---##---##---##---##---##---##---##---##---#
--#-#--#-#--#-#--#-#--#-#--#-#--#-#--#-#--#-#--#-#--#-#--#-#--#-#--#-#--#-#--#-#--#-#--#-#--#-#--#-#
----------------------------------------------------------------------------------------------------
----------------------------------------------------------------------------------------------------
#-##-#-##-#-##-#-##-#-##-#-##-#-##-#-##-#-##-#-##-#-##-#-##-#-##-#-##-#-##-#-##-#-##-#-##-#-##-#-##-
#---##---##---##---##---##---##---##---##---##---##---##---##---##---##---##---##---##---##---##---#
--#-#--#-#--#-#--#-#--#-#--#-#--#-#--#-#--#-#--#-#--#-#--#-#--#-#--#-#--#-#--#-#--#-#--#-#--#-#--#-#
----------------------------------------------------------------------------------------------------
----------------------------------------------------------------------------------------------------
#-##-#-##-#-##-#-##-#-##-#-##-#-##-#-##-#-##-#-##-#-##-#-##-#-##-#-##-#-##-#-##-#-##-#-##-#-##-#-##-
#---##---##---##---##---##---##---##---##---##---##---##---##---##---##---##---##---##---##---##---#
--#-#--#-#--#-#--#-#--#-#--#-#--#-#--#-#--#-#--#-#--#-#--#-#--#-#--#-#--#-#--#-#--#-#--#-#--#-#--#-#
--------------------------------------------------------------------------------------------------S-
----------------------------------------------------------------------------------------------------
#-##-#-##-#-##-#-##-#-##-#-##-#-##-#-##-#-##-#-##-#-##-#-##-#-##-#-##-#-##-#-##-#-##-#-##-#-##-#-##-
#---##---##---##---##---##---##---##---##---##---##---##---##---##---##---##---##---##---##---##---#
--#-#--#-#--#-#--#-#--#-#--#-#--#-#--#-#--#-#--#-#--#-#--#-#--#-#--#-#--#-#--#-#--#-#--#-#--#-#--#-#
----------------------------------------------------------------------------------------------------
----------------------------------------------------------------------------------------------------
#-##-#-##-#-##-#-##-#-##-#-##-#-##-#-##-#-##-#-##-#-##-#-##-#-##-#-##-#-##-#-##-#-##-#-##-#-##-#-##-
#---##---##---##---##---##---##---##---##---##---##---##---##---##---##---##---##---##---##---##---#
--#-#--#-#--#-#--#-#--#-#--#-#--#-#--#-#--#-#--#-#--#-#--#-#--#-#--#-#--#-#--#-#--#-#--#-#--#-#--#-#
----------------------------------------------------------------------------------------------------
----------------------------------------------------------------------------------------------------
#-##-#-##-#-##-#-##-#-##-#-##-#-##-#-##-#-##-#-##-#-##-#-##-#-##-#-##-#-##-#-##-#-##-#-##-#-##-#-##-
#---##---##---##---##---##---##---##---##---##---##---##---##---##---##---##---##---##---##---##---#
--#-#--#-#--#-#--#-#--#-#--#-#--#-#--#-#--#-#--#-#--#-#--#-#--#-#--#-#--#-#--#-#--#-#--#-#--#-#--#-#
----------------------------------------------------------------------------------------------------
----------------------------------------------------------------------------------------------------
#-##-#-##-#-##-#-##-#-##-#-##-#-##-#-##-#-##-#-##-#-##-#-##-#-##-#-##-#-##-#-##-#-##-#-##-#-##-#-##-
#---##---##---##---##---##---##---##---##---##---##---##---##---##---##---##---##---##---##---##---#
--#-#--#-#--#-#--#-#--#-#--#-#--#-#--#-#--#-#--#-#--#-#--#-#--#-#--#-#--#-#--#-#--#-#--#-#--#-#--#-#