?diagonal=Always;
#--###--###--###--###--###--###--###--###--###--###--###--###--###--###--###--###--###--###--###--##
---#----#----#----#----#----#----#----#----#----#----#----#----#----#----#----#----#----#----#----#-
----#----#----#----#----#----#----#----#----#----#----#----#----#----#----#----#----#----#----#----#
----------------------------------------------------------------------------------------------------
##---##---##---##---##---##---##---##---##---##---##---##---##---##---##---##---##---##---##---##---
#--###--###--###--###--###--###--###--###--###--###--###--###--###--###--###--###--###--###--###--##
---#----#----#----#----#----#----#----#----#----#----#----#----#----#----#----#----#----#----#----#-
----#----#----#----#----#----#----#----#----#----#----#----#----#----#----#----#----#----#----#----#
----------------------------------------------------------------------------------------------------
##---##---##---##---##---##---##---##---##---##---##---##---##---##---##---##---##---##---##---##---
#--###--###--###--###--###--###--###--###--###--###--###--###--###--###--###--###--###--###--###--##
---#----#----#----#----#----#----#----#----#----#----#----#----#----#----#----#----#----#----#----#-
----#----#----#----#----#----#----#----#----#----#----#----#----#----#----#----#----#----#----#----#
----------------------------------------------------------------------------------------------------
##---##---##---##---##---##---##---##---##---##---##---##---##---##---##---##---##---##---##---##---
#--###--###--###--###--###--###--###--###--###--###--###--###--###--###--###--###--###--###--###--##
---#----#----#----#----#----#----#----#----#----#----#----#----#----#----#----#----#----#----#----#-
----#----#----#----#----#----#----#----#----#----#----#----#----#----#----#----#----#----#----#----#
----------------------------------------------------------------------------------------------------
##---##---##---##---##---##---##---##---##---##---##---##---##---##---##---##---##---##---##---##---
#--###--###--###--###--###--###--###--###--###--###--###--###--###--###--###--###--###--###--###--##
---#----#----#----#----#----#----#----#----#----#----#----#----#----#----#----#----#----#----#----#-
----#----#----#----#----#----#----#----#----#----#----#----#----#----#----#----#----#----#----#----#
----------------------------------------------------------------------------------------------------
##---##---##---##---##---##---##---##---##---##---##---##---##---##---##---##---##---##---##---##---
#--###--###--###--###--###--###--###--###--###--###--###--###--###--###--###--###--###--###--###--##
---#----#E---#----#----#----#----#----#----#----#----#----#----#----#----#----#----#----#----#----#-
----#----#----#----#----#----#----#----#----#----#----#----#----#----#----#----#----#----#----#----#
----------------------------------------------------------------------------------------------------
##---##---##---##---##---##---##---##---##---##---##---##---##---##---##---##---##---##---##---##---
#--###--###--###--###--###--###--###--###--###--###--###--###--###--###--###--###--###--###--###--##
---#----#----#----#----#----#----#----#----#----#----#----#----#----#----#----#----#----#----#----#-
----#----#----#----#----#----#----#----#----#----#----#----#----#----#----#----#----#----#----#----#
----------------------------------------------------------------------------------------------------
##---##---##---##---##---##---##---##---##---##---##---##---##---##---##---##---##---##---##---##---
#--###--###--###--###--###--###--###--###--###--###--###--###--###--###--###--###--###--###--###--##
---#----#----#----#----#----#----#----#----#----#----#----#----#----#----#----#----#----#----#----#-
----#----#----#----#----#----#----#----#----#----#----#----#----#----#----#----#----#----#----#----#
----------------------------------------------------------------------------------------------------
##---##---##---##---##---##---##---##---##---##---##---##---##---##---##---##---##---##---##---##---
#--###--###--###--###--###--###--###--###--###--###--###--###--###--###--###--###--###--###--###--##
---#----#----#----#----#----#----#----#----#----#----#----#----#----#----#----#----#----#----#----#-
----#----#----#----#----#----#----#----#----#----#----#----#----#----#----#----#----#----#----#----#
----------------------------------------------------------------------------------------------------
##---##---##---##---##---##---##---##---##---##---##---##---##---##---##---##---##---##---##---##---
#--###--###--###--###--###--###--###--###--###--###--###--###--###--###--###--###--###--###--###--##
---#----#----#----#----#----#----#----#----#----#----#----#----#----#----#----#----#----#----#----#-
----#----#----#----#----#----#----#----#----#----#----#----#----#----#----#----#----#----#----#----#
----------------------------------------------------------------------------------------------------
##---##---##---##---##---##---##---##---##---##---##---##---##---##---##---##---##---##---##---##---
#--###--###--###--###--###--###--###--###--###--###--###--###--###--###--###--###--###--###--###--##
---#----#----#----#----#----#----#----#----#----#----#----#----#----#----#----#----#----#----#----#-
----#----#----#----#----#----#----#----#----#----#----#----#----#----#----#----#----#----#----#----#
----------------------------------------------------------------------------------------------------
##---##---##---##---##---##---##---##---##---##---##---##---##---##---##---##---##---##---##---##---
#--###--###--###--###--###--###--###--###--###--###--###--###--###--###--###--###--###--###--###--##
---#----#----#----#----#----#----#----#----#----#----#----#----#----#----#----#----#----#----#----#-
----#----#----#----#----#----#----#----#----#----#----#----#----#----#----#----#----#----#----#----#
----------------------------------------------------------------------------------------------------
##---##---##---##---##---##---##---##---##---##---##---##---##---##---##---##---##---##---##---##---
#--###--###--###--###--###--###--###--###--###--###--###--###--###--###--###--###--###--###--###--##
---#----#----#----#----#----#----#----#----#----#----#----#----#----#----#----#----#----#----#----#-
----#----#----#----#----#----#----#----#----#----#----#----#----#----#----#----#----#----#----#----#
----------------------------------------------------------------------------------------------------
##---##---##---##---##---##---##---##---##---##---##---##---##---##---##---##---##---##---##---##---
#--###--###--###--###--###--###--###--###--###--###--###--###--###--###--###--###--###--###--###--##
---#----#----#----#----#----#----#----#----#----#----#----#----#----#----#----#----#----#----#----#-
----#----#----#----#----#----#----#----#----#----#----#----#----#----#----#----#----#----#----#----#
----------------------------------------------------------------------------------------------------
##---##---##---##---##---##---##---##---##---##---##---##---##---##---##---##---##---##---##---##---
#--###--###--###--###--###--###--###--###--###--###--###--###--###--###--###--###--###--###--###--##
---#----#----#----#----#----#----#----#----#----#----#----#----#----#----#----#----#----#----#----#-
----#----#----#----#----#----#----#----#----#----#----#----#----#----#----#----#----#----#----#----#
----------------------------------------------------------------------------------------------------
##---##---##---##---##---##---##---##---##---##---##---##---##---##---##---##---##---##---##---##---
#--###--###--###--###--###--###--###--###--###--###--###--###--###--###--###--###--###--###--###--##
---#----#----#----#----#----#----#----#----#----#----#----#----#----#----#----#----#----#----#----#-
----#----#----#----#----#----#----#----#----#----#----#----#----#----#----#----#----#----#----#----#
----------------------------------------------------------------------------------------------------
##---##---##---##---##---##---##---##---##---##---##---##---##---##---##---##---##---##---##---##---
#--###--###--###--###--###--###--###--###--###--###--###--###--###--###--###--###--###--###--###--##
---#----#----#----#----#----#----#----#----#----#----#----#----#----#----#----#----#----#----#----#-
----#----#----#----#----#----#----#----#----#----#----#----#----#----#----#----#----#----#----#----#
----------------------------------------------------------------------------------------------------
##---##---##---##---##---##---##---##---##---##---##---##---##---##---##---##---##---##---##---##---
#--###--###--###--###--###--###--###--###--###--###--###--###--###--###--###--###--###--###--###--##
---#----#----#----#----#----#----#----#----#----#----#----#----#----#----#----#----#----#----#----#S
----#----#----#----#----#----#----#----#----#----#----#----#----#----#----#----#----#----#----#----#
----------------------------------------------------------------------------------------------------
##---##---##---##---##---##---##---##---##---##---##---##---##---##---##---##---##---##---##---##---
#--###--###--###--###--###--###--###--###--###--###--###--###--###--###--###--###--###--###--###--##
---#----#----#----#----#----#----#----#----#----#----#----#----#----#----#----#----#----#----#----#-
----#----#----#----#----#----#----#----#----#----#----#----#----#----#----#----#----#----#----#----#
----------------------------------------------------------------------------------------------------
##---##---##---##---##---##---##---##---##---##---##---##---##---##---##---##---##---##---##---##---
#--###--###--###--###--###--###--###--###--###--###--###--###--###--###--###--###--###--###--###--##
---#----#----#----#----#----#----#----#----#----#----#----#----#----#----#----#----#----#----#----#-
----#----#----#----#----#----#----#----#----#----#----#----#----#----#----#----#----#----#----#----#
----------------------------------------------------------------------------------------------------
##---##---##---##---##---##---##---##---##---##---##---##---##---##---##---##---##---##---##---##---