?diagonal=Always;
----#----#----#----#----#----#----#----#----#----#----#----#----#----#----#----#----#----#----#----#
----------------------------------------------------------------------------------------------------
-##-#-##-#-##-#-##-#-##-#-##-#-##-#-##-#-##-#-##-#-##-#-##-#-##-#-##-#-##-#-##-#-##-#-##-#-##-#-##-#
--##---##---##---##---##---##---##---##---##---##---##---##---##---##---##---##---##---##---##---##-
----#----#----#----#----#----#----#----#----#----#----#----#----#----#----#----#----#----#----#----#
----#----#----#----#----#----#----#----#----#----#----#----#----#----#----#----#----#----#----#----#
----------------------------------------------------------------------------------------------------
-##-#-##-#-##-#-##-#-##-#-##-#-##-#-##-#-##-#-##-#-##-#-##-#-##-#-##-#-##-#-##-#-##-#-##-#-##-#-##-#
--##---##---##---##---##---##---##---##---##---##---##---##---##---##---##---##---##---##---##---##-
----#----#----#----#----#----#----#----#----#----#----#----#----#----#----#----#----#----#----#----#
----#----#----#----#----#----#----#----#----#----#----#----#----#----#----#----#----#----#----#----#
----------------------------------------------------------------------------------------------------
-##-#-##-#-##-#-##-#-##-#-##-#-##-#-##-#-##-#-##-#-##-#-##-#-##-#-##-#-##-#-##-#-##-#-##-#-##-#-##-#
--##---##---##---##---##---##---##---##---##---##---##---##---##---##---##---##---##---##---##---##-
----#----#----#----#----#----#----#----#----#----#----#----#----#----#----#----#----#----#----#----#
----#----#----#----#----#----#----#----#----#----#----#----#----#----#----#----#----#----#----#----#
----------------------------------------------------------------------------------------------------
-##-#-##-#-##-#-##-#-##-#-##-#-##-#-##-#-##-#-##-#-##-#-##-#-##-#-##-#-##-#-##-#-##-#-##-#-##-#-##-#
--##---##---##---##---##---##---##---##---##---##---##---##---##---##---##---##---##---##---##---##-
----#----#----#----#----#----#----#----#----#----#----#----#----#----#----#----#----#----#----#----#
----#----#----#----#----#----#----#----#----#----#----#----#----#----#----#----#----#----#----#----#
----------------------------------------------------------------------------------------------------
-##-#-##-#-##-#-##-#-##-#-##-#-##-#-##-#-##-#-##-#-##-#-##-#-##-#-##-#-##-#-##-#-##-#-##-#-##-#-##-#
--##---##---##---##---##---##---##---##---##---##---##---##---##---##---##---##---##---##---##---##-
----#----#----#----#----#----#----#----#----#----#----#----#----#----#----#----#----#----#----#----#
----#----#----#----#----#----#----#----#----#----#----#----#----#----#----#----#----#----#----#----#
----------------------------------------------------------------------------------------------------
-##-#-##-#-##-#-##-#-##-#-##-#-##-#-##-#-##-#-##-#-##-#-##-#-##-#-##-#-##-#-##-#-##-#-##-#-##-#-##-#
--##---##---##---##---##---##---##---##---##---##---##---##---##---##---##---##---##---##---##---##-
----#----#----#----#----#----#----#----#----#----#----#----#----#----#----#----#----#----#----#----#
----#----#----#----#----#----#----#----#----#----#----#----#----#----#----#----#----#----#----#----#
----------------------------------------------------------------------------------------------------
-##-#-##-#-##-#-##-#-##-#-##-#-##-#-##-#-##-#-##-#-##-#-##-#-##-#-##-#-##-#-##-#-##-#-##-#-##-#-##-#
--##---##---##---##---##---##---##---##---##---##---##---##---##---##---##---##---##---##---##---##-
----#----#----#----#----#----#----#----#----#----#----#----#----#----#----#----#----#----#----#----#
----#----#----#----#----#----#----#----#----#----#----#----#----#----#----#----#----#----#----#----#
----------------------------------------------------------------------------------------------------
-##-#-##-#-##-#-##-#-##E#-##-#-##-#-##-#-##-#-##-#-##-#-##-#-##-#-##-#-##-#-##-#-##-#-##-#-##-#-##-#
--##---##---##---##---##---##---##---##---##---##---##---##---##---##---##---##---##---##---##---##-
----#----#----#----#----#----#----#----#----#----#----#----#----#----#----#----#----#----#----#----#
----#----#----#----#----#----#----#----#----#----#----#----#----#----#----#----#----#----#----#----#
----------------------------------------------------------------------------------------------------
-##-#-##-#-##-#-##-#-##-#-##-#-##-#-##-#-##-#-##-#-##-#-##-#-##-#-##-#-##-#-##-#-##-#-##-#-##-#-##-#
--##---##---##---##---##---##---##---##---##---##---##---##---##---##---##---##---##---##---##---##-
----#----#----#----#----#----#----#----#----#----#----#----#----#----#----#----#----#----#----#----#
----#----#----#----#----#----#----#----#----#----#----#----#----#----#----#----#----#----#----#----#
----------------------------------------------------------------------------------------------------
-##-#-##-#-##-#-##-#-##-#-##-#-##-#-##-#-##-#-##-#-##-#-##-#-##-#-##-#-##-#-##-#-##-#-##-#-##-#-##-#
--##---##---##---##---##---##---##---##---##---##---##---##---##---##---##---##---##---##---##---##-
----#----#----#----#----#----#----#----#----#----#----#----#----#----#----#----#----#----#----#----#
----#----#----#----#----#----#----#----#----#----#----#----#----#----#----#----#----#----#----#----#
----------------------------------------------------------------------------------------------------
-##-#-##-#-##-#-##-#-##-#-##-#-##-#-##-#-##-#-##-#-##-#-##-#-##-#-##-#-##-#-##-#-##-#-##-#-##-#-##-#
--##---##---##---##---##---##---##---##---##---##---##---##---##---##---##---##---##---##---##---##-
----#----#----#----#----#----#----#----#----#----#----#----#----#----#----#----#----#----#----#----#
----#----#----#----#----#----#----#----#----#----#----#----#----#----#----#----#----#----#----#----#
----------------------------------------------------------------------------------------------------
-##-#-##-#-##-#-##-#-##-#-##-#-##-#-##-#-##-#-##-#-##-#-##-#-##-#-##-#-##-#-##-#-##-#-##-#-##-#-##-#
--##---##---##---##---##---##---##---##---##---##---##---##---##---##---##---##---##---##---##---##-
----#----#----#----#----#----#----#----#----#----#----#----#----#----#----#----#----#----#----#----#
----#----#----#----#----#----#----#----#----#----#----#----#----#----#----#----#----#----#----#----#
----------------------------------------------------------------------------------------------------
-##-#-##-#-##-#-##-#-##-#-##-#-##-#-##-#-##-#-##-#-##-#-##-#-##-#-##-#-##-#-##-#-##-#-##-#-##-#-##-#
--##---##---##---##---##---##---##---##---##---##---##---##---##---##---##---##---##---##---##---##-
----#----#----#----#----#----#----#----#----#----#----#----#----#----#----#----#----#----#----#----#
----#----#----#----#----#----#----#----#----#----#----#----#----#----#----#----#----#----#----#----#
----------------------------------------------------------------------------------------------------
-##-#-##-#-##-#-##-#-##-#-##-#-##-#-##-#-##-#-##-#-##-#-##-#-##-#-##-#-##-#-##-#-##-#-##-#-##-#-##-#
--##---##---##---##---##---##---##---##---##---##---##---##---##---##---##---##---##---##---##---##-
----#----#----#----#----#----#----#----#----#----#----#----#----#----#----#----#----#----#----#----#
----#----#----#----#----#----#----#----#----#----#----#----#----#----#----#----#----#----#----#----#
----------------------------------------------------------------------------------------------------
-##-#-##-#-##-#-##-#-##-#-##-#-##-#-##-#-##-#-##-#-##-#-##-#-##-#-##-#-##-#-##-#-##-#-##-#-##-#-##-#
--##---##---##---##---##---##---##---##---##---##---##---##---##---##---##---##---##---##---##---##-
----#----#----#----#----#----#----#----#----#----#----#----#----#----#----#----#----#----#----#----#
----#----#----#----#----#----#----#----#----#----#----#----#----#----#----#----#----#----#----#----#
----------------------------------------------------------------------------------------------------
-##-#-##-#-##-#-##-#-##-#-##-#-##-#-##-#-##-#-##-#-##-#-##-#-##-#-##-#-##-#-##-#-##-#-##-#-##-#-##-#
--##---##---##---##---##---##---##---##---##---##---##---##---##---##---##---##---##---##---##---##-
----#----#----#----#----#----#----#----#----#----#----#----#----#----#----#----#----#----#----#----#
----#----#----#----#----#----#----#----#----#----#----#----#----#----#----#----#----#----#----#----#
----------------------------------------------------------------------------------------------------
-##-#-##-#-##-#-##-#-##-#-##-#-##-#-##-#-##-#-##-#-##-#-##-#-##-#-##-#-##-#-##-#-##-#-##-#-##-#-##-#
--##---##---##---##---##---##---##---##---##---##---##---##---##---##---##---##---##---##---##---##-
----#----#----#----#----#----#----#----#----#----#----#----#----#----#----#----#----#----#----#----#
----#----#----#----#----#----#----#----#----#----#----#----#----#----#----#----#----#----#----#----#
----------------------------------------------------------------------------------------------------
-##-#-##-#-##-#-##-#-##-#-##-#-##-#-##-#-##-#-##-#-##-#-##-#-##-#-##-#-##-#-##-#-##-#-##-#-##-#-##-#
--##---##---##---##---##---##---##---##---##---##---##---##---##---##---##---##---##---##---##---##-
----#----#----#----#----#----#----#----#----#----#----#----#----#----#----#----#----#----#----#----#
----#----#----#----#----#----#----#----#----#----#----#----#----#----#----#----#----#----#----#----#
----------------------------------------------------------------------------------------------------
-##-#-##-#-##-#-##-#-##-#-##-#-##-#-##-#-##-#-##-#-##-#-##-#-##-#-##-#-##-#-##-#-##-#-##-#-##-#-##-#
--##---##---##---##---##---##---##---##---##---##---##---##---##---##---##---##---##---##---##---##-
----#-S--#----#----#----#----#----#----#----#----#----#----#----#----#----#----#----#----#----#----#
----#----#----#----#----#----#----#----#----#----#----#----#----#----#----#----#----#----#----#----#
----------------------------------------------------------------------------------------------------
-##-#-##-#-##-#-##-#-##-#-##-#-##-#-##-#-##-#-##-#-##-#-##-#-##-#-##-#-##-#-##-#-##-#-##-#-##-#-##-#
--##---##---##---##---##---##---##---##---##---##---##---##---##---##---##---##---##---##---##---##-
----#----#----#----#----#----#----#----#----#----#----#----#----#----#----#----#----#----#----#----#