?diagonal=Never;
----------------------------------------------------------------------------------------------------
----------------------------------------------------------------------------------------------------
-#----#----#----#----#----#----#----#----#----#----#----#----#----#----#----#----#----#----#----#---
#-#--#-#--#-#--#-#--#-#--#-#--#-#--#-#--#-#--#-#--#-#--#-#--#-#--#-#--#-#--#-#--#-#--#-#--#-#--#-#--
###-####-####-####-####-####-####-####-####-####-####-####-####-####-####-####-####-####-####-####-#
----------------------------------------------------------------------------------------------------
----------------------------------------------------------------------------------------------------
-#----#----#----#----#----#----#----#----#----#----#----#----#----#----#----#----#----#----#----#---
#-#--#-#--#-#--#-#--#-#--#-#--#-#--#-#--#-#--#-#--#-#--#-#--#-#--#-#--#-#--#-#--#-#--#-#--#-#--#-#--
###-####-####-####-####-####-####-####-####-####-####-####-####-####-####-####-####-####-####-####-#
----------------------------------------------------------------------------------------------------
----------------------------------------------------------------------------------------------------
-#----#----#----#----#----#----#----#----#----#----#----#----#----#----#----#----#----#----#----#---
#-#--#-#--#-#--#-#--#-#--#-#--#-#--#-#--#-#--#-#--#-#--#-#--#-#--#-#--#-#--#-#--#-#--#-#--#-#--#-#--
###-####-####-####-####-####-####-####-####-####-####-####-####-####-####-####-####-####-####-####-#
----------------------------------------------------------------------------------------------------
----------------------------------------------------------------------------------------------------
-#----#----#----#----#----#----#----#----#----#----#----#----#----#----#----#----#----#----#----#---
#-#--#-#--#-#--#-#--#-#--#-#--#-#--#-#--#-#--#-#--#-#--#-#--#-#--#-#--#-#--#-#--#-#--#-#--#-#--#-#--
###-####-####-####-####-####-####-####-####-####-####-####-####-####-####-####-####-####-####-####-#
----------------------------------------------------------------------------------------------------
----------------------------------------------------------------------------------------------------
-#----#----#----#----#----#----#----#----#----#----#----#----#----#----#----#----#----#----#----#---
#-#--#-#--#-#--#-#--#-#--#-#--#-#--#-#--#-#--#-#--#-#--#-#--#-#--#-#--#-#--#-#--#-#--#-#--#-#--#-#--
###-####-####-####-####-####-####-####-####-####-####-####-####-####-####-####-####-####-####-####-#
----------------------------------------------------------------------------------------------------
----------------------------------------------------------------------------------------------------
-#----#----#----#----#----#----#----#----#----#----#----#----#----#----#----#----#----#----#----#---
#-#--#-#--#-#--#-#--#-#--#-#--#-#--#-#--#-#--#-#--#-#--#-#--#-#--#-#--#-#--#-#--#-#--#-#--#-#--#-#--
###-####-####-####-####-####-####-####-####-####-####-####-####-####-####-####-####-####-####-####-#
----------------------------------------------------------------------------------------------------
-----------------------------------------------S----------------------------------------------------
-#----#----#----#----#----#----#----#----#----#----#----#----#----#----#----#----#----#----#----#---
#-#--#-#--#-#--#-#--#-#--#-#--#-#--#-#--#-#--#-#--#-#--#-#--#-#--#-#--#-#--#-#--#-#--#-#--#-#--#-#--
###-####-####-####-####-####-####-####-####-####-####-####-####-####-####-####-####-####-####-####-#
----------------------------------------------------------------------------------------------------
----------------------------------------------------------------------------------------------------
-#----#----#----#----#----#----#----#----#----#----#----#----#----#----#----#----#----#----#----#---
#-#--#-#--#-#--#-#--#-#--#-#--#-#--#-#--#-#--#-#--#-#--#-#--#-#--#-#--#-#--#-#--#-#--#-#--#-#--#-#--
###-####-####-####-####-####-####-####-####-####-####-####-####-####-####-####-####-####-####-####-#
----------------------------------------------------------------------------------------------------
----------------------------------------------------------------------------------------------------
-#----#----#----#----#----#----#----#----#----#----#----#----#----#----#----#----#----#----#----#---
#-#--#-#--#-#--#-#--#-#--#-#--#-#--#-#--#-#--#-#--#-#--#-#-E#-#--#-#--#-#--#-#--#-#--#-#--#-#--#-#--
###-####-####-####-####-####-####-####-####-####-####-####-####-####-####-####-####-####-####-####-#
----------------------------------------------------------------------------------------------------
----------------------------------------------------------------------------------------------------
-#----#----#----#----#----#----#----#----#----#----#----#----#----#----#----#----#----#----#----#---
#-#--#-#--#-#--#-#--#-#--#-#--#-#--#-#--#-#--#-#--#-#--#-#--#-#--#-#--#-#--#-#--#-#--#-#--#-#--#-#--
###-####-####-####-####-####-####-####-####-####-####-####-####-####-####-####-####-####-####-####-#
----------------------------------------------------------------------------------------------------
----------------------------------------------------------------------------------------------------
-#----#----#----#----#----#----#----#----#----#----#----#----#----#----#----#----#----#----#----#---
#-#--#-#--#-#--#-#--#-#--#-#--#-#--#-#--#-#--#-#--#-#--#-#--#-#--#-#--#-#--#-#--#-#--#-#--#-#--#-#--
###-####-####-####-####-####-####-####-####-####-####-####-####-####-####-####-####-####-####-####-#
----------------------------------------------------------------------------------------------------
----------------------------------------------------------------------------------------------------
-#----#----#----#----#----#----#----#----#----#----#----#----#----#----#----#----#----#----#----#---
#-#--#-#--#-#--#-#--#-#--#-#--#-#--#-#--#-#--#-#--#-#--#-#--#-#--#-#--#-#--#-#--#-#--#-#--#-#--#-#--
###-####-####-####-####-####-####-####-####-####-####-####-####-####-####-####-####-####-####-####-#
----------------------------------------------------------------------------------------------------
----------------------------------------------------------------------------------------------------
-#----#----#----#----#----#----#----#----#----#----#----#----#----#----#----#----#----#----#----#---
#-#--#-#--#-#--#-#--#-#--#-#--#-#--#-#--#-#--#-#--#-#--#-#--#-#--#-#--#-#--#-#--#-#--#-#--#-#--#-#--
###-####-####-####-####-####-####-####-####-####-####-####-####-####-####-####-####-####-####-####-#
----------------------------------------------------------------------------------------------------
----------------------------------------------------------------------------------------------------
-#----#----#----#----#----#----#----#----#----#----#----#----#----#----#----#----#----#----#----#---
#-#--#-#--#-#--#-#--#-#--#-#--#-#--#-#--#-#--#-#--#-#--#-#--#-#--#-#--#-#--#-#--#-#--#-#--#-#--#-#--
###-####-####-####-####-####-####-####-####-####-####-####-####-####-####-####-####-####-####-####-#
----------------------------------------------------------------------------------------------------
----------------------------------------------------------------------------------------------------
-#----#----#----#----#----#----#----#----#----#----#----#----#----#----#----#----#----#----#----#---
#-#--#-#--#-#--#-#--#-#--#-#--#-#--#-#--#-#--#-#--#-#--#-#--#-#--#-#--#-#--#-#--#-#--#-#--#-#--#-#--
###-####-####-####-####-####-####-####-####-####-####-####-####-####-####-####-####-####-####-####-#
----------------------------------------------------------------------------------------------------
----------------------------------------------------------------------------------------------------
-#----#----#----#----#----#----#----#----#----#----#----#----#----#----#----#----#----#----#----#---
#-#--#-#--#-#--#-#--#-#--#-#--#-#--#-#--#-#--#-#--#-#--#-#--#-#--#-#--#-#--#-#--#-#--#-#--#-#--#-#--
###-####-####-####-####-####-####-####-####-####-####-####-####-####-####-####-####-####-####-####-#
----------------------------------------------------------------------------------------------------
----------------------------------------------------------------------------------------------------
-#----#----#----#----#----#----#----#----#----#----#----#----#----#----#----#----#----#----#----#---
#-#--#-#--#-#--#-#--#-#--#-#--#-#--#-#--#-#--#-#--#-#--#-#--#-#--#-#--#-#--#-#--#-#--#-#--#-#--#-#--
###-####-####-####-####-####-####-####-####-####-####-####-####-####-####-####-####-####-####-####-#
----------------------------------------------------------------------------------------------------
----------------------------------------------------------------------------------------------------
-#----#----#----#----#----#----#----#----#----#----#----#----#----#----#----#----#----#----#----#---
#-#--#-#--#-#--#-#--#-#--#-#--#-#--#-#--#-#--#-#--#-#--#-#--#-#--#-#--#-#--#-#--#-#--#-#--#-#--#-#--
###-####-####-####-####-####-####-####-####-####-####-####-####-####-####-####-####-####-####-####-#
----------------------------------------------------------------------------------------------------
----------------------------------------------------------------------------------------------------
-#----#----#----#----#----#----#----#----#----#----#----#----#----#----#----#----#----#----#----#---
#-#--#-#--#-#--#-#--#-#--#-#--#-#--#-#--#-#--#-#--#-#--#-#--#-#--#-#--#-#--#-#--#-#--#-#--#-#--#-#--
###-####-####-####-####-####-####-####-####-####-####-####-####-####-####-####-####-####-####-####-#
----------------------------------------------------------------------------------------------------
----------------------------------------------------------------------------------------------------
-#----#----#----#----#----#----#----#----#----#----#----#----#----#----#----#----#----#----#----#---
#-#--#-#--#-#--#-#--#-#--#-#--#-#--#-#--#-#--#-#--#-#--#-#--#-#--#-#--#-#--#-#--#-#--#-#--#-#--#-#--
###-####-####-####-####-####-####-####-####-####-####-####-####-####-####-####-####-####-####-####-#