?diagonal=Never;
----#----#----#----#----#----#----#----#----#----#----#----#----#----#----#----#----#----#----#----#
---#----#----#----#----#----#----#----#----#----#----#----#----#----#----#----#----#----#----#----#-
--##---##---##---##---##---##---##---##---##---##---##---##---##---##---##---##---##---##---##---##-
--#-#--#-#--#-#--#-#--#-#--#-#--#-#--#-#--#-#--#-#--#-#--#-#--#-#--#-#--#-#--#-#--#-#--#-#--#-#--#-#
-#----#----#----#----#----#----#----#----#----#----#----#----#----#----#----#----#----#----#----#---
----#----#----#----#----#----#----#----#----#----#----#----#----#----#----#----#----#----#----#----#
---#----#----#----#----#----#----#----#----#----#----#----#----#----#----#----#----#----#----#----#-
--##---##---##---##---##---##---##---##---##---##---##---##---##---##---##---##---##---##---##---##-
--#-#--#-#--#-#--#-#--#-#--#-#--#-#--#-#--#-#--#-#--#-#--#-#--#-#--#-#--#-#--#-#--#-#--#-#--#-#--#-#
-#----#----#----#----#----#----#----#----#----#----#----#----#----#----#----#----#----#----#----#---
----#----#----#----#----#----#----#----#----#----#----#----#----#----#----#----#----#----#----#----#
---#----#----#----#----#----#----#----#----#----#----#----#----#----#----#----#----#----#----#----#-
--##---##---##---##---##---##---##---##---##---##---##---##---##---##---##---##---##---##---##---##-
--#-#--#-#--#-#--#-#--#-#--#-#--#-#--#-#--#-#--#-#--#-#--#-#--#-#--#-#--#-#--#-#--#-#--#-#--#-#--#-#
-#----#----#----#----#----#----#----#----#----#----#----#----#----#----#----#----#----#----#----#---
----#----#----#----#----#----#----#----#----#----#----#----#----#----#----#----#----#----#----#----#
---#----#----#----#----#----#----#----#----#----#----#----#----#----#----#----#----#----#----#----#-
--##---##---##---##---##---##---##---##---##---##---##---##---##---##---##---##---##---##---##---##-
--#-#--#-#--#-#--#-#--#-#--#-#--#-#--#-#--#-#--#-#--#-#--#E#--#-#--#-#--#-#--#-#--#-#--#-#--#-#--#-#
-#----#----#----#----#----#----#----#----#----#----#----#----#----#----#----#----#----#----#----#---
----#----#----#----#----#----#----#----#----#----#----#----#----#----#----#----#----#----#----#----#
---#----#----#----#----#----#----#----#----#----#----#----#----#----#----#----#----#----#----#----#-
--##---##---##---##---##---##---##---##---##---##---##---##---##---##---##---##---##---##---##---##-
--#-#--#-#--#-#--#-#--#-#--#-#--#-#--#-#--#-#--#-#--#-#--#-#--#-#--#-#--#-#--#-#--#-#--#-#--#-#--#-#
-#----#----#----#----#----#----#----#----#----#----#----#----#----#----#----#----#----#----#----#---
----#----#----#----#----#----#----#----#----#----#----#----#----#----#----#----#----#----#----#----#
---#----#----#----#----#----#----#----#----#----#----#----#----#----#----#----#----#----#----#----#-
--##---##---##---##---##---##---##---##---##---##---##---##---##---##---##---##---##---##---##---##-
--#-#--#-#--#-#--#-#--#-#--#-#--#-#--#-#--#-#--#-#--#-#--#-#--#-#--#-#--#-#--#-#--#-#--#-#--#-#--#-#
-#----#----#----#----#----#----#----#----#----#----#--S-#----#----#----#----#----#----#----#----#---
----#----#----#----#----#----#----#----#----#----#----#----#----#----#----#----#----#----#----#----#
---#----#----#----#----#----#----#----#----#----#----#----#----#----#----#----#----#----#----#----#-
--##---##---##---##---##---##---##---##---##---##---##---##---##---##---##---##---##---##---##---##-
--#-#--#-#--#-#--#-#--#-#--#-#--#-#--#-#--#-#--#-#--#-#--#-#--#-#--#-#--#-#--#-#--#-#--#-#--#-#--#-#
-#----#----#----#----#----#----#----#----#----#----#----#----#----#----#----#----#----#----#----#---
----#----#----#----#----#----#----#----#----#----#----#----#----#----#----#----#----#----#----#----#
---#----#----#----#----#----#----#----#----#----#----#----#----#----#----#----#----#----#----#----#-
--##---##---##---##---##---##---##---##---##---##---##---##---##---##---##---##---##---##---##---##-
--#-#--#-#--#-#--#-#--#-#--#-#--#-#--#-#--#-#--#-#--#-#--#-#--#-#--#-#--#-#--#-#--#-#--#-#--#-#--#-#
-#----#----#----#----#----#----#----#----#----#----#----#----#----#----#----#----#----#----#----#---
----#----#----#----#----#----#----#----#----#----#----#----#----#----#----#----#----#----#----#----#
---#----#----#----#----#----#----#----#----#----#----#----#----#----#----#----#----#----#----#----#-
--##---##---##---##---##---##---##---##---##---##---##---##---##---##---##---##---##---##---##---##-
--#-#--#-#--#-#--#-#--#-#--#-#--#-#--#-#--#-#--#-#--#-#--#-#--#-#--#-#--#-#--#-#--#-#--#-#--#-#--#-#
-#----#----#----#----#----#----#----#----#----#----#----#----#----#----#----#----#----#----#----#---
----#----#----#----#----#----#----#----#----#----#----#----#----#----#----#----#----#----#----#----#
---#----#----#----#----#----#----#----#----#----#----#----#----#----#----#----#----#----#----#----#-
--##---##---##---##---##---##---##---##---##---##---##---##---##---##---##---##---##---##---##---##-
--#-#--#-#--#-#--#-#--#-#--#-#--#-#--#-#--#-#--#-#--#-#--#-#--#-#--#-#--#-#--#-#--#-#--#-#--#-#--#-#
-#----#----#----#----#----#----#----#----#----#----#----#----#----#----#----#----#----#----#----#---
----#----#----#----#----#----#----#----#----#----#----#----#----#----#----#----#----#----#----#----#
---#----#----#----#----#----#----#----#----#----#----#----#----#----#----#----#----#----#----#----#-
--##---##---##---##---##---##---##---##---##---##---##---##---##---##---##---##---##---##---##---##-
--#-#--#-#--#-#--#-#--#-#--#-#--#-#--#-#--#-#--#-#--#-#--#-#--#-#--#-#--#-#--#-#--#-#--#-#--#-#--#-#
-#----#----#----#----#----#----#----#----#----#----#----#----#----#----#----#----#----#----#----#---
----#----#----#----#----#----#----#----#----#----#----#----#----#----#----#----#----#----#----#----#
---#----#----#----#----#----#----#----#----#----#----#----#----#----#----#----#----#----#----#----#-
--##---##---##---##---##---##---##---##---##---##---##---##---##---##---##---##---##---##---##---##-
--#-#--#-#--#-#--#-#--#-#--#-#--#-#--#-#--#-#--#-#--#-#--#-#--#-#--#-#--#-#--#-#--#-#--#-#--#-#--#-#
-#----#----#----#----#----#----#----#----#----#----#----#----#----#----#----#----#----#----#----#---
----#----#----#----#----#----#----#----#----#----#----#----#----#----#----#----#----#----#----#----#
---#----#----#----#----#----#----#----#----#----#----#----#----#----#----#----#----#----#----#----#-
--##---##---##---##---##---##---##---##---##---##---##---##---##---##---##---##---##---##---##---##-
--#-#--#-#--#-#--#-#--#-#--#-#--#-#--#-#--#-#--#-#--#-#--#-#--#-#--#-#--#-#--#-#--#-#--#-#--#-#--#-#
-#----#----#----#----#----#----#----#----#----#----#----#----#----#----#----#----#----#----#----#---
----#----#----#----#----#----#----#----#----#----#----#----#----#----#----#----#----#----#----#----#
---#----#----#----#----#----#----#----#----#----#----#----#----#----#----#----#----#----#----#----#-
--##---##---##---##---##---##---##---##---##---##---##---##---##---##---##---##---##---##---##---##-
--#-#--#-#--#-#--#-#--#-#--#-#--#-#--#-#--#-#--#-#--#-#--#-#--#-#--#-#--#-#--#-#--#-#--#-#--#-#--#-#
-#----#----#----#----#----#----#----#----#----#----#----#----#----#----#----#----#----#----#----#---
----#----#----#----#----#----#----#----#----#----#----#----#----#----#----#----#----#----#----#----#
---#----#----#----#----#----#----#----#----#----#----#----#----#----#----#----#----#----#----#----#-
--##---##---##---##---##---##---##---##---##---##---##---##---##---##---##---##---##---##---##---##-
--#-#--#-#--#-#--#-#--#-#--#-#--#-#--#-#--#-#--#-#--#-#--#-#--#-#--#-#--#-#--#-#--#-#--#-#--#-#--#-#
-#----#----#----#----#----#----#----#----#----#----#----#----#----#----#----#----#----#----#----#---
----#----#----#----#----#----#----#----#----#----#----#----#----#----#----#----#----#----#----#----#
---#----#----#----#----#----#----#----#----#----#----#----#----#----#----#----#----#----#----#----#-
--##---##---##---##---##---##---##---##---##---##---##---##---##---##---##---##---##---##---##---##-
--#-#--#-#--#-#--#-#--#-#--#-#--#-#--#-#--#-#--#-#--#-#--#-#--#-#--#-#--#-#--#-#--#-#--#-#--#-#--#-#
-#----#----#----#----#----#----#----#----#----#----#----#----#----#----#----#----#----#----#----#---
----#----#----#----#----#----#----#----#----#----#----#----#----#----#----#----#----#----#----#----#
---#----#----#----#----#----#----#----#----#----#----#----#----#----#----#----#----#----#----#----#-
--##---##---##---##---##---##---##---##---##---##---##---##---##---##---##---##---##---##---##---##-
--#-#--#-#--#-#--#-#--#-#--#-#--#-#--#-#--#-#--#-#--#-#--#-#--#-#--#-#--#-#--#-#--#-#--#-#--#-#--#-#
-#----#----#----#----#----#----#----#----#----#----#----#----#----#----#----#----#----#----#----#---
----#----#----#----#----#----#----#----#----#----#----#----#----#----#----#----#----#----#----#----#
---#----#----#----#----#----#----#----#----#----#----#----#----#----#----#----#----#----#----#----#-
--##---##---##---##---##---##---##---##---##---##---##---##---##---##---##---##---##---##---##---##-
--#-#--#-#--#-#--#-#--#-#--#-#--#-#--#-#--#-#--#-#--#-#--#-#--#-#--#-#--#-#--#-#--#-#--#-#--#-#--#-#
-#----#----#----#----#----#----#----#----#----#----#----#----#----#----#----#----#----#----#----#---
----#----#----#----#----#----#----#----#----#----#----#----#----#----#----#----#----#----#----#----#
---#----#----#----#----#----#----#----#----#----#----#----#----#----#----#----#----#----#----#----#-
--##---##---##---##---##---##---##---##---##---##---##---##---##---##---##---##---##---##---##---##-
--#-#--#-#--#-#--#-#--#-#--#-#--#-#--#-#--#-#--#-#--#-#--#-#--#-#--#-#--#-#--#-#--#-#--#-#--#-#--#-#
-#----#----#----#----#----#----#----#----#----#----#----#----#----#----#----#----#----#----#----#---
----#----#----#----#----#----#----#----#----#----#----#----#----#----#----#----#----#----#----#----#
---#----#----#----#----#----#----#----#----#----#----#----#----#----#----#----#----#----#----#----#-
--##---##---##---##---##---##---##---##---##---##---##---##---##---##---##---##---##---##---##---##-
--#-#--#-#--#-#--#-#--#-#--#-#--#-#--#-#--#-#--#-#--#-#--#-#--#-#--#-#--#-#--#-#--#-#--#-#--#-#--#-#
-#----#----#----#----#----#----#----#----#----#----#----#----#----#----#----#----#----#----#----#---