?diagonal=Never;
--#----#----#----#----#----#----#----#----#----#----#----#----#----#----#----#----#----#----#----#--
-##---##---##---##---##---##---##---##---##---##---##---##---##---##---##---##---##---##---##---##--
---#----#----#----#----#----#E---#----#----#----#----#----#----#----#----#----#----#----#----#----#-
#-#--#-#--#-#--#-#--#-#--#-#--#-#--#-#--#-#--#-#--#-#--#-#--#-#--#-#--#-#--#-#--#-#--#-#--#-#--#-#--
----------------------------------------------------------------------------------------------------
--#----#----#----#----#----#----#----#----#----#----#----#----#----#----#----#----#----#----#----#--
-##---##---##---##---##---##---##---##---##---##---##---##---##---##---##---##---##---##---##---##--
---#----#----#----#----#----#----#----#----#----#----#----#----#----#----#----#----#----#----#----#-
#-#--#-#--#-#--#-#--#-#--#-#--#-#--#-#--#-#--#-#--#-#--#-#--#-#--#-#--#-#--#-#--#-#--#-#--#-#--#-#--
----------------------------------------------------------------------------------------------------
--#----#----#----#----#----#----#----#----#----#----#----#----#----#----#----#----#----#----#----#--
-##---##---##---##---##---##---##---##---##---##---##---##---##---##---##---##---##---##---##---##--
---#----#----#----#----#----#----#----#----#----#----#----#----#----#----#----#----#----#----#----#-
#-#--#-#--#-#--#-#--#-#--#-#--#-#--#-#--#-#--#-#--#-#--#-#--#-#--#-#--#-#--#-#--#-#--#-#--#-#--#-#--
----------------------------------------------------------------------------------------------------
--#----#----#----#----#----#----#----#----#----#----#----#----#----#----#----#----#----#----#----#--
-##---##---##---##---##---##---##---##---##---##---##---##---##---##---##---##---##---##---##---##--
---#----#----#----#----#----#----#----#----#----#----#----#----#----#----#----#----#----#----#----#-
#-#--#-#--#-#--#-#--#-#--#-#--#-#--#-#--#-#--#-#--#-#--#-#--#-#--#-#--#-#--#-#--#-#--#-#--#-#--#-#--
----------------------------------------------------------------------------------------------------
--#----#----#----#----#----#----#----#----#----#----#----#----#----#----#----#----#----#----#----#--
-##---##---##---##---##---##---##---##---##---##---##---##---##---##---##---##---##---##---##---##--
---#----#----#----#----#----#----#----#----#----#----#----#----#----#----#----#----#----#----#----#-
#-#--#-#--#-#--#-#--#-#--#-#--#-#--#-#--#-#--#-#--#-#--#-#--#-#--#-#--#-#--#-#--#-#--#-#--#-#--#-#--
----------------------------------------------------------------------------------------------------
--#----#----#----#----#----#----#----#----#----#----#----#----#----#----#----#----#----#----#----#--
-##---##---##---##---##---##---##---##---##---##---##---##---##---##---##---##---##---##---##---##--
---#----#----#----#----#----#----#----#----#----#----#----#----#----#----#----#----#----#----#----#-
#-#--#-#--#-#--#-#--#-#--#-#--#-#--#-#--#-#--#-#--#-#--#-#--#-#--#-#--#-#--#-#--#-#--#-#--#-#--#-#--
----------------------------------------------------------------------------------------------------
--#----#----#----#----#----#----#----#----#----#----#----#----#----#----#----#----#----#----#----#--
-##---##---##---##---##---##---##---##---##---##---##---##---##---##---##---##---##---##---##---##--
---#----#----#----#----#----#----#----#----#----#----#----#----#----#----#----#----#----#----#----#-
#-#--#-#--#-#--#-#--#-#--#-#--#-#--#-#--#-#--#-#--#-#--#-#--#-#--#-#--#-#--#-#--#-#--#-#--#-#--#-#--
-----------------------------------------------------------------------------------------S----------
--#----#----#----#----#----#----#----#----#----#----#----#----#----#----#----#----#----#----#----#--
-##---##---##---##---##---##---##---##---##---##---##---##---##---##---##---##---##---##---##---##--
---#----#----#----#----#----#----#----#----#----#----#----#----#----#----#----#----#----#----#----#-
#-#--#-#--#-#--#-#--#-#--#-#--#-#--#-#--#-#--#-#--#-#--#-#--#-#--#-#--#-#--#-#--#-#--#-#--#-#--#-#--
----------------------------------------------------------------------------------------------------
--#----#----#----#----#----#----#----#----#----#----#----#----#----#----#----#----#----#----#----#--
-##---##---##---##---##---##---##---##---##---##---##---##---##---##---##---##---##---##---##---##--
---#----#----#----#----#----#----#----#----#----#----#----#----#----#----#----#----#----#----#----#-
#-#--#-#--#-#--#-#--#-#--#-#--#-#--#-#--#-#--#-#--#-#--#-#--#-#--#-#--#-#--#-#--#-#--#-#--#-#--#-#--
----------------------------------------------------------------------------------------------------
--#----#----#----#----#----#----#----#----#----#----#----#----#----#----#----#----#----#----#----#--
-##---##---##---##---##---##---##---##---##---##---##---##---##---##---##---##---##---##---##---##--
---#----#----#----#----#----#----#----#----#----#----#----#----#----#----#----#----#----#----#----#-
#-#--#-#--#-#--#-#--#-#--#-#--#-#--#-#--#-#--#-#--#-#--#-#--#-#--#-#--#-#--#-#--#-#--#-#--#-#--#-#--
----------------------------------------------------------------------------------------------------
--#----#----#----#----#----#----#----#----#----#----#----#----#----#----#----#----#----#----#----#--
-##---##---##---##---##---##---##---##---##---##---##---##---##---##---##---##---##---##---##---##--
---#----#----#----#----#----#----#----#----#----#----#----#----#----#----#----#----#----#----#----#-
#-#--#-#--#-#--#-#--#-#--#-#--#-#--#-#--#-#--#-#--#-#--#-#--#-#--#-#--#-#--#-#--#-#--#-#--#-#--#-#--
----------------------------------------------------------------------------------------------------
--#----#----#----#----#----#----#----#----#----#----#----#----#----#----#----#----#----#----#----#--
-##---##---##---##---##---##---##---##---##---##---##---##---##---##---##---##---##---##---##---##--
---#----#----#----#----#----#----#----#----#----#----#----#----#----#----#----#----#----#----#----#-
#-#--#-#--#-#--#-#--#-#--#-#--#-#--#-#--#-#--#-#--#-#--#-#--#-#--#-#--#-#--#-#--#-#--#-#--#-#--#-#--
----------------------------------------------------------------------------------------------------
--#----#----#----#----#----#----#----#----#----#----#----#----#----#----#----#----#----#----#----#--
-##---##---##---##---##---##---##---##---##---##---##---##---##---##---##---##---##---##---##---##--
---#----#----#----#----#----#----#----#----#----#----#----#----#----#----#----#----#----#----#----#-
#-#--#-#--#-#--#-#--#-#--#-#--#-#--#-#--#-#--#-#--#-#--#-#--#-#--#-#--#-#--#-#--#-#--#-#--#-#--#-#--
----------------------------------------------------------------------------------------------------
--#----#----#----#----#----#----#----#----#----#----#----#----#----#----#----#----#----#----#----#--
-##---##---##---##---##---##---##---##---##---##---##---##---##---##---##---##---##---##---##---##--
---#----#----#----#----#----#----#----#----#----#----#----#----#----#----#----#----#----#----#----#-
#-#--#-#--#-#--#-#--#-#--#-#--#-#--#-#--#-#--#-#--#-#--#-#--#-#--#-#--#-#--#-#--#-#--#-#--#-#--#-#--
----------------------------------------------------------------------------------------------------
--#----#----#----#----#----#----#----#----#----#----#----#----#----#----#----#----#----#----#----#--
-##---##---##---##---##---##---##---##---##---##---##---##---##---##---##---##---##---##---##---##--
---#----#----#----#----#----#----#----#----#----#----#----#----#----#----#----#----#----#----#----#-
#-#--#-#--#-#--#-#--#-#--#-#--#-#--#-#--#-#--#-#--#-#--#-#--#-#--#-#--#-#--#-#--#-#--#-#--#-#--#-#--
----------------------------------------------------------------------------------------------------
--#----#----#----#----#----#----#----#----#----#----#----#----#----#----#----#----#----#----#----#--
-##---##---##---##---##---##---##---##---##---##---##---##---##---##---##---##---##---##---##---##--
---#----#----#----#----#----#----#----#----#----#----#----#----#----#----#----#----#----#----#----#-
#-#--#-#--#-#--#-#--#-#--#-#--#-#--#-#--#-#--#-#--#-#--#-#--#-#--#-#--#-#--#-#--#-#--#-#--#-#--#-#--
----------------------------------------------------------------------------------------------------
--#----#----#----#----#----#----#----#----#----#----#----#----#----#----#----#----#----#----#----#--
-##---##---##---##---##---##---##---##---##---##---##---##---##---##---##---##---##---##---##---##--
---#----#----#----#----#----#----#----#----#----#----#----#----#----#----#----#----#----#----#----#-
#-#--#-#--#-#--#-#--#-#--#-#--#-#--#-#--#-#--#-#--#-#--#-#--#-#--#-#--#-#--#-#--#-#--#-#--#-#--#-#--
----------------------------------------------------------------------------------------------------
--#----#----#----#----#----#----#----#----#----#----#----#----#----#----#----#----#----#----#----#--
-##---##---##---##---##---##---##---##---##---##---##---##---##---##---##---##---##---##---##---##--
---#----#----#----#----#----#----#----#----#----#----#----#----#----#----#----#----#----#----#----#-
#-#--#-#--#-#--#-#--#-#--#-#--#-#--#-#--#-#--#-#--#-#--#-#--#-#--#-#--#-#--#-#--#-#--#-#--#-#--#-#--
----------------------------------------------------------------------------------------------------
--#----#----#----#----#----#----#----#----#----#----#----#----#----#----#----#----#----#----#----#--
-##---##---##---##---##---##---##---##---##---##---##---##---##---##---##---##---##---##---##---##--
---#----#----#----#----#----#----#----#----#----#----#----#----#----#----#----#----#----#----#----#-
#-#--#-#--#-#--#-#--#-#--#-#--#-#--#-#--#-#--#-#--#-#--#-#--#-#--#-#--#-#--#-#--#-#--#-#--#-#--#-#--
----------------------------------------------------------------------------------------------------
--#----#----#----#----#----#----#----#----#----#----#----#----#----#----#----#----#----#----#----#--
-##---##---##---##---##---##---##---##---##---##---##---##---##---##---##---##---##---##---##---##--
---#----#----#----#----#----#----#----#----#----#----#----#----#----#----#----#----#----#----#----#-
#-#--#-#--#-#--#-#--#-#--#-#--#-#--#-#--#-#--#-#--#-#--#-#--#-#--#-#--#-#--#-#--#-#--#-#--#-#--#-#--
----------------------------------------------------------------------------------------------------