?diagonal=Never;
##--###--###--###--###--###--###--###--###--###--###--###--###--###--###--###--###--###--###--###--#
----------------------------------------------------------------------------------------------------
-#----#----#----#----#----#----#----#----#----#----#----#----#----#----#----#----#----#----#----#---
-##---##---##---##---##---##---##---##---##---##---##---##---##---##---##---##---##---##---##---##--
---#----#----#----#----#----#----#----#----#----#----#----#----#----#----#----#----#----#----#----#-
##--###--###--###--###--###--###--###--###--###--###--###--###--###--###--###--###--###--###--###--#
----------------------------------------------------------------------------------------------------
-#----#----#----#----#----#----#----#----#----#----#----#----#----#----#----#----#----#----#----#---
-##---##---##---##---##---##---##---##---##---##---##---##---##---##---##---##---##---##---##---##--
---#----#----#----#----#----#----#----#----#----#----#----#----#----#----#----#----#----#----#----#-
##--###--###--###--###--###--###--###--###--###--###--###--###--###--###--###--###--###--###--###--#
----------------------------------------------------------------------------------------------------
-#----#----#----#----#----#----#----#----#----#----#----#----#----#----#----#----#----#----#----#---
-##---##---##---##---##---##---##---##---##---##---##---##---##---##---##---##---##---##---##---##--
---#----#----#----#----#----#----#----#----#----#----#----#----#----#----#----#----#----#----#----#-
##--###--###--###--###--###--###--###--###--###--###--###--###--###--###--###--###--###--###--###--#
----------------------------------------------------------------------------------------------------
-#----#----#----#----#----#----#----#----#----#----#----#----#----#----#----#----#----#----#----#---
-##---##---##---##---##---##---##---##---##---##---##---##---##---##---##---##---##---##---##---##--
---#----#----#----#----#----#----#----#----#----#----#----#----#----#----#----#----#----#----#----#-
##--###--###--###--###--###--###--###--###--###--###--###--###--###--###--###--###--###--###--###--#
----------------------------------------------------------------------------------------------------
-#----#----#----#----#----#----#----#----#----#----#----#----#----#----#----#----#----#----#----#---
-##---##---##---##---##---##---##---##---##---##---##---##---##---##---##---##---##---##---##---##--
---#----#----#----#----#----#----#----#----#----#----#----#----#----#----#----#----#----#----#----#-
##--###--###--###--###--###--###--###--###--###--###--###--###--###--###--###--###--###--###--###--#
----------------------------------------------------------------------------------------------------
-#----#----#----#----#----#----#----#----#----#----#----#----#----#----#----#----#----#----#----#---
-##---##---##---##---##---##---##---##---##---##---##---##---##---##---##---##---##---##---##---##--
---#----#----#----#----#----#----#----#----#----#----#----#----#----#----#----#----#----#----#----#-
##--###--###--###--###--###--###--###--###--###--###--###--###--###--###--###--###--###--###--###--#
----------------------------------------------------------------------------------------------------
-#----#----#----#----#----#----#----#----#----#----#----#----#----#----#----#----#----#----#--S-#---
-##---##---##---##---##---##---##---##---##---##---##---##---##---##---##---##---##---##---##---##--
---#----#----#----#----#----#----#----#----#----#----#----#----#----#----#----#----#----#----#----#-
##--###--###--###--###--###--###--###--###--###--###--###--###--###--###--###--###--###--###--###--#
----------------------------------------------------------------------------------------------------
-#----#----#----#----#----#----#----#----#----#----#----#----#----#----#----#----#----#----#----#---
-##---##---##---##---##---##---##---##---##---##---##---##---##---##---##---##---##---##---##---##--
---#----#----#----#----#----#----#----#----#----#----#----#----#----#----#----#----#----#----#----#-
##--###--###--###--###--###--###--###--###--###--###--###--###--###--###--###--###--###--###--###--#
----------------------------------------------------------------------------------------------------
-#----#----#----#----#----#----#----#----#----#----#----#----#----#----#----#----#----#----#----#---
-##---##---##---##---##---##---##---##---##---##---##---##---##---##---##---##---##---##---##---##--
---#----#----#----#----#----#----#----#----#----#----#----#----#----#----#----#----#----#----#----#-
##--###--###--###--###--###--###--###--###--###--###--###--###--###--###--###--###--###--###--###--#
----------------------------------------------------------------------------------------------------
-#----#----#----#----#----#----#----#----#----#----#----#----#----#----#----#----#----#----#----#---
-##---##---##---##---##---##---##---##---##---##---##---##---##---##---##---##---##---##---##---##--
---#----#----#----#----#----#----#----#----#----#----#----#----#----#----#----#----#----#----#----#-
##--###--###--###--###--###--###--###--###--###--###--###--###--###--###--###--###--###--###--###--#
----------------------------------------------------------------------------------------------------
-#----#----#----#----#----#----#----#----#----#----#----#----#----#----#----#----#----#----#----#---
-##---##---##---##---##---##---##---##---##---##---##---##---##---##---##---##---##---##---##---##--
---#----#----#----#----#----#----#----#----#----#----#----#----#----#----#----#----#----#----#----#-
##--###--###--###--###--###--###--###--###--###--###--###--###--###--###--###--###--###--###--###--#
----------------------------------------------------------------------------------------------------
-#----#----#----#----#----#----#----#----#----#----#----#----#----#----#----#----#----#----#----#---
-##---##---##---##---##---##---##---##---##---##---##---##---##---##---##---##---##---##---##---##--
---#----#----#----#----#----#----#----#----#----#----#----#----#----#----#----#----#----#----#----#-
##--###--###--###--###--###--###--###--###--###--###--###--###--###--###--###--###--###--###--###--#
----------------------------------------------------------------------------------------------------
-#----#----#----#----#----#----#----#----#----#----#----#----#----#----#----#----#----#----#----#---
-##---##---##---##---##---##---##---##---##---##---##---##---##---##---##---##---##---##---##---##--
---#----#----#----#----#----#----#----#----#----#----#----#----#----#----#----#----#----#----#----#-
##--###--###--###--###--###--###--###--###--###--###--###--###--###--###--###--###--###--###--###--#
----------------------------------------------------------------------------------------------------
-#----#----#----#----#----#----#----#----#----#----#----#----#----#----#----#----#----#----#----#---
-##---##---##---##---##---##---##---##---##---##---##---##---##---##---##---##---##---##---##---##--
---#----#----#----#----#----#----#----#----#----#----#----#----#----#----#----#----#----#----#----#-
##--###--###--###--###--###--###--###--###--###--###--###--###--###--###--###--###--###--###--###--#
----------------------------------------------------------------------------------------------------
-#----#----#----#----#----#----#----#----#----#----#----#----#----#----#----#----#----#----#----#---
-##---##---##---##---##---##---##---##---##---##---##---##---##---##---##---##---##---##---##---##--
---#----#----#----#----#----#----#----#----#----#----#----#----#----#----#----#----#----#----#----#-
##--###--###--###--###--###--###--###--###--###--###--###--###--###--###--###--###--###--###--###--#
--------------------------E-------------------------------------------------------------------------
-#----#----#----#----#----#----#----#----#----#----#----#----#----#----#----#----#----#----#----#---
-##---##---##---##---##---##---##---##---##---##---##---##---##---##---##---##---##---##---##---##--
---#----#----#----#----#----#----#----#----#----#----#----#----#----#----#----#----#----#----#----#-
##--###--###--###--###--###--###--###--###--###--###--###--###--###--###--###--###--###--###--###--#
----------------------------------------------------------------------------------------------------
-#----#----#----#----#----#----#----#----#----#----#----#----#----#----#----#----#----#----#----#---
-##---##---##---##---##---##---##---##---##---##---##---##---##---##---##---##---##---##---##---##--
---#----#----#----#----#----#----#----#----#----#----#----#----#----#----#----#----#----#----#----#-
##--###--###--###--###--###--###--###--###--###--###--###--###--###--###--###--###--###--###--###--#
----------------------------------------------------------------------------------------------------
-#----#----#----#----#----#----#----#----#----#----#----#----#----#----#----#----#----#----#----#---
-##---##---##---##---##---##---##---##---##---##---##---##---##---##---##---##---##---##---##---##--
---#----#----#----#----#----#----#----#----#----#----#----#----#----#----#----#----#----#----#----#-
##--###--###--###--###--###--###--###--###--###--###--###--###--###--###--###--###--###--###--###--#
----------------------------------------------------------------------------------------------------
-#----#----#----#----#----#----#----#----#----#----#----#----#----#----#----#----#----#----#----#---
-##---##---##---##---##---##---##---##---##---##---##---##---##---##---##---##---##---##---##---##--
---#----#----#----#----#----#----#----#----#----#----#----#----#----#----#----#----#----#----#----#-
##--###--###--###--###--###--###--###--###--###--###--###--###--###--###--###--###--###--###--###--#
----------------------------------------------------------------------------------------------------
-#----#----#----#----#----#----#----#----#----#----#----#----#----#----#----#----#----#----#----#---
-##---##---##---##---##---##---##---##---##---##---##---##---##---##---##---##---##---##---##---##--
---#----#----#----#----#----#----#----#----#----#----#----#----#----#----#----#----#----#----#----#-