?diagonal=Never;
-#----#----#----#----#----#----#----#----#----#----#----#----#----#----#----#----#----#----#----#---
---#----#----#----#----#----#----#----#----#----#----#----#----#----#----#----#----#----#----#----#-
#----#----#----#----#----#----#----#----#----#----#----#----#----#----#----#----#----#----#----#----
-#-#--#-#--#-#--#-#--#-#--#-#--#-#--#-#--#-#--#-#--#-#--#-#--#-#--#-#--#-#--#-#--#-#--#-#--#-#--#-#-
#-##-#-##-#-##-#-##-#-##-#-##-#-##-#-##-#-##-#-##-#-##-#-##-#-##-#-##-#-##-#-##-#-##-#-##-#-##-#-##-
-#----#----#----#----#----#----#----#----#----#----#----#----#----#----#----#----#----#----#----#---
---#----#----#----#----#----#----#----#----#----#----#----#----#----#----#----#----#----#----#----#-
#----#----#----#----#----#----#----#----#----#----#----#----#----#----#----#----#----#----#----#----
-#-#--#-#--#-#--#-#--#-#--#-#--#-#--#-#--#-#--#-#--#-#--#-#--#-#--#-#--#-#--#-#--#-#--#-#--#-#--#-#-
#-##-#-##-#-##-#-##-#-##-#-##-#-##-#-##-#-##-#-##-#-##-#-##-#-##-#-##-#-##-#-##-#-##-#-##-#-##-#-##-
-#----#----#----#----#----#----#----#----#----#----#----#----#----#----#----#----#----#----#----#---
---#----#----#----#----#----#----#----#----#----#----#----#----#----#----#----#----#----#----#----#-
#----#----#----#----#----#----#----#----#----#----#----#----#----#----#----#----#----#----#----#----
-#-#--#-#--#-#--#-#--#-#--#-#--#-#--#-#--#-#--#-#--#-#--#-#--#-#--#-#--#-#--#-#--#-#--#-#--#-#--#-#-
#-##-#-##-#-##-#-##-#-##-#-##-#-##-#-##-#-##-#-##-#-##-#-##-#-##-#-##-#-##-#-##-#-##-#-##-#-##-#-##-
-#----#----#----#----#----#----#----#----#----#----#----#----#----#----#----#----#----#----#----#---
---#----#----#----#----#----#----#----#----#----#----#----#----#----#----#----#----#----#----#----#-
#----#----#----#----#----#----#----#----#----#----#----#----#----#----#----#----#----#----#----#----
-#-#--#-#--#-#--#-#--#-#--#-#--#-#--#-#--#-#--#-#--#-#--#-#--#-#--#-#--#-#--#-#--#-#--#-#--#-#--#-#-
#-##-#-##-#-##-#-##-#-##-#-##-#-##-#-##-#-##-#-##-#-##-#-##-#-##-#-##-#-##-#-##-#-##-#-##-#-##-#-##-
-#----#----#----#----#----#----#----#----#----#----#----#----#----#----#----#----#----#----#----#---
---#----#----#----#----#----#----#----#----#----#----#----#----#----#----#----#----#----#----#----#-
#----#----#----#----#----#----#----#----#----#----#----#----#----#----#----#----#----#----#S---#----
-#-#--#-#--#-#--#-#--#-#--#-#--#-#--#-#--#-#--#-#--#-#--#-#--#-#--#-#--#-#--#-#--#-#--#-#--#-#--#-#-
#-##-#-##-#-##-#-##-#-##-#-##-#-##-#-##-#-##-#-##-#-##-#-##-#-##-#-##-#-##-#-##-#-##-#-##-#-##-#-##-
-#----#----#----#----#----#----#----#----#----#----#----#----#----#----#----#----#----#----#----#---
---#----#----#----#----#----#----#----#----#----#----#----#----#----#----#----#----#----#----#----#-
#----#----#----#----#----#----#----#----#----#----#----#----#----#----#----#----#----#----#----#----
-#-#--#-#--#-#--#-#--#-#--#-#--#-#--#-#--#-#--#-#--#-#--#-#--#-#--#-#--#-#--#-#--#-#--#-#--#-#--#-#-
#-##-#-##-#-##-#-##-#-##-#-##-#-##-#-##-#-##-#-##-#-##-#-##-#-##-#-##-#-##-#-##-#-##-#-##-#-##-#-##-
-#----#----#----#----#----#----#----#----#----#----#----#----#----#----#----#----#----#----#----#---
---#----#----#----#----#----#----#----#----#----#----#----#----#----#----#----#----#----#----#----#-
#----#----#----#----#----#----#----#----#----#----#----#----#----#----#----#----#----#----#----#----
-#-#--#-#--#-#--#-#--#-#--#-#--#-#--#-#--#-#--#-#--#-#--#-#--#-#--#-#--#-#--#-#--#-#--#-#--#-#--#-#-
#-##-#-##-#-##-#-##-#-##-#-##-#-##-#-##-#-##-#-##-#-##-#-##-#-##-#-##-#-##-#-##-#-##-#-##-#-##-#-##-
-#----#----#----#----#----#----#----#----#----#----#----#----#----#----#----#----#----#----#----#---
---#----#----#----#----#----#----#----#----#----#----#----#----#----#----#----#----#----#----#----#-
#----#----#----#----#----#----#----#----#----#----#----#----#----#----#----#----#----#----#----#----
-#-#--#-#--#-#--#-#--#-#--#-#--#-#--#-#--#-#--#-#--#-#--#-#--#-#--#-#--#-#--#-#--#-#--#-#--#-#--#-#-
#-##-#-##-#-##-#-##-#-##-#-##-#-##-#-##-#-##-#-##-#-##-#-##-#-##-#-##-#-##-#-##-#-##-#-##-#-##-#-##-
-#----#----#----#----#----#----#----#----#----#----#----#----#----#----#----#----#----#----#----#---
---#----#----#----#----#----#----#----#----#----#----#----#----#----#----#----#----#----#----#----#-
#----#----#----#----#----#----#----#----#----#----#----#----#----#----#----#----#----#----#----#----
-#-#--#-#--#-#--#-#--#-#--#-#--#-#--#-#--#-#--#-#--#-#--#-#--#-#--#-#--#-#--#-#--#-#--#-#--#-#--#-#-
#-##-#-##-#-##-#-##-#-##-#-##-#-##-#-##-#-##-#-##-#-##-#-##-#-##-#-##-#-##-#-##-#-##-#-##-#-##-#-##-
-#----#----#----#----#----#----#----#----#----#----#----#----#----#----#----#----#----#----#----#---
---#----#----#----#----#----#----#----#----#----#----#----#----#----#----#----#----#----#----#----#-
#----#----#----#----#----#----#----#----#----#----#----#----#----#----#----#----#----#----#----#----
-#-#--#-#--#-#--#-#--#-#--#-#--#-#--#-#--#-#--#-#--#-#--#-#--#-#--#-#--#-#--#-#--#-#--#-#--#-#--#-#-
#-##-#-##-#-##-#-##-#-##-#-##-#-##-#-##-#-##-#-##-#-##-#-##-#-##-#-##-#-##-#-##-#-##-#-##-#-##-#-##-
-#----#----#----#----#----#----#----#----#----#----#----#----#----#----#----#----#----#----#----#---
---#----#----#----#----#----#----#----#----#----#----#----#----#----#----#----#----#----#----#----#-
#----#----#----#----#----#----#----#----#----#----#----#----#----#----#----#----#----#----#----#----
-#-#--#-#--#-#--#-#--#-#--#-#--#-#--#-#--#-#--#-#--#-#--#-#--#-#--#-#--#-#--#-#--#-#--#-#--#-#--#-#-
#-##-#-##-#-##-#-##-#-##-#-##-#-##-#-##-#-##-#-##-#-##-#-##-#-##-#-##-#-##-#-##-#-##-#-##-#-##-#-##-
-#----#----#----#----#----#----#----#----#----#----#----#----#----#----#----#----#----#----#----#---
---#----#----#----#----#----#----#----#----#----#----#----#----#----#----#----#----#----#----#----#-
#----#----#----#----#----#----#----#----#----#----#----#----#----#----#----#----#----#----#----#----
-#-#--#-#--#-#--#-#--#-#--#-#--#-#--#-#--#-#--#-#--#-#--#-#--#-#--#-#--#-#--#-#--#-#--#-#--#-#--#-#-
#-##-#-##-#-##-#-##-#-##-#-##-#-##-#-##-#-##-#-##-#-##-#-##-#-##-#-##-#-##-#-##-#-##-#-##-#-##-#-##-
-#----#----#----#----#----#----#----#----#----#----#----#----#----#----#----#----#----#----#----#---
---#----#----#----#----#----#----#----#----#----#----#----#----#----#----#----#----#----#----#----#-
#----#----#----#----#----#----#----#----#----#----#----#----#----#----#----#----#----#----#----#----
-#-#--#-#--#-#--#-#--#-#--#-#--#-#--#-#--#-#--#-#--#-#--#-#--#-#--#-#--#-#--#-#--#-#--#-#--#-#--#-#-
#-##-#-##-#-##-#-##-#-##-#-##-#-##-#-##-#-##-#-##-#-##-#-##-#-##-#-##-#-##-#-##-#-##-#-##-#-##-#-##-
-#----#----#----#----#----#----#----#----#----#----#----#----#----#----#E---#----#----#----#----#---
---#----#----#----#----#----#----#----#----#----#----#----#----#----#----#----#----#----#----#----#-
#----#----#----#----#----#----#----#----#----#----#----#----#----#----#----#----#----#----#----#----
-#-#--#-#--#-#--#-#--#-#--#-#--#-#--#-#--#-#--#-#--#-#--#-#--#-#--#-#--#-#--#-#--#-#--#-#--#-#--#-#-
#-##-#-##-#-##-#-##-#-##-#-##-#-##-#-##-#-##-#-##-#-##-#-##-#-##-#-##-#-##-#-##-#-##-#-##-#-##-#-##-
-#----#----#----#----#----#----#----#----#----#----#----#----#----#----#----#----#----#----#----#---
---#----#----#----#----#----#----#----#----#----#----#----#----#----#----#----#----#----#----#----#-
#----#----#----#----#----#----#----#----#----#----#----#----#----#----#----#----#----#----#----#----
-#-#--#-#--#-#--#-#--#-#--#-#--#-#--#-#--#-#--#-#--#-#--#-#--#-#--#-#--#-#--#-#--#-#--#-#--#-#--#-#-
#-##-#-##-#-##-#-##-#-##-#-##-#-##-#-##-#-##-#-##-#-##-#-##-#-##-#-##-#-##-#-##-#-##-#-##-#-##-#-##-
-#----#----#----#----#----#----#----#----#----#----#----#----#----#----#----#----#----#----#----#---
---#----#----#----#----#----#----#----#----#----#----#----#----#----#----#----#----#----#----#----#-
#----#----#----#----#----#----#----#----#----#----#----#----#----#----#----#----#----#----#----#----
-#-#--#-#--#-#--#-#--#-#--#-#--#-#--#-#--#-#--#-#--#-#--#-#--#-#--#-#--#-#--#-#--#-#--#-#--#-#--#-#-
#-##-#-##-#-##-#-##-#-##-#-##-#-##-#-##-#-##-#-##-#-##-#-##-#-##-#-##-#-##-#-##-#-##-#-##-#-##-#-##-
-#----#----#----#----#----#----#----#----#----#----#----#----#----#----#----#----#----#----#----#---
---#----#----#----#----#----#----#----#----#----#----#----#----#----#----#----#----#----#----#----#-
#----#----#----#----#----#----#----#----#----#----#----#----#----#----#----#----#----#----#----#----
-#-#--#-#--#-#--#-#--#-#--#-#--#-#--#-#--#-#--#-#--#-#--#-#--#-#--#-#--#-#--#-#--#-#--#-#--#-#--#-#-
#-##-#-##-#-##-#-##-#-##-#-##-#-##-#-##-#-##-#-##-#-##-#-##-#-##-#-##-#-##-#-##-#-##-#-##-#-##-#-##-
-#----#----#----#----#----#----#----#----#----#----#----#----#----#----#----#----#----#----#----#---
---#----#----#----#----#----#----#----#----#----#----#----#----#----#----#----#----#----#----#----#-
#----#----#----#----#----#----#----#----#----#----#----#----#----#----#----#----#----#----#----#----
-#-#--#-#--#-#--#-#--#-#--#-#--#-#--#-#--#-#--#-#--#-#--#-#--#-#--#-#--#-#--#-#--#-#--#-#--#-#--#-#-
#-##-#-##-#-##-#-##-#-##-#-##-#-##-#-##-#-##-#-##-#-##-#-##-#-##-#-##-#-##-#-##-#-##-#-##-#-##-#-##-
-#----#----#----#----#----#----#----#----#----#----#----#----#----#----#----#----#----#----#----#---
---#----#----#----#----#----#----#----#----#----#----#----#----#----#----#----#----#----#----#----#-
#----#----#----#----#----#----#----#----#----#----#----#----#----#----#----#----#----#----#----#----
-#-#--#-#--#-#--#-#--#-#--#-#--#-#--#-#--#-#--#-#--#-#--#-#--#-#--#-#--#-#--#-#--#-#--#-#--#-#--#-#-
#-##-#-##-#-##-#-##-#-##-#-##-#-##-#-##-#-##-#-##-#-##-#-##-#-##-#-##-#-##-#-##-#-##-#-##-#-##-#-##-
-#----#----#----#----#----#----#----#----#----#----#----#----#----#----#----#----#----#----#----#---
---#----#----#----#----#----#----#----#----#----#----#----#----#----#----#----#----#----#----#----#-
#----#----#----#----#----#----#----#----#----#----#----#----#----#----#----#----#----#----#----#----
-#-#--#-#--#-#--#-#--#-#--#-#--#-#--#-#--#-#--#-#--#-#--#-#--#-#--#-#--#-#--#-#--#-#--#-#--#-#--#-#-
#-##-#-##-#-##-#-##-#-##-#-##-#-##-#-##-#-##-#-##-#-##-#-##-#-##-#-##-#-##-#-##-#-##-#-##-#-##-#-##-