?diagonal=Never;
----------------------------------------------------------------------------------------------------
----------------------------------------------------------------------------------------------------
-###--###--###--###--###--###--###--###--###--###--###--###--###--###--###--###--###--###--###--###-
#--#-#--#-#--#-#--#-#--#-#--#-#--#-#--#-#--#-#--#-#--#-#--#-#--#-#--#-#--#-#--#-#--#-#--#-#--#-#--#-
-#----#----#----#----#----#----#----#----#----#----#----#----#----#----#----#----#----#----#----#---
----------------------------------------------------------------------------------------------------
----------------------------------------------------------------------------------------------------
-###--###--###--###--###--###--###--###--###--###--###--###--###--###--###--###--###--###--###--###-
#--#-#--#-#--#-#--#-#--#-#--#-#--#-#--#-#--#-#--#-#--#-#--#-#--#-#--#-#--#-#--#-#--#-#--#-#--#-#--#-
-#----#----#----#----#----#----#----#----#----#----#----#----#----#----#----#----#----#----#----#---
----------------------------------------------------------------------------------------------------
----------------------------------------------------------------------------------------------------
-###--###--###--###--###--###--###--###--###--###--###--###--###--###--###--###--###--###--###--###-
#--#-#--#-#--#-#--#-#--#-#--#-#--#-#--#-#--#-#--#-#--#-#--#-#--#-#--#-#--#-#--#-#--#-#--#-#--#-#--#-
-#----#----#----#----#----#----#----#----#----#----#----#----#----#----#----#----#----#----#----#---
----------------------------------------------------------------------------------------------------
----------------------------------------------------------------------------------------------------
-###--###--###--###--###--###--###--###--###--###--###--###--###--###--###--###--###--###--###--###-
#--#-#--#-#--#-#--#-#--#-#--#-#--#-#--#-#--#-#--#-#--#-#--#-#--#-#--#-#--#-#--#-#--#-#--#-#--#-#--#-
-#----#----#----#----#----#----#----#----#----#----#----#----#----#----#----#----#----#----#----#---
----------------------------------------------------------------------------------------------------
----------------------------------------------------------------------------------------------------
-###--###--###--###--###--###--###--###--###--###--###--###--###--###--###--###--###--###--###--###-
#--#-#--#-#--#-#--#-#--#-#--#-#--#-#--#-#--#-#--#-#--#-#--#-#--#-#--#-#--#-#--#-#--#-#--#-#--#-#--#-
-#----#----#----#----#----#----#----#----#----#----#----#----#----#----#----#----#----#----#----#---
----------------------------------------------------------------------------------------------------
----------------------------------------------------------------------------------------------------
-###--###--###--###--###--###--###--###--###--###--###--###--###--###--###--###--###--###--###--###-
#--#-#--#-#--#-#--#-#--#-#--#-#--#-#--#-#--#-#--#-#--#-#--#-#--#-#--#-#--#-#--#-#--#-#--#-#--#-#--#-
-#----#----#----#----#----#----#----#----#----#----#----#----#----#----#----#----#----#----#----#---
----------------------------------------------------------------------------------------------------
----------------------------------------------------------------------------------------------------
-###--###--###--###--###--###--###--###--###--###--###--###--###--###--###--###--###--###--###--###-
#--#-#--#-#--#-#--#-#--#-#--#-#--#-#--#-#--#-#--#-#--#-#--#-#--#-#--#-#--#-#--#-#--#-#--#-#--#-#--#-
-#----#----#----#----#----#----#----#----#----#----#----#----#----#----#----#----#----#----#----#---
----------------------------------------------------------------------------------------------------
----------------------------------------------------------------------------------------------------
-###--###--###--###--###--###--###--###--###--###--###--###--###--###--###--###--###--###--###--###-
#--#-#--#-#--#-#--#-#--#-#--#-#--#-#--#-#--#-#--#-#--#-#--#-#--#-#--#-#--#-#--#-#--#-#--#-#--#-#--#-
-#----#----#----#----#----#----#----#----#----#----#----#----#----#----#----#----#----#----#----#---
----------------------------------------------------------------------------------------------------
----------------------------------------------------------------------------------------------------
-###--###--###--###--###--###--###--###--###--###--###--###--###--###--###--###--###--###--###--###-
#--#-#--#-#--#-#--#-#--#-#--#-#--#-#--#-#--#-#--#-#--#-#--#-#--#-#--#-#--#-#--#-#--#-#--#-#--#-#--#-
-#----#----#----#----#----#----#----#----#----#----#----#----#----#----#----#----#----#----#----#---
---------------------------------------------------S------------------------------------------------
----------------------------------------------------------------------------------------------------
-###--###--###--###--###--###--###--###--###--###--###--###--###--###--###--###--###--###--###--###-
#--#-#--#-#--#-#--#-#--#-#--#-#--#-#--#-#--#-#--#-#--#-#--#-#--#-#--#-#--#-#--#-#--#-#--#-#--#-#--#-
-#----#----#----#----#----#----#----#----#----#----#----#----#----#----#----#----#----#----#----#---
----------------------------------------------------------------------------------------------------
----------------------------------------------------------------------------------------------------
-###--###--###--###--###--###--###--###--###--###--###--###--###--###--###--###--###--###--###--###-
#--#-#--#-#--#-#--#-#--#-#--#-#--#-#--#-#--#-#--#-#--#-#--#-#--#-#--#-#--#-#--#-#--#-#--#-#--#-#--#-
-#----#----#----#----#----#----#----#----#----#----#----#----#----#----#----#----#----#----#----#---
----------------------------------------------------------------------------------------------------
----------------------------------------------------------------------------------------------------
-###--###--###--###--###--###--###--###--###--###--###--###--###--###--###--###--###--###--###--###-
#--#-#--#-#--#-#--#-#--#-#--#-#--#-#--#-#--#-#--#-#--#-#--#-#--#-#--#-#--#-#--#-#--#-#--#-#--#-#--#-
-#----#----#----#----#----#----#----#----#----#----#----#----#----#----#----#----#----#----#----#---
----------------------------------------------------------------------------------------------------
----------------------------------------------------------------------------------------------------
-###--###--###--###--###--###--###--###--###--###--###--###--###--###--###--###--###--###--###--###-
#--#-#--#-#--#-#--#-#--#-#--#-#--#-#--#-#--#-#--#-#--#-#--#-#--#-#--#-#--#-#--#-#--#-#--#-#--#-#--#-
-#----#----#----#----#----#----#----#----#----#----#----#----#----#----#----#----#----#----#----#---
----------------------------------------------------------------------------------------------------
--------------------------------E-------------------------------------------------------------------
-###--###--###--###--###--###--###--###--###--###--###--###--###--###--###--###--###--###--###--###-
#--#-#--#-#--#-#--#-#--#-#--#-#--#-#--#-#--#-#--#-#--#-#--#-#--#-#--#-#--#-#--#-#--#-#--#-#--#-#--#-
-#----#----#----#----#----#----#----#----#----#----#----#----#----#----#----#----#----#----#----#---
----------------------------------------------------------------------------------------------------
----------------------------------------------------------------------------------------------------
-###--###--###--###--###--###--###--###--###--###--###--###--###--###--###--###--###--###--###--###-
#--#-#--#-#--#-#--#-#--#-#--#-#--#-#--#-#--#-#--#-#--#-#--#-#--#-#--#-#--#-#--#-#--#-#--#-#--#-#--#-
-#----#----#----#----#----#----#----#----#----#----#----#----#----#----#----#----#----#----#----#---
----------------------------------------------------------------------------------------------------
----------------------------------------------------------------------------------------------------
-###--###--###--###--###--###--###--###--###--###--###--###--###--###--###--###--###--###--###--###-
#--#-#--#-#--#-#--#-#--#-#--#-#--#-#--#-#--#-#--#-#--#-#--#-#--#-#--#-#--#-#--#-#--#-#--#-#--#-#--#-
-#----#----#----#----#----#----#----#----#----#----#----#----#----#----#----#----#----#----#----#---
----------------------------------------------------------------------------------------------------
----------------------------------------------------------------------------------------------------
-###--###--###--###--###--###--###--###--###--###--###--###--###--###--###--###--###--###--###--###-
#--#-#--#-#--#-#--#-#--#-#--#-#--#-#--#-#--#-#--#-#--#-#--#-#--#-#--#-#--#-#--#-#--#-#--#-#--#-#--#-
-#----#----#----#----#----#----#----#----#----#----#----#----#----#----#----#----#----#----#----#---
----------------------------------------------------------------------------------------------------
----------------------------------------------------------------------------------------------------
-###--###--###--###--###--###--###--###--###--###--###--###--###--###--###--###--###--###--###--###-
#--#-#--#-#--#-#--#-#--#-#--#-#--#-#--#-#--#-#--#-#--#-#--#-#--#-#--#-#--#-#--#-#--#-#--#-#--#-#--#-
-#----#----#----#----#----#----#----#----#----#----#----#----#----#----#----#----#----#----#----#---
----------------------------------------------------------------------------------------------------
----------------------------------------------------------------------------------------------------
-###--###--###--###--###--###--###--###--###--###--###--###--###--###--###--###--###--###--###--###-
#--#-#--#-#--#-#--#-#--#-#--#-#--#-#--#-#--#-#--#-#--#-#--#-#--#-#--#-#--#-#--#-#--#-#--#-#--#-#--#-
-#----#----#----#----#----#----#----#----#----#----#----#----#----#----#----#----#----#----#----#---
----------------------------------------------------------------------------------------------------
----------------------------------------------------------------------------------------------------
-###--###--###--###--###--###--###--###--###--###--###--###--###--###--###--###--###--###--###--###-
#--#-#--#-#--#-#--#-#--#-#--#-#--#-#--#-#--#-#--#-#--#-#--#-#--#-#--#-#--#-#--#-#--#-#--#-#--#-#--#-
-#----#----#----#----#----#----#----#----#----#----#----#----#----#----#----#----#----#----#----#---