?diagonal=Never;
-#----#----#----#----#----#----#----#----#----#----#----#----#----#----#----#----#----#----#----#---
----------------------------------------------------------------------------------------------------
###-####-####-####-####-####-####-####-####-####-####-####-####-####-####-####-####-####-####-####-#
----#----#----#----#----#----#----#----#----#----#----#----#----#----#----#----#----#----#----#----#
----#----#----#----#----#----#----#----#----#----#----#----#----#----#----#----#----#----#----#----#
-#----#----#----#----#----#----#----#----#----#----#----#----#----#----#----#----#----#----#----#---
----------------------------------------------------------------------------------------------------
###-####-####-####-####-####-####-####-####-####-####-####-####-####-####-####-####-####-####-####-#
----#----#----#----#----#----#----#----#----#----#----#----#----#----#----#----#----#----#----#----#
----#----#----#----#----#----#----#----#----#----#----#----#----#----#----#----#----#----#----#----#
-#----#----#----#----#----#----#----#----#----#----#----#----#----#----#----#----#----#----#----#---
----------------------------------------------------------------------------------------------------
###-####-####-####-####-####-####-####-####-####-####-####-####-####-####-####-####-####-####-####-#
----#----#----#----#----#----#----#----#----#----#----#----#----#----#----#----#----#----#----#----#
----#----#----#----#----#----#----#----#----#----#----#----#----#----#----#----#----#----#----#----#
-#----#----#----#----#----#----#----#----#----#----#----#----#----#----#----#----#----#----#----#---
----------------------------------------------------------------------------------------------------
###-####-####-####-####-####-####-####-####-####-####-####-####-####-####-####-####-####-####-####-#
----#----#----#----#----#----#----#----#----#----#----#----#----#----#----#----#----#----#----#----#
----#----#----#----#----#----#----#----#----#----#----#----#----#----#----#----#----#----#----#----#
-#----#----#----#----#----#----#----#----#----#----#----#----#----#----#----#----#----#----#----#---
----------------------------------------------------------------------------------------------------
###-####-####-####-####-####-####-####-####-####-####-####-####-####-####-####-####-####-####-####-#
----#----#----#----#----#----#----#----#----#----#----#----#----#----#----#----#----#----#----#----#
----#----#----#----#----#----#----#----#----#----#----#----#----#----#----#----#----#----#----#----#
-#----#----#----#----#----#----#----#----#----#----#----#----#----#----#----#----#----#----#----#---
----------------------------------------------------------------------------------------------------
###-####-####-####-####-####-####-####-####-####-####-####-####-####-####-####-####-####-####-####-#
----#----#----#----#----#----#----#----#----#----#----#----#----#----#----#----#----#----#----#----#
----#----#----#----#----#----#----#----#----#----#----#----#----#----#----#----#----#----#----#----#
-#----#----#----#----#----#----#----#----#----#----#----#----#----#----#----#----#----#----#----#---
----------------------------------------------------------------------------------------------------
###-####-####-####-####-####-####-####-####-####-####-####-####-####-####-####-####-####-####-####-#
----#----#-E--#----#----#----#----#----#----#----#----#----#----#----#----#----#----#----#----#----#
----#----#----#----#----#----#----#----#----#----#----#----#----#----#----#----#----#----#----#----#
-#----#----#----#----#----#----#----#----#----#----#----#----#----#----#----#----#----#----#----#---
----------------------------------------------------------------------------------------------------
###-####-####-####-####-####-####-####-####-####-####-####-####-####-####-####-####-####-####-####-#
----#----#----#----#----#----#----#----#----#----#----#----#----#----#----#----#----#----#----#----#
----#----#----#----#----#----#----#----#----#----#----#----#----#----#----#----#----#----#----#----#
-#----#----#----#----#----#----#----#----#----#----#----#----#----#----#----#----#----#----#----#---
----------------------------------------------------------------------------------------------------
###-####-####-####-####-####-####-####-####-####-####-####-####-####-####-####-####-####-####-####-#
----#----#----#----#----#----#----#----#----#----#----#----#----#----#----#----#----#----#----#----#
----#----#----#----#----#----#----#----#----#----#----#----#----#----#----#----#----#----#----#----#
-#----#----#----#----#----#----#----#----#----#----#----#----#----#----#----#----#----#----#----#---
----------------------------------------------------------------------------------------------------
###-####-####-####-####-####-####-####-####-####-####-####-####-####-####-####-####-####-####-####-#
----#----#----#----#----#----#----#----#----#----#----#----#----#----#----#----#----#----#----#----#
----#----#----#----#----#----#----#----#----#----#----#----#----#----#----#----#----#----#----#----#
-#----#----#----#----#----#----#----#----#----#----#----#----#----#----#----#----#----#----#----#---
----------------------------------------------------------------------------------------------------
###-####-####-####-####-####-####-####-####-####-####-####-####-####-####-####-####-####-####-####-#
----#----#----#----#----#----#----#----#----#----#----#----#----#----#----#----#----#----#----#----#
----#----#----#----#----#----#----#----#----#----#----#----#----#----#----#----#----#----#----#----#
-#----#----#----#----#----#----#----#----#----#----#----#----#----#----#----#----#----#----#----#---
----------------------------------------------------------------------------------------------------
###-####-####-####-####-####-####-####-####-####-####-####-####-####-####-####-####-####-####-####-#
----#----#----#----#----#----#----#----#----#--S-#----#----#----#----#----#----#----#----#----#----#
----#----#----#----#----#----#----#----#----#----#----#----#----#----#----#----#----#----#----#----#
-#----#----#----#----#----#----#----#----#----#----#----#----#----#----#----#----#----#----#----#---
----------------------------------------------------------------------------------------------------
###-####-####-####-####-####-####-####-####-####-####-####-####-####-####-####-####-####-####-####-#
----#----#----#----#----#----#----#----#----#----#----#----#----#----#----#----#----#----#----#----#
----#----#----#----#----#----#----#----#----#----#----#----#----#----#----#----#----#----#----#----#
-#----#----#----#----#----#----#----#----#----#----#----#----#----#----#----#----#----#----#----#---
----------------------------------------------------------------------------------------------------
###-####-####-####-####-####-####-####-####-####-####-####-####-####-####-####-####-####-####-####-#
----#----#----#----#----#----#----#----#----#----#----#----#----#----#----#----#----#----#----#----#
----#----#----#----#----#----#----#----#----#----#----#----#----#----#----#----#----#----#----#----#
-#----#----#----#----#----#----#----#----#----#----#----#----#----#----#----#----#----#----#----#---
----------------------------------------------------------------------------------------------------
###-####-####-####-####-####-####-####-####-####-####-####-####-####-####-####-####-####-####-####-#
----#----#----#----#----#----#----#----#----#----#----#----#----#----#----#----#----#----#----#----#
----#----#----#----#----#----#----#----#----#----#----#----#----#----#----#----#----#----#----#----#
-#----#----#----#----#----#----#----#----#----#----#----#----#----#----#----#----#----#----#----#---
----------------------------------------------------------------------------------------------------
###-####-####-####-####-####-####-####-####-####-####-####-####-####-####-####-####-####-####-####-#
----#----#----#----#----#----#----#----#----#----#----#----#----#----#----#----#----#----#----#----#
----#----#----#----#----#----#----#----#----#----#----#----#----#----#----#----#----#----#----#----#
-#----#----#----#----#----#----#----#----#----#----#----#----#----#----#----#----#----#----#----#---
----------------------------------------------------------------------------------------------------
###-####-####-####-####-####-####-####-####-####-####-####-####-####-####-####-####-####-####-####-#
----#----#----#----#----#----#----#----#----#----#----#----#----#----#----#----#----#----#----#----#
----#----#----#----#----#----#----#----#----#----#----#----#----#----#----#----#----#----#----#----#
-#----#----#----#----#----#----#----#----#----#----#----#----#----#----#----#----#----#----#----#---
----------------------------------------------------------------------------------------------------
###-####-####-####-####-####-####-####-####-####-####-####-####-####-####-####-####-####-####-####-#
----#----#----#----#----#----#----#----#----#----#----#----#----#----#----#----#----#----#----#----#
----#----#----#----#----#----#----#----#----#----#----#----#----#----#----#----#----#----#----#----#
-#----#----#----#----#----#----#----#----#----#----#----#----#----#----#----#----#----#----#----#---
----------------------------------------------------------------------------------------------------
###-####-####-####-####-####-####-####-####-####-####-####-####-####-####-####-####-####-####-####-#
----#----#----#----#----#----#----#----#----#----#----#----#----#----#----#----#----#----#----#----#
----#----#----#----#----#----#----#----#----#----#----#----#----#----#----#----#----#----#----#----#
-#----#----#----#----#----#----#----#----#----#----#----#----#----#----#----#----#----#----#----#---
----------------------------------------------------------------------------------------------------
###-####-####-####-####-####-####-####-####-####-####-####-####-####-####-####-####-####-####-####-#
----#----#----#----#----#----#----#----#----#----#----#----#----#----#----#----#----#----#----#----#
----#----#----#----#----#----#----#----#----#----#----#----#----#----#----#----#----#----#----#----#