?diagonal=Never;
---##---##---##---##---##---##---##---##---##---##---##---##---##---##---##---##---##---##---##---##
#-####-####-####-####-####-####-####-####-####-####-####-####-####-####-####-####-####-####-####-###
----------------------------------------------------------------------------------------------------
--#----#----#----#----#----#----#----#----#----#----#----#----#----#----#----#----#----#----#----#--
----------------------------------------------------------------------------------------------------
---##---##---##---##---##---##---##---##---##---##---##---##---##---##---##---##---##---##---##---##
#-####-####-####-####-####-####-####-####-####-####-####-####-####-####-####-####-####-####-####-###
----------------------------------------------------------------------------------------------------
--#----#----#----#----#----#----#----#----#----#----#----#----#----#----#----#----#----#----#----#--
----------------------------------------------------------------------------------------------------
---##---##---##---##---##---##---##---##---##---##---##---##---##---##---##---##---##---##---##---##
#-####-####-####-####-####-####-####-####-####-####-####-####-####-####-####-####-####-####-####-###
----------------------------------------------------------------------------------------------------
--#----#----#----#----#----#----#----#----#----#----#----#----#----#----#----#----#----#----#----#--
---------------------------------------------E------------------------------------------------------
---##---##---##---##---##---##---##---##---##---##---##---##---##---##---##---##---##---##---##---##
#-####-####-####-####-####-####-####-####-####-####-####-####-####-####-####-####-####-####-####-###
----------------------------------------------------------------------------------------------------
--#----#----#----#----#----#----#----#----#----#----#----#----#----#----#----#----#----#----#----#--
----------------------------------------------------------------------------------------------------
---##---##---##---##---##---##---##---##---##---##---##---##---##---##---##---##---##---##---##---##
#-####-####-####-####-####-####-####-####-####-####-####-####-####-####-####-####-####-####-####-###
----------------------------------------------------------------------------------------------------
--#----#----#----#----#----#----#----#----#----#----#----#----#----#----#----#----#----#----#----#--
----------------------------------------------------------------------------------------------------
---##---##---##---##---##---##---##---##---##---##---##---##---##---##---##---##---##---##---##---##
#-####-####-####-####-####-####-####-####-####-####-####-####-####-####-####-####-####-####-####-###
----------------------------------------------------------------------------------------------------
--#----#----#----#----#----#----#----#----#----#----#----#----#----#----#----#----#----#----#----#--
----------------------------------------------------------------------------------------------------
---##---##---##---##---##---##---##---##---##---##---##---##---##---##---##---##---##---##---##---##
#-####-####-####-####-####-####-####-####-####-####-####-####-####-####-####-####-####-####-####-###
----------------------------------------------------------------------------------------------------
--#----#----#----#----#----#----#----#----#----#----#----#----#----#----#----#----#----#----#----#--
----------------------------------------------------------------------------------------------------
---##---##---##---##---##---##---##---##---##---##---##---##---##---##---##---##---##---##---##---##
#-####-####-####-####-####-####-####-####-####-####-####-####-####-####-####-####-####-####-####-###
----------------------------------------------------------------------------------------------------
--#----#----#----#----#----#----#----#----#----#----#----#----#----#----#----#----#----#----#----#--
----------------------------------------------------------------------------------------------------
---##---##---##---##---##---##---##---##---##---##---##---##---##---##---##---##---##---##---##---##
#-####-####-####-####-####-####-####-####-####-####-####-####-####-####-####-####-####-####-####-###
----------------------------------------------------------------------------------------------------
--#----#----#----#----#----#----#----#----#----#----#----#----#----#----#----#----#----#----#----#--
----------------------------------------------------------------------------------------------------
---##---##---##---##---##---##---##---##---##---##---##---##---##---##---##---##---##---##---##---##
#-####-####-####-####-####-####-####-####-####-####-####-####-####-####-####-####-####-####-####-###
----------------------------------------------------------------------------------------------------
--#----#----#----#----#----#----#----#----#----#----#----#----#----#----#----#----#----#----#----#--
----------------------------------------------------------------------------------------------------
---##---##---##---##---##---##---##---##---##---##---##---##---##---##---##---##---##---##---##---##
#-####-####-####-####-####-####-####-####-####-####-####-####-####-####-####-####-####-####-####-###
----------------------------------------------------------------------------------------------------
--#----#----#----#----#----#----#----#----#----#----#----#----#----#----#----#----#----#----#----#--
----------------------------------------------------------------------------------------------------
---##---##---##---##---##---##---##---##---##---##---##---##---##---##---##---##---##---##---##---##
#-####-####-####-####-####-####-####-####-####-####-####-####-####-####-####-####-####-####-####-###
----------------------------------------------------------------------------------------------------
--#----#----#----#----#----#----#----#----#----#----#----#----#----#----#----#----#----#----#----#--
----------------------------------------------------------------------------------------------------
---##---##---##---##---##---##---##---##---##---##---##---##---##---##---##---##---##---##---##---##
#-####-####-####-####-####-####-####-####-####-####-####-####-####-####-####-####-####-####-####-###
----------------------------------------------------------------------------------------------------
--#----#----#----#----#----#----#----#----#----#----#----#----#----#----#----#----#----#----#----#--
----------------------------------------------------------------------------------------------------
---##---##---##---##---##---##---##---##---##---##---##---##---##---##---##---##---##---##---##---##
#-####-####-####-####-####-####-####-####-####-####-####-####-####-####-####-####-####-####-####-###
----------------------------------------------------------------------------------------------------
--#----#----#----#----#----#----#----#----#----#----#----#----#----#----#----#----#----#----#----#--
----------------------------------------------------------------------------------------------------
---##---##---##---##---##---##---##---##---##---##---##---##---##---##---##---##---##---##---##---##
#-####-####-####-####-####-####-####-####-####-####-####-####-####-####-####-####-####-####-####-###
----------------------------------------------------------------------------------------------------
--#----#----#----#----#----#----#----#----#----#----#----#----#----#----#----#----#----#----#----#--
----------------------------------------------------------------------------------------------------
---##---##---##---##---##---##---##---##---##---##---##---##---##---##---##---##---##---##---##---##
#-####-####-####-####-####-####-####-####-####-####-####-####-####-####-####-####-####-####-####-###
----------------------------------------------------------------------------------------------------
--#----#----#----#----#----#----#----#----#----#----#----#----#----#----#----#----#----#----#----#--
----------------------------------------------------------------------------------------------------
---##---##---##---##---##---##---##---##---##---##---##---##---##---##---##---##---##---##---##---##
#-####-####-####-####-####-####-####-####-####-####-####-####-####-####-####-####-####-####-####-###
----------------------------------------------------------------------------------------------------
--#----#----#----#----#----#----#----#----#----#----#----#----#----#----#----#----#----#----#----#--
----------------------------------------------------------------------------------------------------
---##---##---##---##---##---##---##---##---##---##---##---##---##---##---##---##---##---##---##---##
#-####-####-####-####-####-####-####-####-####-####-####-####-####-####-####-####-####-####-####-###
----------------------------------------------------------------------------------------------------
--#----#----#----#----#----#----#----#----#----#----#----#----#----#----#----#----#----#---S#----#--
----------------------------------------------------------------------------------------------------
---##---##---##---##---##---##---##---##---##---##---##---##---##---##---##---##---##---##---##---##
#-####-####-####-####-####-####-####-####-####-####-####-####-####-####-####-####-####-####-####-###
----------------------------------------------------------------------------------------------------
--#----#----#----#----#----#----#----#----#----#----#----#----#----#----#----#----#----#----#----#--
----------------------------------------------------------------------------------------------------
---##---##---##---##---##---##---##---##---##---##---##---##---##---##---##---##---##---##---##---##
#-####-####-####-####-####-####-####-####-####-####-####-####-####-####-####-####-####-####-####-###
----------------------------------------------------------------------------------------------------
--#----#----#----#----#----#----#----#----#----#----#----#----#----#----#----#----#----#----#----#--
----------------------------------------------------------------------------------------------------