?diagonal=Never;
#-##-#-##-#-##-#-##-#-##-#-##-#-##-#-##-#-##-#-##-#-##-#-##-#-##-#-##-#-##-#-##-#-##-#-##-#-##-#-##-
----#----#----#----#----#----#----#----#----#----#----#----#----#----#----#----#----#----#----#----#
-#----#----#----#----#----#----#----#----#----#----#----#----#----#----#----#----#----#----#----#---
-#----#----#----#----#----#----#----#----#----#----#----#----#----#----#----#----#----#----#----#---
---#----#----#----#----#----#----#----#----#----#----#----#----#----#----#----#----#----#----#----#-
#-##-#-##-#-##-#-##-#-##-#-##-#-##-#-##-#-##-#-##-#-##-#-##-#-##-#-##-#-##-#-##-#-##-#-##-#-##-#-##-
----#----#----#----#----#----#----#----#----#----#----#----#----#----#----#----#----#----#----#----#
-#----#----#----#----#----#----#----#----#----#----#----#----#----#----#----#----#----#----#----#---
-#----#----#----#----#----#----#----#----#----#----#----#----#----#----#----#----#----#----#----#---
---#----#----#----#----#----#----#----#----#----#----#----#----#----#----#----#----#----#----#----#-
#-##-#-##-#-##-#-##-#-##-#-##-#-##-#-##-#-##-#-##-#-##-#-##-#-##-#-##-#-##-#-##-#-##-#-##-#-##-#-##-
----#----#----#----#----#----#----#----#----#----#----#----#----#----#----#----#----#----#----#----#
-#----#----#----#----#----#----#----#----#----#----#----#----#----#----#----#----#----#----#----#---
-#----#----#----#----#----#----#----#----#----#----#----#----#----#----#----#----#----#----#----#---
---#----#----#----#----#----#----#----#----#----#----#----#----#----#----#----#----#----#----#----#-
#-##-#-##-#-##-#-##-#-##-#-##-#-##-#-##-#-##-#-##-#-##-#-##-#-##-#-##-#-##-#-##-#-##-#-##-#-##-#-##-
----#----#----#----#----#----#----#----#----#----#----#----#----#----#----#----#----#----#----#----#
-#----#----#----#----#----#----#----#----#----#----#----#----#----#----#----#----#----#----#----#---
-#----#----#----#----#----#----#----#----#----#----#----#----#----#----#----#----#----#----#----#---
---#----#----#----#----#----#----#----#----#----#----#----#----#----#----#----#----#----#----#----#-
#-##-#-##-#-##-#-##-#-##-#-##S#-##-#-##-#-##-#-##-#-##-#-##-#-##-#-##-#-##-#-##-#-##-#-##-#-##-#-##-
----#----#----#----#----#----#----#----#----#----#----#----#----#----#----#----#----#----#----#----#
-#----#----#----#----#----#----#----#----#----#----#----#----#----#----#----#----#----#----#----#---
-#----#----#----#----#----#----#----#----#----#----#----#----#----#----#----#----#----#----#----#---
---#----#----#----#----#----#----#----#----#----#----#----#----#----#----#----#----#----#----#----#-
#-##-#-##-#-##-#-##-#-##-#-##-#-##-#-##-#-##-#-##-#-##-#-##-#-##-#-##-#-##-#-##-#-##-#-##-#-##-#-##-
----#----#----#----#----#----#----#----#----#----#----#----#----#----#----#----#----#----#----#----#
-#----#----#----#----#----#----#----#----#----#----#----#----#----#----#----#----#----#----#----#---
-#----#----#----#----#----#----#----#----#----#----#----#----#----#----#----#----#----#----#----#---
---#----#----#----#----#----#----#----#----#----#----#----#----#----#----#----#----#----#----#----#-
#-##-#-##-#-##-#-##-#-##-#-##-#-##-#-##-#-##-#-##-#-##-#-##-#-##-#-##-#-##-#-##-#-##-#-##-#-##-#-##-
----#----#----#----#----#----#----#----#----#----#----#----#----#----#----#----#----#----#----#----#
-#----#----#----#----#----#----#----#----#----#----#----#----#----#----#----#----#----#----#----#---
-#----#----#----#----#----#----#----#----#----#----#----#----#----#----#----#----#----#----#----#---
---#----#----#----#----#----#----#----#----#----#----#----#----#----#----#----#----#----#----#----#-
#-##-#-##-#-##-#-##-#-##-#-##-#-##-#-##-#-##-#-##-#-##-#-##-#-##-#-##-#-##-#-##-#-##-#-##-#-##-#-##-
----#----#----#----#----#----#----#----#----#----#----#----#----#----#----#----#----#----#----#----#
-#----#----#----#----#----#----#----#----#----#----#----#----#----#----#----#----#----#----#----#---
-#----#----#----#----#----#----#----#----#----#----#----#----#----#----#----#----#----#----#----#---
---#----#----#----#----#----#----#----#----#----#----#----#----#----#----#----#----#----#----#----#-
#-##-#-##-#-##-#-##-#-##-#-##-#-##-#-##-#-##-#-##-#-##-#-##-#-##-#-##-#-##-#-##-#-##-#-##-#-##-#-##-
----#----#----#----#----#----#----#----#----#----#----#----#----#----#----#----#----#----#----#----#
-#----#----#----#----#----#----#----#----#----#----#----#----#----#----#----#----#----#----#----#---
-#----#----#----#----#----#----#----#----#----#----#----#----#----#----#----#----#----#----#----#---
---#----#----#----#----#----#----#----#----#----#----#----#----#----#----#----#----#----#----#----#-
#-##-#-##-#-##-#-##-#-##-#-##-#-##-#-##-#-##-#-##-#-##-#-##-#-##-#-##-#-##-#-##-#-##-#-##-#-##-#-##-
----#----#----#----#----#----#----#----#----#----#----#----#----#----#----#----#----#----#----#----#
-#----#----#----#----#----#----#----#----#----#----#----#----#----#----#----#----#----#----#----#---
-#----#----#----#----#----#----#----#----#----#----#----#----#----#----#----#----#----#----#----#---
---#----#----#----#----#----#----#----#----#----#----#----#----#----#----#----#----#----#----#----#-
#-##-#-##-#-##-#-##-#-##-#-##-#-##-#-##-#-##-#-##-#-##-#-##-#-##-#-##-#-##-#-##-#-##-#-##-#-##-#-##-
----#----#----#----#----#----#----#----#----#----#----#----#----#----#----#----#----#----#----#----#
-#----#----#----#----#----#----#----#----#----#----#----#----#----#----#----#----#----#----#----#---
-#----#----#----#----#----#----#----#----#----#----#----#----#----#----#----#----#----#----#----#---
---#----#----#----#----#----#----#----#----#----#----#----#----#----#----#----#----#----#----#----#-
#-##-#-##-#-##-#-##-#-##-#-##-#-##-#-##-#-##-#-##-#-##-#-##-#-##-#-##-#-##-#-##-#-##-#-##-#-##-#-##-
----#----#----#----#----#----#----#----#----#----#----#----#----#----#----#----#----#----#----#----#
-#----#----#----#----#----#----#----#----#----#----#----#----#----#----#----#----#----#----#----#---
-#----#----#----#----#----#----#----#----#----#----#----#----#----#----#----#----#----#----#----#---
---#----#----#----#----#----#----#----#----#----#----#----#----#----#----#----#----#----#----#----#-
#-##-#-##-#-##-#-##-#-##-#-##-#-##-#-##-#-##-#-##-#-##-#-##-#-##-#-##-#-##-#-##-#-##-#-##-#-##-#-##-
----#----#----#----#----#----#----#----#----#----#----#----#----#----#----#----#----#----#----#----#
-#----#----#----#----#----#----#----#----#----#----#----#----#----#----#----#----#----#----#----#---
-#----#----#----#----#----#----#----#----#----#----#----#----#----#----#----#----#----#----#----#---
---#----#----#----#----#----#----#----#----#----#----#----#----#----#----#----#----#----#----#----#-
#-##-#-##-#-##-#-##-#-##-#-##-#-##-#-##-#-##-#-##-#-##-#-##-#-##-#-##-#-##-#-##-#-##-#-##-#-##-#-##-
----#----#----#----#----#----#----#----#----#----#----#----#----#----#----#----#----#----#----#----#
-#----#----#----#----#----#----#----#----#----#----#----#----#----#----#----#----#----#----#----#---
-#----#----#----#----#----#----#----#----#----#----#----#----#----#----#----#----#----#----#----#---
---#----#----#----#----#----#----#----#----#----#----#----#----#----#----#----#----#----#----#----#-
#-##-#-##-#-##-#-##-#-##-#-##-#-##-#-##-#-##-#-##-#-##-#-##-#-##-#-##-#-##-#-##-#-##-#-##-#-##-#-##-
----#----#----#----#----#----#----#----#----#----#----#----#----#----#----#----#----#----#----#----#
-#----#----#----#----#----#----#----#----#----#----#----#----#----#----#----#----#----#----#----#---
-#----#----#----#----#----#----#----#----#----#----#----#----#----#----#----#----#----#----#----#---
---#----#----#----#----#----#----#----#----#----#----#----#----#----#----#----#----#----#----#----#-
#-##-#-##-#-##-#-##-#-##-#-##-#-##-#-##-#-##-#-##-#-##-#-##-#-##-#-##-#-##-#-##-#-##-#-##-#-##-#-##-
----#----#----#----#----#----#----#----#----#----#----#----#----#----#----#----#----#----#----#----#
-#----#----#----#----#----#----#----#----#----#----#----#----#----#----#----#----#----#----#----#---
-#----#----#----#----#----#----#----#----#----#----#----#----#----#----#----#----#----#----#----#---
---#----#----#----#----#----#----#----#----#----#----#----#----#----#----#----#----#----#----#----#-
#-##-#-##-#-##-#-##-#-##-#-##-#-##-#-##-#-##-#-##-#-##-#-##-#-##-#-##-#-##-#-##-#-##-#-##-#-##-#-##-
----#----#----#----#----#----#----#----#----#----#----#----#----#----#----#----#----#----#----#----#
-#----#----#----#----#----#----#----#----#----#----#----#----#----#----#----#----#----#----#----#---
-#----#----#----#----#----#----#----#----#----#----#----#----#----#----#----#----#----#----#----#---
---#----#----#----#----#----#----#----#----#----#----#----#----#----#----#----#----#----#----#----#-
#-##-#-##-#-##-#-##-#-##-#-##-#-##-#-##-#-##-#-##-#-##-#-##-#-##-#-##-#-##-#-##-#-##-#-##-#-##-#-##-
----#----#---E#----#----#----#----#----#----#----#----#----#----#----#----#----#----#----#----#----#
-#----#----#----#----#----#----#----#----#----#----#----#----#----#----#----#----#----#----#----#---
-#----#----#----#----#----#----#----#----#----#----#----#----#----#----#----#----#----#----#----#---
---#----#----#----#----#----#----#----#----#----#----#----#----#----#----#----#----#----#----#----#-
#-##-#-##-#-##-#-##-#-##-#-##-#-##-#-##-#-##-#-##-#-##-#-##-#-##-#-##-#-##-#-##-#-##-#-##-#-##-#-##-
----#----#----#----#----#----#----#----#----#----#----#----#----#----#----#----#----#----#----#----#
-#----#----#----#----#----#----#----#----#----#----#----#----#----#----#----#----#----#----#----#---
-#----#----#----#----#----#----#----#----#----#----#----#----#----#----#----#----#----#----#----#---
---#----#----#----#----#----#----#----#----#----#----#----#----#----#----#----#----#----#----#----#-
#-##-#-##-#-##-#-##-#-##-#-##-#-##-#-##-#-##-#-##-#-##-#-##-#-##-#-##-#-##-#-##-#-##-#-##-#-##-#-##-
----#----#----#----#----#----#----#----#----#----#----#----#----#----#----#----#----#----#----#----#
-#----#----#----#----#----#----#----#----#----#----#----#----#----#----#----#----#----#----#----#---
-#----#----#----#----#----#----#----#----#----#----#----#----#----#----#----#----#----#----#----#---
---#----#----#----#----#----#----#----#----#----#----#----#----#----#----#----#----#----#----#----#-