?diagonal=Never;
-##---##---##---##---##---##---##---##---##---##---##---##---##---##---##---##---##---##---##---##--
-#-#--#-#--#-#--#-#--#-#--#-#--#-#--#-#--#-#--#-#--#-#--#-#--#-#--#-#--#-#--#-#--#-#--#-#--#-#--#-#-
-#----#----#----#----#----#----#----#----#----#----#----#----#----#----#----#----#----#----#----#---
--##---##---##---##---##---##---##---##---##---##---##---##---##---##---##---##---##---##---##---##-
----#----#----#----#----#----#----#----#----#----#----#----#----#----#----#----#----#----#----#----#
-##---##---##---##---##---##---##---##---##---##---##---##---##---##---##---##---##---##---##---##--
-#-#--#-#--#-#--#-#--#-#--#-#--#-#--#-#--#-#--#-#--#-#--#-#--#-#--#-#--#-#--#-#--#-#--#-#--#-#--#-#-
-#----#----#----#----#----#----#----#----#----#----#----#----#----#----#----#----#----#----#----#---
--##---##---##---##---##---##---##---##---##---##---##---##---##---##---##---##---##---##---##---##-
----#----#----#----#----#----#----#----#----#----#----#----#----#----#----#----#----#----#----#----#
-##---##---##---##---##---##---##---##---##---##---##---##---##---##---##---##---##---##---##---##--
-#-#--#-#--#-#--#-#--#-#--#-#--#-#--#-#--#-#--#-#--#-#--#-#--#-#--#-#--#-#--#-#--#-#--#-#--#-#--#-#-
-#----#----#----#----#----#----#----#----#----#----#----#----#----#----#----#----#----#----#----#---
--##---##---##---##---##---##---##---##---##---##---##---##---##---##---##---##---##---##---##---##-
----#----#----#----#----#----#----#----#----#----#----#----#----#----#----#----#----#----#----#----#
-##---##---##---##---##---##---##---##---##---##---##---##---##---##---##---##---##---##---##---##--
-#-#--#-#--#-#--#-#--#-#--#-#--#-#--#-#--#-#--#-#--#-#--#-#--#-#--#-#--#-#--#-#--#-#--#-#--#-#--#-#-
-#----#----#----#----#----#----#----#----#----#----#----#----#----#----#----#----#----#----#----#---
--##---##---##---##---##---##---##---##---##---##---##---##---##---##---##---##---##---##---##---##-
----#----#----#----#----#----#----#----#----#----#----#----#----#----#----#----#----#----#----#----#
-##---##---##---##---##---##---##---##---##---##---##---##---##---##---##---##---##---##---##---##--
-#-#--#-#--#-#--#-#--#-#--#-#--#-#--#-#--#-#--#-#--#-#--#-#--#-#--#-#--#-#--#-#--#-#--#-#--#-#--#-#-
-#----#----#----#----#----#----#----#----#----#----#----#----#----#----#----#----#----#----#----#---
--##---##---##---##---##---##---##---##---##---##---##---##---##---##---##---##---##---##---##---##-
----#----#----#----#----#----#----#----#----#----#----#----#----#----#----#----#----#----#----#----#
-##---##---##---##---##---##---##---##---##---##---##---##---##---##---##---##---##---##---##---##--
-#-#--#-#--#-#--#-#--#-#--#-#--#-#--#-#--#-#--#-#--#-#--#-#--#-#--#-#--#-#--#-#--#-#--#-#--#-#--#-#-
-#----#----#----#----#----#----#----#----#----#----#----#----#----#----#----#----#----#----#----#---
--##---##---##---##---##---##---##---##---##---##---##---##---##---##---##---##---##---##---##---##-
----#----#----#----#----#----#----#----#----#----#----#----#----#----#----#----#----#----#----#----#
-##---##---##---##---##---##---##---##---##---##---##---##---##---##---##---##---##---##---##---##--
-#-#--#-#--#-#--#-#--#-#--#-#--#-#--#-#--#-#--#-#--#-#--#-#--#-#--#-#--#-#--#-#--#-#--#-#--#-#--#-#-
-#----#----#----#----#----#----#----#----#----#----#----#----#----#----#----#----#----#----#----#---
--##---##---##---##---##---##---##---##---##---##---##---##---##---##---##---##---##---##---##---##-
----#----#----#----#----#----#----#----#----#----#----#----#----#----#----#----#----#----#----#----#
-##---##---##---##---##---##---##---##---##---##---##---##---##---##---##---##---##---##---##---##--
-#-#--#-#--#-#--#-#--#-#--#-#--#-#--#-#--#-#--#-#--#-#--#-#--#-#--#-#--#-#--#-#--#-#--#-#--#-#--#-#-
-#----#----#----#----#----#----#----#----#----#----#----#----#----#----#----#----#----#----#----#---
--##---##---##---##---##---##---##---##---##---##---##---##---##---##---##---##---##---##---##---##-
----#----#----#----#----#----#----#----#----#----#----#----#----#----#----#----#----#----#----#----#
-##---##---##---##---##---##---##---##---##---##---##---##---##---##---##---##---##---##---##---##--
-#-#--#-#--#-#--#-#--#-#--#-#--#-#--#-#--#-#--#-#--#-#--#-#--#-#--#-#--#-#--#-#--#-#--#-#--#-#--#-#-
-#----#----#----#----#----#----#----#----#----#----#----#----#----#----#----#----#----#----#----#---
--##---##---##---##---##---##---##---##---##---##---##---##---##---##---##---##---##---##---##---##-
----#----#----#----#----#----#----#----#----#----#----#----#----#----#----#----#----#----#----#----#
-##---##---##---##---##---##---##---##---##---##---##---##---##---##---##---##---##---##---##---##--
-#-#--#-#--#-#--#-#--#-#--#-#--#-#--#-#--#-#--#-#--#-#--#-#--#-#--#-#--#-#--#-#--#-#--#-#--#-#--#-#-
-#----#----#----#----#----#----#----#----#----#----#----#----#----#----#----#----#----#----#----#---
--##---##---##---##---##---##---##---##---##---##---##---##---##---##---##---##---##---##---##---##-
----#----#----#----#----#----#----#----#----#----#----#----#----#----#----#----#----#----#----#----#
-##---##---##---##---##---##---##---##---##---##---##---##---##---##---##---##---##---##---##---##--
-#-#--#-#--#-#--#-#--#-#--#-#--#-#--#-#--#-#--#-#--#-#--#-#--#-#--#-#--#-#--#-#--#-#--#-#--#-#--#-#-
-#----#----#----#----#----#----#----#----#--E-#----#----#----#----#----#----#----#----#----#----#---
--##---##---##---##---##---##---##---##---##---##---##---##---##---##---##---##---##---##---##---##-
----#----#----#----#----#----#----#----#----#----#----#----#----#----#----#----#----#----#----#----#
-##---##---##---##---##---##---##---##---##---##---##---##---##---##---##---##---##---##---##---##--
-#-#--#-#--#-#--#-#--#-#--#-#--#-#--#-#--#-#--#-#--#-#--#-#--#-#--#-#--#-#--#-#--#-#--#-#--#-#--#-#-
-#----#----#----#----#----#----#----#----#----#----#----#----#----#----#----#----#----#----#----#---
--##---##---##---##---##---##---##---##---##---##---##---##---##---##---##---##---##---##---##---##-
----#----#----#----#----#----#----#----#----#----#----#----#----#----#----#----#----#----#----#----#
-##---##---##---##---##---##---##---##---##---##---##---##---##---##---##---##---##---##---##---##--
-#-#--#-#--#-#--#-#--#-#--#-#--#-#--#-#--#-#--#-#--#-#--#-#--#-#--#-#--#-#--#-#--#-#--#-#--#-#--#-#-
-#----#----#----#----#----#----#----#----#----#----#----#----#----#----#----#----#----#----#----#---
--##---##---##---##---##---##---##---##---##---##---##---##---##---##---##---##---##---##---##---##-
----#----#----#----#----#----#----#----#----#----#----#----#----#----#----#----#----#----#----#----#
-##---##---##---##---##---##---##---##---##---##---##---##---##---##---##---##---##---##---##---##--
-#-#--#-#--#-#--#-#--#-#--#-#--#-#--#-#--#-#--#-#--#-#--#-#--#-#--#-#--#-#--#-#--#-#--#-#--#-#--#-#-
-#----#----#----#----#----#----#----#----#----#----#----#----#----#----#----#----#----#----#----#---
--##---##---##---##---##---##---##---##---##---##---##---##---##---##---##---##---##---##---##---##-
----#----#----#----#----#----#----#----#----#----#----#----#----#----#----#----#----#----#----#----#
-##---##---##---##---##---##---##---##---##---##---##---##---##---##---##---##---##---##---##---##--
-#-#--#-#--#-#--#-#--#-#--#-#--#-#--#-#--#-#--#-#--#-#--#-#--#-#--#-#--#-#--#-#--#-#--#-#--#-#--#-#-
-#----#----#----#----#----#----#----#----#----#----#----#----#----#----#----#----#----#----#----#---
--##---##---##---##---##---##---##---##---##---##---##---##---##---##---##---##---##---##---##---##-
----#----#----#----#----#----#----#----#----#----#----#----#----#----#----#----#----#----#----#----#
-##---##---##---##---##---##---##---##---##---##---##---##---##---##---##---##---##---##---##---##--
-#-#--#-#--#-#--#-#--#-#--#-#--#-#--#-#--#-#--#-#--#-#--#-#--#-#--#-#--#-#--#-#--#-#--#-#--#-#--#-#-
-#----#----#----#----#----#----#----#----#----#----#----#----#----#----#----#----#----#----#----#---
--##---##---##---##---##---##---##---##---##---##---##---##---##---##---##---##---##---##---##---##-
----#----#----#----#----#----#----#----#----#----#----#----#----#----#----#----#----#----#----#----#
-##---##---##---##---##---##---##---##---##---##---##---##---##---##---##---##---##---##---##---##--
-#-#--#-#--#-#--#-#--#-#--#-#--#-#--#-#--#-#--#-#--#-#--#-#--#-#--#-#--#-#--#-#--#-#--#-#--#-#--#-#-
-#----#----#----#----#----#----#----#----#----#----#----#----#----#----#----#----#----#----#----#---
--##---##---##---##---##---##---##---##---##---##---##---##---##---##---##---##---##---##---##---##-
----#----#----#----#----#----#----#----#----#----#----#----#----#----#----#----#----#----#----#----#
-##---##---##---##---##---##---##---##---##---##---##---##---##---##---##---##---##---##---##---##--
-#-#--#-#--#-#--#-#--#-#--#-#--#-#--#-#--#-#--#-#--#-#--#-#--#-#--#-#--#-#--#-#--#-#--#-#--#-#--#-#-
-#----#----#----#----#----#----#----#----#----#----#----#----#----#----#----#----#----#----#----#---
--##---##---##---##---##---##---##---##---##---##---##---##---##---##---##---##---##---##---##---##-
----#----#----#----#----#----#----#----#----#----#----#----#----#----#----#----#----#----#----#----#
-##---##---##---##---##---##---##---##---##---##---##---##---##---##---##---##---##---##---##---##--
-#-#--#-#--#-#--#-#--#-#--#-#--#-#--#-#--#-#--#-#--#-#--#-#--#-#--#-#--#-#--#-#--#-#--#-#--#-#--#-#-
-#----#----#----#----#----#----#----#----#----#----#----#----#----#----#----#----#----#----#----#---
--##---##---##---##---##---##---##---##---##---##---##---##---##---##---##---##---##---##---##---##-
----#----#----#----#----#----#----#----#----#----#----#----#----#----#----#----#----#----#----#----#
-##---##---##---##---##---##---##---##---##---##---##---##---##---##---##---##---##---##---##---##--
-#-#--#-#--#-#--#-#--#-#--#-#--#-#--#-#--#-#--#-#--#-#--#-#--#-#--#-#--#-#--#-#--#-#--#-#--#-#--#-#-
-#----#----#----#----#----#----#----#----#----#----#----#----#----#----#----#----#-S--#----#----#---
--##---##---##---##---##---##---##---##---##---##---##---##---##---##---##---##---##---##---##---##-
----#----#----#----#----#----#----#----#----#----#----#----#----#----#----#----#----#----#----#----#