?diagonal=Never;
----------------------------------------------------------------------------------------------------
##--###--###--###--###--###--###--###--###--###--###--###--###--###--###--###--###--###--###--###--#
---#----#----#----#----#----#----#----#----#----#----#----#----#----#----#----#----#----#----#----#-
---------E------------------------------------------------------------------------------------------
--#-#--#-#--#-#--#-#--#-#--#-#--#-#--#-#--#-#--#-#--#-#--#-#--#-#--#-#--#-#--#-#--#-#--#-#--#-#--#-#
----------------------------------------------------------------------------------------------------
##--###--###--###--###--###--###--###--###--###--###--###--###--###--###--###--###--###--###--###--#
---#----#----#----#----#----#----#----#----#----#----#----#----#----#----#----#----#----#----#----#-
----------------------------------------------------------------------------------------------------
--#-#--#-#--#-#--#-#--#-#--#-#--#-#--#-#--#-#--#-#--#-#--#-#--#-#--#-#--#-#--#-#--#-#--#-#--#-#--#-#
----------------------------------------------------------------------------------------------------
##--###--###--###--###--###--###--###--###--###--###--###--###--###--###--###--###--###--###--###--#
---#----#----#----#----#----#----#----#----#----#----#----#----#----#----#----#----#----#----#----#-
----------------------------------------------------------------------------------------------------
--#-#--#-#--#-#--#-#--#-#--#-#--#-#--#-#--#-#--#-#--#-#--#-#--#-#--#-#--#-#--#-#--#-#--#-#--#-#--#-#
----------------------------------------------------------------------------------------------------
##--###--###--###--###--###--###--###--###--###--###--###--###--###--###--###--###--###--###--###--#
---#----#----#----#----#----#----#----#----#----#----#----#----#----#----#----#----#----#----#----#-
----------------------------------------------------------------------------------------------------
--#-#--#-#--#-#--#-#--#-#--#-#--#-#--#-#--#-#--#-#--#-#--#-#--#-#--#-#--#-#--#-#--#-#--#-#--#-#--#-#
----------------------------------------------------------------------------------------------------
##--###--###--###--###--###--###--###--###--###--###--###--###--###--###--###--###--###--###--###--#
---#----#----#----#----#----#----#----#----#----#----#----#----#----#----#----#----#----#----#----#-
----------------------------------------------------------------------------------------------------
--#-#--#-#--#-#--#-#--#-#--#-#--#-#--#-#--#-#--#-#--#-#--#-#--#-#--#-#--#-#--#-#--#-#--#-#--#-#--#-#
----------------------------------------------------------------------------------------------------
##--###--###--###--###--###--###--###--###--###--###--###--###--###--###--###--###--###--###--###--#
---#----#----#----#----#----#----#----#----#----#----#----#----#----#----#----#----#----#----#----#-
----------------------------------------------------------------------------------------------------
--#-#--#-#--#-#--#-#--#-#--#-#--#-#--#-#--#-#--#-#--#-#--#-#--#-#--#-#--#-#--#-#--#-#--#-#--#-#--#-#
----------------------------------------------------------------------------------------------------
##--###--###--###--###--###--###--###--###--###--###--###--###--###--###--###--###--###--###--###--#
---#----#----#----#----#----#----#----#----#----#----#----#----#----#----#----#----#----#----#----#-
----------------------------------------------------------------------------------------------------
--#-#--#-#--#-#--#-#--#-#--#-#--#-#--#-#--#-#--#-#--#-#--#-#--#-#--#-#--#-#--#-#--#-#--#-#--#-#--#-#
----------------------------------------------------------------------------------------------------
##--###--###--###--###--###--###--###--###--###--###--###--###--###--###--###--###--###--###--###--#
---#----#----#----#----#----#----#----#----#----#----#----#----#----#----#----#----#----#----#----#-
----------------------------------------------------------------------------------------------------
--#-#--#-#--#-#--#-#--#-#--#-#--#-#--#-#--#-#--#-#--#-#--#-#--#-#--#-#--#-#--#-#--#-#--#-#--#-#--#-#
----------------------------------------------------------------------------------------------------
##--###--###--###--###--###--###--###--###--###--###--###--###--###--###--###--###--###--###--###--#
---#----#----#----#----#----#----#----#----#----#----#----#----#----#----#----#----#----#----#----#-
----------------------------------------------------------------------------------------------------
--#-#--#-#--#-#--#-#--#-#--#-#--#-#--#-#--#-#--#-#--#-#--#-#--#-#--#-#--#-#--#-#--#-#--#-#--#-#--#-#
----------------------------------------------------------------------------------------------------
##--###--###--###--###--###--###--###--###--###--###--###--###--###--###--###--###--###--###--###--#
---#----#----#----#----#----#----#----#----#----#----#----#----#----#----#----#----#----#----#----#-
----------------------------------------------------------------------------------------------------
--#-#--#-#--#-#--#-#--#-#--#-#--#-#--#-#--#-#--#-#--#-#--#-#--#-#--#-#--#-#--#-#--#-#--#-#--#-#--#-#
----------------------------------------------------------------------------------------------------
##--###--###--###--###--###--###--###--###--###--###--###--###--###--###--###--###--###--###--###--#
---#----#----#----#----#----#----#----#----#----#----#----#----#----#----#----#----#----#----#----#-
----------------------------------------------------------------------------------------------------
--#-#--#-#--#-#--#-#--#-#--#-#--#-#--#-#--#-#--#-#--#-#--#-#--#-#--#-#--#-#--#-#--#-#--#-#--#-#--#-#
----------------------------------------------------------------------------------------------------
##--###--###--###--###--###--###--###--###--###--###--###--###--###--###--###--###--###--###--###--#
---#----#----#----#----#----#----#----#----#----#----#----#----#----#----#----#----#----#----#----#-
----------------------------------------------------------------------------------------------------
--#-#--#-#--#-#--#-#--#-#--#-#--#-#--#-#--#-#--#-#--#-#--#-#--#-#--#-#--#-#--#-#--#-#--#-#--#-#--#-#
----------------------------------------------------------------------------------------------------
##--###--###--###--###--###--###--###--###--###--###--###--###--###--###--###--###--###--###--###--#
---#----#----#----#----#----#----#----#----#----#----#----#----#----#----#----#----#----#----#----#-
----------------------------------------------------------------------------------------------------
--#-#--#-#--#-#--#-#--#-#--#-#--#-#--#-#--#-#--#-#--#-#--#-#--#-#--#-#--#-#--#-#--#-#--#-#--#-#--#-#
----------------------------------------------------------------------------------------------------
##--###--###--###--###--###--###--###--###--###--###--###--###--###--###--###--###--###--###--###--#
---#----#----#----#----#----#----#----#----#----#----#----#----#----#----#----#----#----#----#----#-
----------------------------------------------------------------------------------------------------
--#-#--#-#--#-#--#-#--#-#--#-#--#-#--#-#--#-#--#-#--#-#--#-#--#-#--#-#--#-#--#-#--#-#--#-#--#-#--#-#
----------------------------------------------------------------------------------------------------
##--###--###--###--###--###--###--###--###--###--###--###--###--###--###--###--###--###--###--###--#
---#----#----#----#----#----#----#----#----#----#----#----#----#----#----#----#----#----#----#----#-
----------------------------------------------------------------------------------------------------
--#-#--#-#--#-#--#-#--#-#--#-#--#-#--#-#--#-#--#-#--#-#--#-#--#-#--#-#--#-#--#-#--#-#--#-#--#-#--#-#
----------------------------------------------------------------------------------------------------
##--###--###--###--###--###--###--###--###--###--###--###--###--###--###--###--###--###--###--###--#
---#----#----#----#----#----#----#----#----#----#----#----#----#----#----#----#----#----#----#----#-
----------------------------------------------------------------------------------------------------
--#-#--#-#--#-#--#-#--#-#--#-#--#-#--#-#--#-#--#-#--#-#--#-#--#-#--#-#--#-#--#-#--#-#--#-#--#-#--#-#
----------------------------------------------------------------------------------------------------
##--###--###--###--###--###--###--###--###--###--###--###--###--###--###--###--###--###--###--###--#
---#----#----#----#----#----#----#----#----#----#----#----#----#----#----#----#----#----#----#----#-
----------------------------------------------------------------------------------------------------
--#-#--#-#--#-#--#-#--#-#--#-#--#-#--#-#--#-#--#-#--#-#--#-#--#-#--#-#--#-#--#-#--#-#--#-#--#-#--#-#
----------------------------------------------------------------------------------------------------
##--###--###--###--###--###--###--###--###--###--###--###--###--###--###--###--###--###--###--###--#
---#----#----#----#----#----#----#----#----#----#----#----#----#----#----#----#----#----#----#----#-
----------------------------------------------------------------------------------------------------
--#-#--#-#--#-#--#-#--#-#--#-#--#-#--#-#--#-#--#-#--#-#--#-#--#-#--#-#S-#-#--#-#--#-#--#-#--#-#--#-#
----------------------------------------------------------------------------------------------------
##--###--###--###--###--###--###--###--###--###--###--###--###--###--###--###--###--###--###--###--#
---#----#----#----#----#----#----#----#----#----#----#----#----#----#----#----#----#----#----#----#-
----------------------------------------------------------------------------------------------------
--#-#--#-#--#-#--#-#--#-#--#-#--#-#--#-#--#-#--#-#--#-#--#-#--#-#--#-#--#-#--#-#--#-#--#-#--#-#--#-#
----------------------------------------------------------------------------------------------------
##--###--###--###--###--###--###--###--###--###--###--###--###--###--###--###--###--###--###--###--#
---#----#----#----#----#----#----#----#----#----#----#----#----#----#----#----#----#----#----#----#-
----------------------------------------------------------------------------------------------------
--#-#--#-#--#-#--#-#--#-#--#-#--#-#--#-#--#-#--#-#--#-#--#-#--#-#--#-#--#-#--#-#--#-#--#-#--#-#--#-#