?diagonal=Never;
-#----#----#----#----#----#----#----#----#----#----#----#----#----#----#----#----#----#----#----#---
--#----#----#----#----#----#----#----#----#----#----#----#----#----#----#----#----#----#----#----#--
--#----#----#----#----#----#----#----#----#----#----#----#----#----#----#----#----#----#----#----#--
-#-#--#-#--#-#--#-#--#-#--#-#--#-#--#-#--#-#--#-#--#-#--#-#--#-#--#-#--#-#--#-#--#-#--#-#--#-#--#-#-
--#----#----#----#----#----#----#----#----#----#----#----#----#----#----#----#----#----#----#----#--
-#----#----#----#----#----#----#----#----#----#----#----#----#----#----#----#----#----#----#----#---
--#----#----#----#----#----#----#----#----#----#----#----#----#----#----#----#----#----#----#----#--
--#----#----#----#----#----#----#----#----#----#----#----#----#----#----#----#----#----#----#----#--
-#-#--#-#--#-#--#-#--#-#--#-#--#-#--#-#--#-#--#-#--#-#--#-#--#-#--#-#--#-#--#-#--#-#--#-#--#-#--#-#-
--#----#----#----#----#----#----#----#----#----#----#----#----#----#----#----#----#----#----#----#--
-#----#----#----#----#----#----#----#----#----#----#----#----#----#----#----#----#----#----#----#---
--#----#----#----#----#----#----#----#----#----#----#----#----#----#----#----#----#----#----#----#--
--#----#----#----#----#----#----#----#----#----#----#----#----#----#----#----#----#----#----#----#--
-#-#--#-#--#-#--#-#--#-#--#-#--#-#--#-#--#-#--#-#--#-#--#-#--#-#--#-#--#-#--#-#--#-#--#-#--#-#--#-#-
--#----#----#----#----#----#----#----#----#----#----#----#----#----#----#----#----#----#----#----#--
-#----#----#----#----#----#----#----#----#----#----#----#----#----#----#----#----#----#----#----#---
--#----#----#----#----#----#----#----#----#----#----#----#----#----#----#----#----#----#----#----#--
--#----#----#----#----#----#----#----#----#----#----#----#----#----#----#----#---S#----#----#----#--
-#-#--#-#--#-#--#-#--#-#--#-#--#-#--#-#--#-#--#-#--#-#--#-#--#-#--#-#--#-#--#-#--#-#--#-#--#-#--#-#-
--#----#----#----#----#----#----#----#----#----#----#----#----#----#----#----#----#----#----#----#--
-#----#----#----#----#----#----#----#----#----#----#----#----#----#----#----#----#----#----#----#---
--#----#----#----#----#----#----#----#----#----#----#----#----#----#----#----#----#----#----#----#--
--#----#----#----#----#----#----#----#----#----#----#----#----#----#----#----#----#----#----#----#--
-#-#--#-#--#-#--#-#--#-#--#-#--#-#--#-#--#-#--#-#--#-#--#-#--#-#--#-#--#-#--#-#--#-#--#-#--#-#--#-#-
--#----#----#----#----#----#----#----#----#----#----#----#----#----#----#----#----#----#----#----#--
-#----#----#----#----#----#----#----#----#----#----#----#----#----#----#----#----#----#----#----#---
--#----#----#----#----#----#----#----#----#----#----#----#----#----#----#----#----#----#----#----#--
--#----#----#----#----#----#----#----#----#----#----#----#----#----#----#----#----#----#----#----#--
-#-#--#-#--#-#--#-#--#-#--#-#--#-#--#-#--#-#--#-#--#-#--#-#--#-#--#-#--#-#--#-#--#-#--#-#--#-#--#-#-
--#----#----#----#----#----#----#----#----#----#----#----#----#----#----#----#----#----#----#----#--
-#----#----#----#----#----#----#----#----#----#----#----#----#----#----#----#----#----#----#----#---
--#----#----#----#----#----#----#----#----#----#----#----#----#----#----#----#----#----#----#----#--
--#----#----#----#----#----#----#----#----#----#----#----#----#----#----#----#----#----#----#----#--
-#-#--#-#--#-#--#-#--#-#--#-#--#-#--#-#--#-#--#-#--#-#--#-#--#-#--#-#--#-#--#-#--#-#--#-#--#-#--#-#-
--#----#----#----#----#----#----#----#----#----#----#----#----#----#----#----#----#----#----#----#--
-#----#----#----#----#----#----#----#----#----#----#----#----#----#----#----#----#----#----#----#---
--#----#----#----#----#----#----#----#----#----#----#----#----#----#----#----#----#----#----#----#--
--#----#----#----#----#----#----#----#----#----#----#----#----#----#----#----#----#----#----#----#--
-#-#--#-#--#-#--#-#--#-#--#-#--#-#--#-#--#-#--#-#--#-#--#-#--#-#--#-#--#-#--#-#--#-#--#-#--#-#--#-#-
--#----#----#----#----#----#----#----#----#----#----#----#----#----#----#----#----#----#----#----#--
-#----#----#----#----#----#----#----#----#----#----#----#----#----#----#----#----#----#----#----#---
--#----#----#----#----#----#----#----#----#----#----#----#----#----#----#----#----#----#----#----#--
--#----#----#----#----#----#----#----#----#----#----#----#----#----#----#----#----#----#----#----#--
-#-#--#-#--#-#--#-#--#-#--#-#--#-#--#-#--#-#--#-#--#-#--#-#--#-#--#-#--#-#--#-#--#-#--#-#--#-#--#-#-
--#----#----#----#----#----#----#----#----#----#----#----#----#----#----#----#----#----#----#----#--
-#----#----#----#----#----#----#----#----#----#----#----#----#----#----#----#----#----#----#----#---
--#----#----#----#----#----#----#----#----#----#----#----#----#----#----#----#----#----#----#----#--
--#----#----#----#----#----#----#----#----#----#----#----#----#----#----#----#----#----#----#----#--
-#-#--#-#--#-#--#-#--#-#--#-#--#-#--#-#--#-#--#-#--#-#--#-#--#-#--#-#--#-#--#-#--#-#--#-#--#-#--#-#-
--#----#----#----#----#----#----#----#----#----#----#----#----#----#----#----#----#----#----#----#--
-#----#----#----#----#----#----#----#----#----#----#----#----#----#----#----#----#----#----#----#---
--#----#----#----#----#----#----#----#----#----#----#----#----#----#----#----#----#----#----#----#--
--#----#----#----#----#----#----#----#----#----#----#----#----#----#----#----#----#----#----#----#--
-#-#--#-#--#-#--#-#--#-#--#-#--#-#--#-#--#-#--#-#--#-#--#-#--#-#--#-#--#-#--#-#--#-#--#-#--#-#--#-#-
--#----#----#----#----#----#----#----#----#----#----#----#----#----#----#----#----#----#----#----#--
-#----#----#----#----#----#----#----#----#----#----#----#----#----#----#----#----#----#----#----#---
--#----#----#----#----#----#----#----#----#----#----#----#----#----#----#----#----#----#----#----#--
--#----#----#----#----#----#----#----#----#----#----#----#----#----#E---#----#----#----#----#----#--
-#-#--#-#--#-#--#-#--#-#--#-#--#-#--#-#--#-#--#-#--#-#--#-#--#-#--#-#--#-#--#-#--#-#--#-#--#-#--#-#-
--#----#----#----#----#----#----#----#----#----#----#----#----#----#----#----#----#----#----#----#--
-#----#----#----#----#----#----#----#----#----#----#----#----#----#----#----#----#----#----#----#---
--#----#----#----#----#----#----#----#----#----#----#----#----#----#----#----#----#----#----#----#--
--#----#----#----#----#----#----#----#----#----#----#----#----#----#----#----#----#----#----#----#--
-#-#--#-#--#-#--#-#--#-#--#-#--#-#--#-#--#-#--#-#--#-#--#-#--#-#--#-#--#-#--#-#--#-#--#-#--#-#--#-#-
--#----#----#----#----#----#----#----#----#----#----#----#----#----#----#----#----#----#----#----#--
-#----#----#----#----#----#----#----#----#----#----#----#----#----#----#----#----#----#----#----#---
--#----#----#----#----#----#----#----#----#----#----#----#----#----#----#----#----#----#----#----#--
--#----#----#----#----#----#----#----#----#----#----#----#----#----#----#----#----#----#----#----#--
-#-#--#-#--#-#--#-#--#-#--#-#--#-#--#-#--#-#--#-#--#-#--#-#--#-#--#-#--#-#--#-#--#-#--#-#--#-#--#-#-
--#----#----#----#----#----#----#----#----#----#----#----#----#----#----#----#----#----#----#----#--
-#----#----#----#----#----#----#----#----#----#----#----#----#----#----#----#----#----#----#----#---
--#----#----#----#----#----#----#----#----#----#----#----#----#----#----#----#----#----#----#----#--
--#----#----#----#----#----#----#----#----#----#----#----#----#----#----#----#----#----#----#----#--
-#-#--#-#--#-#--#-#--#-#--#-#--#-#--#-#--#-#--#-#--#-#--#-#--#-#--#-#--#-#--#-#--#-#--#-#--#-#--#-#-
--#----#----#----#----#----#----#----#----#----#----#----#----#----#----#----#----#----#----#----#--
-#----#----#----#----#----#----#----#----#----#----#----#----#----#----#----#----#----#----#----#---
--#----#----#----#----#----#----#----#----#----#----#----#----#----#----#----#----#----#----#----#--
--#----#----#----#----#----#----#----#----#----#----#----#----#----#----#----#----#----#----#----#--
-#-#--#-#--#-#--#-#--#-#--#-#--#-#--#-#--#-#--#-#--#-#--#-#--#-#--#-#--#-#--#-#--#-#--#-#--#-#--#-#-
--#----#----#----#----#----#----#----#----#----#----#----#----#----#----#----#----#----#----#----#--
-#----#----#----#----#----#----#----#----#----#----#----#----#----#----#----#----#----#----#----#---
--#----#----#----#----#----#----#----#----#----#----#----#----#----#----#----#----#----#----#----#--
--#----#----#----#----#----#----#----#----#----#----#----#----#----#----#----#----#----#----#----#--
-#-#--#-#--#-#--#-#--#-#--#-#--#-#--#-#--#-#--#-#--#-#--#-#--#-#--#-#--#-#--#-#--#-#--#-#--#-#--#-#-
--#----#----#----#----#----#----#----#----#----#----#----#----#----#----#----#----#----#----#----#--
-#----#----#----#----#----#----#----#----#----#----#----#----#----#----#----#----#----#----#----#---
--#----#----#----#----#----#----#----#----#----#----#----#----#----#----#----#----#----#----#----#--
--#----#----#----#----#----#----#----#----#----#----#----#----#----#----#----#----#----#----#----#--
-#-#--#-#--#-#--#-#--#-#--#-#--#-#--#-#--#-#--#-#--#-#--#-#--#-#--#-#--#-#--#-#--#-#--#-#--#-#--#-#-
--#----#----#----#----#----#----#----#----#----#----#----#----#----#----#----#----#----#----#----#--
-#----#----#----#----#----#----#----#----#----#----#----#----#----#----#----#----#----#----#----#---
--#----#----#----#----#----#----#----#----#----#----#----#----#----#----#----#----#----#----#----#--
--#----#----#----#----#----#----#----#----#----#----#----#----#----#----#----#----#----#----#----#--
-#-#--#-#--#-#--#-#--#-#--#-#--#-#--#-#--#-#--#-#--#-#--#-#--#-#--#-#--#-#--#-#--#-#--#-#--#-#--#-#-
--#----#----#----#----#----#----#----#----#----#----#----#----#----#----#----#----#----#----#----#--
-#----#----#----#----#----#----#----#----#----#----#----#----#----#----#----#----#----#----#----#---
--#----#----#----#----#----#----#----#----#----#----#----#----#----#----#----#----#----#----#----#--
--#----#----#----#----#----#----#----#----#----#----#----#----#----#----#----#----#----#----#----#--
-#-#--#-#--#-#--#-#--#-#--#-#--#-#--#-#--#-#--#-#--#-#--#-#--#-#--#-#--#-#--#-#--#-#--#-#--#-#--#-#-
--#----#----#----#----#----#----#----#----#----#----#----#----#----#----#----#----#----#----#----#--