?diagonal=Never;
-#----#----#----#----#----#----#----#----#----#----#----#----#----#----#----#----#----#----#----#---
###--###--###--###--###--###--###--###--###--###--###--###--###--###--###--###--###--###--###--###--
--#----#----#----#----#----#----#----#----#----#----#----#----#----#----#----#----#----#----#----#--
----------------------------------------------------------------------------------------------------
#----#----#----#----#----#----#----#----#----#----#----#----#----#----#----#----#----#----#----#----
-#----#----#----#----#----#----#----#----#----#----#----#----#----#----#----#----#----#----#----#---
###--###--###--###--###--###--###--###--###--###--###--###--###--###--###--###--###--###--###--###--
--#----#----#----#----#----#----#----#----#----#----#----#----#----#----#----#----#----#----#----#--
----------------------------------------------------------------------------------------------------
#----#----#----#----#----#----#----#----#----#----#----#----#----#----#----#----#----#----#----#----
-#----#----#----#----#----#----#----#----#----#----#----#----#----#----#----#----#----#----#----#---
###--###--###--###--###--###--###--###--###--###--###--###--###--###--###--###--###--###--###--###--
--#----#----#----#----#----#----#----#----#----#----#----#----#----#----#----#----#----#----#----#--
----------------------------------------------------------------------------------------------------
#----#----#----#----#----#----#----#----#----#----#----#----#----#----#----#----#----#----#----#----
-#----#----#----#----#----#----#----#----#----#----#----#----#----#----#----#----#----#----#----#---
###--###--###--###--###--###--###--###--###--###--###--###--###--###--###--###--###--###--###--###--
--#----#----#----#----#----#----#----#----#----#----#----#----#----#----#----#----#----#----#----#--
----------------------------------------------------------------------------------------------------
#----#----#----#----#----#----#----#----#----#----#----#----#----#----#----#----#----#----#----#----
-#----#----#----#----#----#----#----#----#----#----#----#----#----#----#----#----#----#----#----#---
###--###--###--###--###--###--###--###--###--###--###--###--###--###--###--###--###--###--###--###--
E-#----#----#----#----#----#----#----#----#----#----#----#----#----#----#----#----#----#----#----#--
----------------------------------------------------------------------------------------------------
#----#----#----#----#----#----#----#----#----#----#----#----#----#----#----#----#----#----#----#----
-#----#----#----#----#----#----#----#----#----#----#----#----#----#----#----#----#----#----#----#---
###--###--###--###--###--###--###--###--###--###--###--###--###--###--###--###--###--###--###--###--
--#----#----#----#----#----#----#----#----#----#----#----#----#----#----#----#----#----#----#----#--
----------------------------------------------------------------------------------------------------
#----#----#----#----#----#----#----#----#----#----#----#----#----#----#----#----#----#----#----#----
-#----#----#----#----#----#----#----#----#----#----#----#----#----#----#----#----#----#----#----#---
###--###--###--###--###--###--###--###--###--###--###--###--###--###--###--###--###--###--###--###--
--#----#----#----#----#----#----#----#----#----#----#----#----#----#----#----#----#----#----#----#--
----------------------------------------------------------------------------------------------------
#----#----#----#----#----#----#----#----#----#----#----#----#----#----#----#----#----#----#----#----
-#----#----#----#----#----#----#----#----#----#----#----#----#----#----#----#----#----#----#----#---
###--###--###--###--###--###--###--###--###--###--###--###--###--###--###--###--###--###--###--###--
--#----#----#----#----#----#----#----#----#----#----#----#----#----#----#----#----#----#----#----#--
----------------------------------------------------------------------------------------------------
#----#----#----#----#----#----#----#----#----#----#----#----#----#----#----#----#----#----#----#----
-#----#----#----#----#----#----#----#----#----#----#----#----#----#----#----#----#----#----#----#---
###--###--###--###--###--###--###--###--###--###--###--###--###--###--###--###--###--###--###--###--
--#----#----#----#----#----#----#----#----#----#----#----#----#----#----#----#----#----#----#----#--
----------------------------------------------------------------------------------------------------
#----#----#----#----#----#----#----#----#----#----#----#----#----#----#----#----#----#----#----#----
-#----#----#----#----#----#----#----#----#----#----#----#----#----#----#----#----#----#----#----#---
###--###--###--###--###--###--###--###--###--###--###--###--###--###--###--###--###--###--###--###--
--#----#----#----#----#----#----#----#----#----#----#----#----#----#----#----#----#----#----#----#--
----------------------------------------------------------------------------------------------------
#----#----#----#----#----#----#----#----#----#----#----#----#----#----#----#----#----#----#----#----
-#----#----#----#----#----#----#----#----#----#----#----#----#----#----#----#----#----#----#----#---
###--###--###--###--###--###--###--###--###--###--###--###--###--###--###--###--###--###--###--###--
--#----#----#----#----#----#----#----#----#----#----#----#----#----#----#----#----#----#----#----#--
----------------------------------------------------------------------------------------------------
#----#----#----#----#----#----#----#----#----#----#----#----#----#----#----#----#----#----#----#----
-#----#----#----#----#----#----#----#----#----#----#----#----#----#----#----#----#----#----#----#---
###--###--###--###--###--###--###--###--###--###--###--###--###--###--###--###--###-S###--###--###--
--#----#----#----#----#----#----#----#----#----#----#----#----#----#----#----#----#----#----#----#--
----------------------------------------------------------------------------------------------------
#----#----#----#----#----#----#----#----#----#----#----#----#----#----#----#----#----#----#----#----
-#----#----#----#----#----#----#----#----#----#----#----#----#----#----#----#----#----#----#----#---
###--###--###--###--###--###--###--###--###--###--###--###--###--###--###--###--###--###--###--###--
--#----#----#----#----#----#----#----#----#----#----#----#----#----#----#----#----#----#----#----#--
----------------------------------------------------------------------------------------------------
#----#----#----#----#----#----#----#----#----#----#----#----#----#----#----#----#----#----#----#----
-#----#----#----#----#----#----#----#----#----#----#----#----#----#----#----#----#----#----#----#---
###--###--###--###--###--###--###--###--###--###--###--###--###--###--###--###--###--###--###--###--
--#----#----#----#----#----#----#----#----#----#----#----#----#----#----#----#----#----#----#----#--
----------------------------------------------------------------------------------------------------
#----#----#----#----#----#----#----#----#----#----#----#----#----#----#----#----#----#----#----#----
-#----#----#----#----#----#----#----#----#----#----#----#----#----#----#----#----#----#----#----#---
###--###--###--###--###--###--###--###--###--###--###--###--###--###--###--###--###--###--###--###--
--#----#----#----#----#----#----#----#----#----#----#----#----#----#----#----#----#----#----#----#--
----------------------------------------------------------------------------------------------------
#----#----#----#----#----#----#----#----#----#----#----#----#----#----#----#----#----#----#----#----
-#----#----#----#----#----#----#----#----#----#----#----#----#----#----#----#----#----#----#----#---
###--###--###--###--###--###--###--###--###--###--###--###--###--###--###--###--###--###--###--###--
--#----#----#----#----#----#----#----#----#----#----#----#----#----#----#----#----#----#----#----#--
----------------------------------------------------------------------------------------------------
#----#----#----#----#----#----#----#----#----#----#----#----#----#----#----#----#----#----#----#----
-#----#----#----#----#----#----#----#----#----#----#----#----#----#----#----#----#----#----#----#---
###--###--###--###--###--###--###--###--###--###--###--###--###--###--###--###--###--###--###--###--
--#----#----#----#----#----#----#----#----#----#----#----#----#----#----#----#----#----#----#----#--
----------------------------------------------------------------------------------------------------
#----#----#----#----#----#----#----#----#----#----#----#----#----#----#----#----#----#----#----#----
-#----#----#----#----#----#----#----#----#----#----#----#----#----#----#----#----#----#----#----#---
###--###--###--###--###--###--###--###--###--###--###--###--###--###--###--###--###--###--###--###--
--#----#----#----#----#----#----#----#----#----#----#----#----#----#----#----#----#----#----#----#--
----------------------------------------------------------------------------------------------------
#----#----#----#----#----#----#----#----#----#----#----#----#----#----#----#----#----#----#----#----
-#----#----#----#----#----#----#----#----#----#----#----#----#----#----#----#----#----#----#----#---
###--###--###--###--###--###--###--###--###--###--###--###--###--###--###--###--###--###--###--###--
--#----#----#----#----#----#----#----#----#----#----#----#----#----#----#----#----#----#----#----#--
----------------------------------------------------------------------------------------------------
#----#----#----#----#----#----#----#----#----#----#----#----#----#----#----#----#----#----#----#----
-#----#----#----#----#----#----#----#----#----#----#----#----#----#----#----#----#----#----#----#---
###--###--###--###--###--###--###--###--###--###--###--###--###--###--###--###--###--###--###--###--
--#----#----#----#----#----#----#----#----#----#----#----#----#----#----#----#----#----#----#----#--
----------------------------------------------------------------------------------------------------
#----#----#----#----#----#----#----#----#----#----#----#----#----#----#----#----#----#----#----#----