?diagonal=Never;
#--#-#--#-#--#-#--#-#--#-#--#-#--#-#--#-#--#-#--#-#--#-#--#-#--#-#--#-#--#-#--#-#--#-#--#-#--#-#--#-
-###--###--###--###--###--###--###--###--###--###--###--###--###--###--###--###--###--###--###--###-
-#----#----#----#----#----#----#----#----#----#----#----#----#----#----#----#----#----#----#----#---
----------------------------------------------------------------------------------------------------
-#-#--#-#--#-#--#-#--#-#--#-#--#-#--#-#--#-#--#-#--#-#--#-#--#-#--#-#--#-#--#-#--#-#--#-#--#-#--#-#-
#--#-#--#-#--#-#--#-#--#-#--#-#--#-#--#-#--#-#--#-#--#-#--#-#--#-#--#-#--#-#--#-#--#-#--#-#--#-#--#-
-###--###--###--###--###--###--###--###--###--###--###--###--###--###--###--###--###--###--###--###-
-#----#----#----#----#----#----#----#----#----#----#----#----#----#----#----#----#----#----#----#---
----------------------------------------------------------------------------------------------------
-#-#--#-#--#-#--#-#--#-#--#-#--#-#--#-#--#-#--#-#--#-#--#-#--#-#--#-#--#-#--#-#--#-#--#-#--#-#--#-#-
#--#-#--#-#--#-#--#-#--#-#--#-#--#-#--#-#--#-#--#-#--#-#--#-#--#-#--#-#--#-#--#-#--#-#--#-#--#-#--#-
-###--###--###--###--###--###--###--###--###--###--###--###--###--###--###--###--###--###--###--###-
-#----#----#----#----#----#----#----#----#----#----#----#----#----#----#----#----#----#----#----#---
----------------------------------------------------------------------------------------------------
-#-#--#-#--#-#--#-#--#-#--#-#--#-#--#-#--#-#--#-#--#-#--#-#--#-#--#-#--#-#--#-#--#-#--#-#--#-#--#-#-
#--#-#--#-#--#-#--#-#--#-#--#-#--#-#--#-#--#-#--#-#--#-#--#-#--#-#--#-#--#-#--#-#--#-#--#-#--#-#--#-
-###--###--###--###--###--###--###--###--###--###--###--###--###--###--###--###--###--###--###--###-
-#----#----#----#----#----#----#----#----#----#----#----#----#----#----#----#----#----#----#----#---
----------------------------------------------------------------------------------------------------
-#-#--#-#--#-#--#-#--#-#--#-#--#-#--#-#--#-#--#-#--#-#--#-#--#-#--#-#--#-#--#-#--#-#--#-#--#-#--#-#-
#--#-#--#-#--#-#--#-#--#-#--#-#--#-#--#-#--#-#--#-#--#-#--#-#--#-#--#-#--#-#--#-#--#-#--#-#--#-#--#-
-###--###--###--###--###--###--###--###--###--###--###--###--###--###--###--###--###--###--###--###-
-#----#----#----#----#----#----#----#----#----#----#----#----#----#----#----#----#----#----#----#---
----------------------------------------------------------------------------------------------------
-#-#--#-#--#-#--#-#--#-#--#-#--#-#--#-#--#-#--#-#--#-#--#-#--#-#--#-#--#-#--#-#--#-#--#-#--#-#--#-#-
#--#-#--#-#--#-#--#-#--#-#--#-#--#-#--#-#--#-#--#-#--#-#--#-#--#-#--#-#--#-#--#-#--#-#--#-#--#-#--#-
-###--###--###--###--###--###--###--###--###--###--###--###--###--###--###--###--###--###--###--###-
-#----#----#----#----#----#----#----#----#----#----#----#----#----#----#----#----#----#----#----#---
----------------------------------------------------------------------------------------------------
-#-#--#-#--#-#--#-#--#-#--#-#--#-#--#-#--#-#--#-#--#-#--#-#--#-#--#-#--#-#--#-#--#-#--#-#--#-#--#-#-
#--#-#--#-#--#-#--#-#--#-#--#-#--#-#--#-#--#-#--#-#--#-#--#-#--#-#--#-#--#-#--#-#--#-#--#-#--#-#--#-
-###--###--###--###--###--###--###--###--###--###--###--###--###--###--###--###--###--###--###--###-
-#----#----#----#----#----#----#----#----#----#----#----#----#----#----#----#----#----#----#----#---
----------------------------------------------------------------------------------------------------
-#-#--#-#--#-#--#-#--#-#--#-#--#-#--#-#--#-#--#-#--#-#--#-#--#-#--#-#--#-#--#-#--#-#--#-#--#-#--#-#-
#--#-#--#-#--#-#--#-#--#-#--#-#--#-#--#-#--#-#--#-#--#-#--#-#--#-#--#-#--#-#--#-#--#-#--#-#--#-#--#-
-###--###--###--###--###--###--###--###--###--###--###--###--###--###--###--###--###--###--###--###-
-#----#----#----#----#----#----#----#----#----#----#----#----#----#----#----#----#----#----#----#---
----------------------------------------------------------------------------------------------------
-#-#--#-#--#-#--#-#--#-#--#-#--#-#--#-#-S#-#--#-#--#-#--#-#--#-#--#-#--#-#--#-#--#-#--#-#--#-#--#-#-
#--#-#--#-#--#-#--#-#--#-#--#-#--#-#--#-#--#-#--#-#--#-#--#-#--#-#--#-#--#-#--#-#--#-#--#-#--#-#--#-
-###--###--###--###--###--###--###--###--###--###--###--###--###--###--###--###--###--###--###--###-
-#----#----#----#----#----#----#----#----#----#----#----#----#----#----#----#----#----#----#----#---
----------------------------------------------------------------------------------------------------
-#-#--#-#--#-#--#-#--#-#--#-#--#-#--#-#--#-#--#-#--#-#--#-#--#-#--#-#--#-#--#-#--#-#--#-#--#-#--#-#-
#--#-#--#-#--#-#--#-#--#-#--#-#--#-#--#-#--#-#--#-#--#-#--#-#--#-#--#-#--#-#--#-#--#-#--#-#--#-#--#-
-###--###--###--###--###--###--###--###--###--###--###--###--###--###--###--###--###--###--###--###-
-#----#----#----#----#----#----#----#----#----#----#----#----#----#----#----#----#----#----#----#---
----------------------------------------------------------------------------------------------------
-#-#--#-#--#-#--#-#--#-#--#-#--#-#--#-#--#-#--#-#--#-#--#-#--#-#--#-#--#-#--#-#--#-#--#-#--#-#--#-#-
#--#-#--#-#--#-#--#-#--#-#--#-#--#-#--#-#--#-#--#-#--#-#--#-#--#-#--#-#--#-#--#-#--#-#--#-#--#-#--#-
-###--###--###--###--###--###--###--###--###--###--###--###--###--###--###--###--###--###--###--###-
-#----#----#----#----#----#----#----#----#----#----#----#----#----#----#----#----#----#----#----#---
----------------------------------------------------------------------------------------------------
-#-#--#-#--#-#--#-#--#-#--#-#--#-#--#-#--#-#--#-#--#-#--#-#--#-#--#-#--#-#--#-#--#-#--#-#--#-#--#-#-
#--#-#--#-#--#-#--#-#--#-#--#-#--#-#--#-#--#-#--#-#--#-#--#-#--#-#--#-#--#-#--#-#--#-#--#-#--#-#--#-
-###--###--###--###--###--###--###--###--###--###--###--###--###--###--###--###--###--###--###--###-
-#----#----#----#----#----#----#----#----#----#----#----#----#----#----#----#----#----#----#----#---
----------------------------------------------------------------------------------------------------
-#-#--#-#--#-#--#-#--#-#--#-#--#-#--#-#--#-#--#-#--#-#--#-#--#-#--#-#--#-#--#-#--#-#--#-#--#-#--#-#-
#--#-#--#-#--#-#--#-#--#-#--#-#--#-#--#-#--#-#--#-#--#-#--#-#--#-#--#-#--#-#--#-#--#-#--#-#--#-#--#-
-###--###--###--###--###--###--###--###--###--###--###--###--###--###--###--###--###--###--###--###-
-#----#----#----#----#----#----#----#----#----#----#----#----#----#----#----#----#----#----#----#---
----------------------------------------------------------------------------------------------------
-#-#--#-#--#-#--#-#--#-#--#-#--#-#--#-#--#-#--#-#--#-#--#-#--#-#--#-#--#-#--#-#--#-#--#-#--#-#--#-#-
#--#-#--#-#--#-#--#-#--#-#--#-#--#-#--#-#--#-#--#-#--#-#--#-#--#-#--#-#--#-#--#-#--#-#--#-#--#-#--#-
-###--###--###--###--###--###--###--###--###--###--###--###--###--###--###--###--###--###--###--###-
-#----#----#----#----#----#----#----#----#----#----#----#----#----#----#----#----#----#----#----#---
----------------------------------------------------------------------------------------------------
-#-#--#-#--#-#--#-#--#-#--#-#--#-#--#-#--#-#--#-#--#-#--#-#--#-#--#-#--#-#--#-#--#-#--#-#--#-#--#-#-
#--#-#--#-#--#-#--#-#--#-#--#-#--#-#--#-#--#-#--#-#--#-#--#-#--#-#--#-#--#-#--#-#--#-#--#-#--#-#E-#-
-###--###--###--###--###--###--###--###--###--###--###--###--###--###--###--###--###--###--###--###-
-#----#----#----#----#----#----#----#----#----#----#----#----#----#----#----#----#----#----#----#---
----------------------------------------------------------------------------------------------------
-#-#--#-#--#-#--#-#--#-#--#-#--#-#--#-#--#-#--#-#--#-#--#-#--#-#--#-#--#-#--#-#--#-#--#-#--#-#--#-#-
#--#-#--#-#--#-#--#-#--#-#--#-#--#-#--#-#--#-#--#-#--#-#--#-#--#-#--#-#--#-#--#-#--#-#--#-#--#-#--#-
-###--###--###--###--###--###--###--###--###--###--###--###--###--###--###--###--###--###--###--###-
-#----#----#----#----#----#----#----#----#----#----#----#----#----#----#----#----#----#----#----#---
----------------------------------------------------------------------------------------------------
-#-#--#-#--#-#--#-#--#-#--#-#--#-#--#-#--#-#--#-#--#-#--#-#--#-#--#-#--#-#--#-#--#-#--#-#--#-#--#-#-
#--#-#--#-#--#-#--#-#--#-#--#-#--#-#--#-#--#-#--#-#--#-#--#-#--#-#--#-#--#-#--#-#--#-#--#-#--#-#--#-
-###--###--###--###--###--###--###--###--###--###--###--###--###--###--###--###--###--###--###--###-
-#----#----#----#----#----#----#----#----#----#----#----#----#----#----#----#----#----#----#----#---
----------------------------------------------------------------------------------------------------
-#-#--#-#--#-#--#-#--#-#--#-#--#-#--#-#--#-#--#-#--#-#--#-#--#-#--#-#--#-#--#-#--#-#--#-#--#-#--#-#-
#--#-#--#-#--#-#--#-#--#-#--#-#--#-#--#-#--#-#--#-#--#-#--#-#--#-#--#-#--#-#--#-#--#-#--#-#--#-#--#-
-###--###--###--###--###--###--###--###--###--###--###--###--###--###--###--###--###--###--###--###-
-#----#----#----#----#----#----#----#----#----#----#----#----#----#----#----#----#----#----#----#---
----------------------------------------------------------------------------------------------------
-#-#--#-#--#-#--#-#--#-#--#-#--#-#--#-#--#-#--#-#--#-#--#-#--#-#--#-#--#-#--#-#--#-#--#-#--#-#--#-#-
#--#-#--#-#--#-#--#-#--#-#--#-#--#-#--#-#--#-#--#-#--#-#--#-#--#-#--#-#--#-#--#-#--#-#--#-#--#-#--#-
-###--###--###--###--###--###--###--###--###--###--###--###--###--###--###--###--###--###--###--###-
-#----#----#----#----#----#----#----#----#----#----#----#----#----#----#----#----#----#----#----#---
----------------------------------------------------------------------------------------------------
-#-#--#-#--#-#--#-#--#-#--#-#--#-#--#-#--#-#--#-#--#-#--#-#--#-#--#-#--#-#--#-#--#-#--#-#--#-#--#-#-
#--#-#--#-#--#-#--#-#--#-#--#-#--#-#--#-#--#-#--#-#--#-#--#-#--#-#--#-#--#-#--#-#--#-#--#-#--#-#--#-
-###--###--###--###--###--###--###--###--###--###--###--###--###--###--###--###--###--###--###--###-
-#----#----#----#----#----#----#----#----#----#----#----#----#----#----#----#----#----#----#----#---
----------------------------------------------------------------------------------------------------
-#-#--#-#--#-#--#-#--#-#--#-#--#-#--#-#--#-#--#-#--#-#--#-#--#-#--#-#--#-#--#-#--#-#--#-#--#-#--#-#-