?diagonal=Never;
##---##---##---##---##---##---##---##---##---##---##---##---##---##---##---##---##---##---##---##---
----------------------------------------------------------------------------------------------------
-#----#----#----#----#----#----#----#----#----#----#----#----#----#----#----#----#----#----#----#---
#---##---##---##---##---##---##---##---##---##---##---##---##---##---##---##---##---##---##---##---#
##--###--###--###--###--###--###--###--###--###--###--###--###--###--###--###--###--###--###--###--#
##---##---##---##---##---##---##---##---##---##---##---##---##---##---##---##---##---##---##---##---
----------------------------------------------------------------------------------------------------
-#----#----#----#----#----#----#----#----#----#----#----#----#----#----#----#----#----#----#----#---
#---##---##---##---##---##---##---##---##---##---##---##---##---##---##---##---##---##---##---##---#
##--###--###--###--###--###--###--###--###--###--###--###--###--###--###--###--###--###--###--###--#
##---##---##---##---##---##---##---##---##---##---##---##---##---##---##---##---##---##---##---##---
----------------------------------------------------------------------------------------------------
-#----#----#----#----#----#----#----#----#----#----#----#----#----#----#----#----#----#----#----#---
#---##---##---##---##---##---##---##---##---##---##---##---##---##---##---##---##---##---##---##---#
##--###--###--###--###--###--###--###--###--###--###--###--###--###--###--###--###--###--###--###--#
##---##---##---##---##---##---##---##---##---##---##---##---##---##---##---##---##---##---##---##---
----------------------------------------------------------------------------------------------------
-#----#----#----#----#----#----#----#----#----#----#----#----#----#----#----#----#----#----#----#---
#---##---##---##---##---##---##---##---##---##---##---##---##---##---##---##---##---##---##---##---#
##--###--###--###--###--###--###--###--###--###--###--###--###--###--###--###--###--###--###--###--#
##---##---##---##---##---##---##---##---##---##---##---##---##---##---##---##---##---##---##---##---
----------------------------------------------------------------------------------------------------
-#----#----#----#----#----#----#----#----#----#----#----#----#----#----#----#----#----#----#----#---
#---##---##---##---##---##---##---##---##---##---##---##---##---##---##---##---##---##---##---##---#
##--###--###--###--###--###--###--###--###--###--###--###--###--###--###--###--###--###--###--###--#
##---##---##---##---##---##---##---##---##---##---##---##---##---##---##---##---##---##---##---##---
----------------------------------------------------------------------------------------------------
-#----#----#----#----#----#----#----#----#----#----#----#----#----#----#----#----#----#----#----#---
#---##---##---##---##---##---##---##---##---##---##---##---##---##---##---##---##---##---##---##---#
##--###--###--###--###--###--###--###--###--###--###--###--###--###--###--###--###--###--###--###--#
##---##---##---##---##---##---##---##---##---##---##---##---##---##---##---##---##---##---##---##---
----------------------------------------------------------------------------------------------------
-#----#----#----#----#----#----#----#----#----#----#----#----#----#----#----#----#----#----#----#---
#---##---##---##---##---##---##---##---##---##---##---##---##---##---##---##---##---##---##---##---#
##--###--###--###--###--###--###--###--###--###--###--###--###--###--###--###--###--###--###--###--#
##---##---##---##---##---##---##---##---##---##---##---##---##---##---##---##---##---##---##---##---
----------------------------------------------------------------------------------------------------
-#----#----#----#----#----#----#----#----#----#----#----#----#----#----#----#----#----#----#----#---
#---##---##---##---##---##---##---##---##---##---##---##---##---##---##---##---##---##---##---##---#
##--###--###--###--###--###--###--###--###--###--###--###--###--###--###--###--###--###--###--###--#
##---##---##---##---##---##---##---##---##---##---##---##---##---##---##---##---##---##---##---##---
----------------------------------------------------------------------------------------------------
-#----#----#----#----#----#----#----#----#----#----#----#----#----#----#----#----#----#----#----#---
#---##---##---##---##---##---##---##---##---##---##---##---##---##---##---##---##---##---##---##---#
##--###--###--###--###--###--###--###--###--###--###--###--###--###--###--###--###--###--###--###--#
##---##---##---##---##---##---##---##---##---##---##---##---##---##---##---##---##---##---##---##---
----------------------------------------------------------------------------------------------------
-#----#----#----#----#----#----#----#----#----#----#----#----#----#----#----#----#----#----#----#---
#---##---##---##---##---##---##---##---##---##---##---##---##---##---##---##---##---##---##---##---#
##--###--###--###--###--###--###--###--###--###--###--###--###--###--###--###--###--###--###--###--#
##---##---##---##---##---##---##---##---##---##---##---##---##---##---##---##---##---##---##---##---
----------------------------------------------------------------------------------------------------
-#----#----#----#----#----#----#----#----#----#----#----#----#----#----#----#----#----#----#----#---
#---##---##---##---##---##---##---##---##---##---##---##---##---##---##---##---##---##---##---##---#
##--###--###--###--###--###--###--###--###--###--###--###--###--###--###--###--###--###--###--###--#
##---##---##---##---##---##---##---##---##---##---##---##---##---##---##---##---##---##---##---##---
----------------------------------------------------------------------------------------------------
-#----#----#----#----#----#----#----#----#----#----#----#----#----#----#----#----#----#----#----#---
#---##---##---##---##---##---##---##---##---##---##---##---##---##---##---##---##---##---##---##---#
##--###--###--###--###--###--###--###--###--###--###--###--###--###--###--###--###--###--###--###--#
##---##---##---##---##---##---##---##---##---##---##---##---##---##---##---##---##---##---##---##---
----------------------------------------------------------------------------------------------------
-#----#----#----#----#----#----#----#----#----#----#----#----#----#----#----#----#----#----#----#---
#---##---##---##---##---##---##---##---##---##---##---##---##---##---##---##---##---##---##---##---#
##--###--###--###--###--###--###--###--###--###--###--###--###--###--###--###--###--###--###--###--#
##---##---##---##---##---##---##---##---##---##---##---##---##---##---##---##---##---##---##---##---
----------------------------------------------------------------------------------------------------
-#----#----#----#----#----#----#----#----#----#----#----#----#----#----#----#----#----#----#----#---
#---##---##---##---##---##---##---##---##---##---##---##---##---##---##---##---##---##---##---##---#
##--###--###--###--###--###--###--###--###--###--###--###--###--###--###--###--###--###--###--###--#
##---##---##---##---##---##---##---##---##---##---##---##---##---##---##---##---##---##---##---##---
----------------------------------------------------------------------------------------------------
-#----#----#----#----#----#----#----#----#----#----#----#----#----#----#----#----#----#----#----#---
#---##---##---##---##---##---##---##---##---##---##---##---##---##---##---##---##---##---##---##---#
##--###--###--###--###--###--###--###--###--###--###--###--###--###--###--###--###--###--###--###--#
##---##---##---##---##S--##---##---##---##---##---##---##---##---##---##---##---##---##---##---##---
----------------------------------------------------------------------------------------------------
-#----#----#----#----#----#----#----#----#----#----#----#----#----#----#----#----#----#----#----#---
#---##---##---##---##---##---##---##---##---##---##---##---##---##---##---##---##---##---##---##---#
##--###--###--###--###--###--###--###--###--###--###--###--###--###--###--###--###--###--###--###--#
##---##---##---##---##---##---##---##---##---##---##---##---##---##---##---##---##---##---##---##---
----------------------------------------------------------------------------------------------------
-#----#----#----#----#----#----#----#----#----#----#----#----#----#----#----#----#----#----#----#---
#---##---##---##---##---##---##---##---##---##---##---##---##---##---##---##---##---##---##---##---#
##--###--###--###--###--###--###--###--###--###--###--###--###--###--###--###--###--###--###--###--#
##---##---##---##---##---##---##---##---##---##---##---##---##---##---##---##---##---##---##---##---
----------------------------------------------------------------------------------------------------
-#----#----#----#----#----#----#----#----#----#----#----#----#----#----#----#----#----#----#----#---
#---##---##---##---##---##---##---##---##---##---##---##---##---##---##---##---##---##---##---##---#
##--###--###--###--###--###--###--###--###--###--###--###--###--###--###--###--###--###--###--###--#
##---##---##---##---##---##---##---##---##---##---##---##---##---##---##---##---##---##---##---##---
----------------------------------------------------------------------------------------------------
-#----#----#----#----#----#----#----#----#----#----#----#----#----#----#----#-E--#----#----#----#---
#---##---##---##---##---##---##---##---##---##---##---##---##---##---##---##---##---##---##---##---#
##--###--###--###--###--###--###--###--###--###--###--###--###--###--###--###--###--###--###--###--#
##---##---##---##---##---##---##---##---##---##---##---##---##---##---##---##---##---##---##---##---
----------------------------------------------------------------------------------------------------
-#----#----#----#----#----#----#----#----#----#----#----#----#----#----#----#----#----#----#----#---
#---##---##---##---##---##---##---##---##---##---##---##---##---##---##---##---##---##---##---##---#
##--###--###--###--###--###--###--###--###--###--###--###--###--###--###--###--###--###--###--###--#