?diagonal=Never;
---##---##---##---##---##---##---##---##---##---##---##---##---##---##---##---##---##---##---##---##
----------------------------------------------------------------------------------------------------
--#----#----#----#----#----#----#----#----#----#----#----#----#----#----#----#----#----#----#----#--
-#--#-#--#-#--#-#--#-#--#-#--#-#--#-#--#-#--#-#--#-#--#-#--#-#--#-#--#-#--#-#--#-#--#-#--#-#--#-#--#
-#----#----#----#----#----#----#----#----#----#----#----#----#----#---E#----#----#----#----#----#---
---##---##---##---##---##---##---##---##---##---##---##---##---##---##---##---##---##---##---##---##
----------------------------------------------------------------------------------------------------
--#----#----#----#----#----#----#----#----#----#----#----#----#----#----#----#----#----#----#----#--
-#--#-#--#-#--#-#--#-#--#-#--#-#--#-#--#-#--#-#--#-#--#-#--#-#--#-#--#-#--#-#--#-#--#-#--#-#--#-#--#
-#----#----#----#----#----#----#----#----#----#----#----#----#----#----#----#----#----#----#----#---
---##---##---##---##---##---##---##---##---##---##---##---##---##---##---##---##---##---##---##---##
----------------------------------------------------------------------------------------------------
--#----#----#----#----#----#----#----#----#----#----#----#----#----#----#----#----#----#----#----#--
-#--#-#--#-#--#-#--#-#--#-#--#-#--#-#--#-#--#-#--#-#--#-#--#-#--#-#--#-#--#-#--#-#--#-#--#-#--#-#--#
-#----#----#----#----#----#----#----#----#----#----#----#----#----#----#----#----#----#----#----#---
---##---##---##---##---##---##---##---##---##---##---##---##---##---##---##---##---##---##---##---##
----------------------------------------------------------------------------------------------------
--#----#----#----#----#----#----#----#----#----#----#----#----#----#----#----#----#----#----#----#--
-#--#-#--#-#--#-#--#-#--#-#--#-#--#-#--#-#--#-#--#-#--#-#--#-#--#-#--#-#--#-#--#-#--#-#--#-#--#-#--#
-#----#----#----#----#----#----#----#----#----#----#----#----#----#----#----#----#----#----#----#---
---##---##---##---##---##---##---##---##---##---##---##---##---##---##---##---##---##---##---##---##
----------------------------------------------------------------------------------------------------
--#----#----#----#----#----#----#----#----#----#----#----#----#----#----#----#----#----#----#----#--
-#--#-#--#-#--#-#--#-#--#-#--#-#--#-#--#-#--#-#--#-#--#-#--#-#--#-#--#-#--#-#--#-#--#-#--#-#--#-#--#
-#----#----#----#----#----#----#----#----#----#----#----#----#----#----#----#----#----#----#----#---
---##---##---##---##---##---##---##---##---##---##---##---##---##---##---##---##---##---##---##---##
----------------------------------------------------------------------------------------------------
--#----#----#----#----#----#----#----#----#----#----#----#----#----#----#----#----#----#----#----#--
-#--#-#--#-#--#-#--#-#--#-#--#-#--#-#--#-#--#-#--#-#--#-#--#-#--#-#--#-#--#-#--#-#--#-#--#-#--#-#--#
-#----#----#----#----#----#----#----#----#----#----#----#----#----#----#----#----#----#----#----#---
---##---##---##---##---##---##---##---##---##---##---##---##---##---##---##---##---##---##---##---##
----------------------------------------------------------------------------------------------------
--#----#----#----#----#----#----#----#----#----#----#----#----#----#----#----#----#----#----#----#--
-#--#-#--#-#--#-#--#-#--#-#--#-#--#-#--#-#--#-#--#-#--#-#--#-#--#-#--#-#--#-#--#-#--#-#--#-#--#-#--#
-#----#----#----#----#----#----#----#----#----#----#----#----#----#----#----#----#----#----#----#---
---##---##---##---##---##---##---##---##---##---##---##---##---##---##---##---##---##---##---##---##
----------------------------------------------------------------------------------------------------
--#----#----#----#----#----#----#----#----#----#----#----#----#----#----#----#----#----#----#----#--
-#--#-#--#-#--#-#--#-#--#-#--#-#--#-#--#-#--#-#--#-#--#-#--#-#--#-#--#-#--#-#--#-#--#-#--#-#--#-#--#
-#----#----#----#----#----#----#----#----#----#----#----#----#----#----#----#----#----#----#----#---
---##---##---##---##---##---##---##---##---##---##---##---##---##---##---##---##---##---##---##---##
----------------------------------------------------------------------------------------------------
--#----#----#----#----#----#----#----#----#----#----#----#----#----#----#----#----#----#----#----#--
-#--#-#--#-#--#-#--#-#--#-#--#-#--#-#--#-#--#-#--#-#--#-#--#-#--#-#--#-#--#-#--#-#--#-#--#-#--#-#--#
-#----#----#----#----#----#----#----#----#----#----#----#----#----#----#----#----#----#----#----#---
---##---##---##---##---##---##---##---##---##---##---##---##---##---##---##---##---##---##---##---##
----------------------------------------------------------------------------------------------------
--#----#----#----#----#----#----#----#----#----#----#----#----#----#----#----#----#----#----#----#--
-#--#-#--#-#--#-#--#-#--#-#--#-#--#-#--#-#--#-#--#-#--#-#--#-#--#-#--#-#--#-#--#-#--#-#--#-#--#-#--#
-#----#----#----#----#----#----#----#----#----#----#----#----#----#----#----#----#----#----#----#---
---##---##---##---##---##---##---##---##---##---##---##---##---##---##---##---##---##---##---##---##
----------------------------------------------------------------------------------------------------
--#----#----#----#----#----#----#----#----#----#----#----#----#----#----#----#----#----#----#----#--
-#--#-#--#-#--#-#--#-#--#-#--#-#--#-#--#-#--#-#--#-#--#-#--#-#--#-#--#-#--#-#--#-#--#-#--#-#--#-#--#
-#----#----#----#----#----#----#----#----#----#----#----#----#----#----#----#----#----#----#----#---
---##---##---##---##---##---##---##---##---##---##---##---##---##---##---##---##---##---##---##---##
----------------------------------------------------------------------------------------------------
--#----#----#----#----#----#----#----#----#----#----#----#----#----#----#----#----#----#----#----#--
-#--#-#--#-#--#-#--#-#--#-#--#-#--#-#--#-#--#-#--#-#--#-#--#-#--#-#--#-#--#-#--#-#--#-#--#-#--#-#--#
-#----#----#----#----#----#----#----#----#----#----#----#----#----#----#----#----#----#----#----#---
---##---##---##---##---##---##---##---##---##---##---##---##---##---##---##---##---##---##---##---##
----------------------------------------------------------------------------------------------------
--#----#----#----#----#----#----#----#----#----#----#----#----#----#----#----#----#----#----#----#--
-#--#-#--#-#--#-#--#-#--#-#--#-#--#-#--#-#--#-#--#-#--#-#--#-#--#-#--#-#--#-#--#-#--#-#--#-#--#-#--#
-#----#----#----#----#----#----#----#----#----#----#----#----#----#----#----#----#----#----#----#---
---##---##---##---##---##---##---##---##---##---##---##---##---##---##---##---##---##---##---##---##
----------------------------------------------------------------------------------------------------
--#----#----#----#----#----#----#----#----#----#----#----#----#----#----#----#----#----#----#----#--
-#--#-#--#-#--#-#--#-#--#-#--#-#--#-#--#-#--#-#--#-#--#-#--#-#--#-#--#-#--#-#--#-#--#-#--#-#--#-#--#
-#----#----#----#----#----#----#----#----#----#----#----#----#----#----#----#----#----#----#----#---
---##---##---##---##---##---##---##---##---##---##---##---##---##---##---##---##---##---##---##---##
----------------------------------------------------------------------------------------------------
--#----#----#----#----#----#----#----#----#----#----#----#----#----#----#----#----#----#----#----#--
-#--#-#--#-#--#-#--#-#--#-#--#-#--#-#--#-#--#-#--#-#--#-#--#-#--#-#--#-#--#-#--#-#--#-#--#-#--#-#--#
-#----#----#----#----#----#----#----#----#----#----#----#----#----#----#----#----#----#----#----#---
---##---##---##---##---##---##---##---##---##---##---##---##---##---##---##-S-##---##---##---##---##
----------------------------------------------------------------------------------------------------
--#----#----#----#----#----#----#----#----#----#----#----#----#----#----#----#----#----#----#----#--
-#--#-#--#-#--#-#--#-#--#-#--#-#--#-#--#-#--#-#--#-#--#-#--#-#--#-#--#-#--#-#--#-#--#-#--#-#--#-#--#
-#----#----#----#----#----#----#----#----#----#----#----#----#----#----#----#----#----#----#----#---
---##---##---##---##---##---##---##---##---##---##---##---##---##---##---##---##---##---##---##---##
----------------------------------------------------------------------------------------------------
--#----#----#----#----#----#----#----#----#----#----#----#----#----#----#----#----#----#----#----#--
-#--#-#--#-#--#-#--#-#--#-#--#-#--#-#--#-#--#-#--#-#--#-#--#-#--#-#--#-#--#-#--#-#--#-#--#-#--#-#--#
-#----#----#----#----#----#----#----#----#----#----#----#----#----#----#----#----#----#----#----#---
---##---##---##---##---##---##---##---##---##---##---##---##---##---##---##---##---##---##---##---##
----------------------------------------------------------------------------------------------------
--#----#----#----#----#----#----#----#----#----#----#----#----#----#----#----#----#----#----#----#--
-#--#-#--#-#--#-#--#-#--#-#--#-#--#-#--#-#--#-#--#-#--#-#--#-#--#-#--#-#--#-#--#-#--#-#--#-#--#-#--#
-#----#----#----#----#----#----#----#----#----#----#----#----#----#----#----#----#----#----#----#---
---##---##---##---##---##---##---##---##---##---##---##---##---##---##---##---##---##---##---##---##
----------------------------------------------------------------------------------------------------
--#----#----#----#----#----#----#----#----#----#----#----#----#----#----#----#----#----#----#----#--
-#--#-#--#-#--#-#--#-#--#-#--#-#--#-#--#-#--#-#--#-#--#-#--#-#--#-#--#-#--#-#--#-#--#-#--#-#--#-#--#
-#----#----#----#----#----#----#----#----#----#----#----#----#----#----#----#----#----#----#----#---
---##---##---##---##---##---##---##---##---##---##---##---##---##---##---##---##---##---##---##---##
----------------------------------------------------------------------------------------------------
--#----#----#----#----#----#----#----#----#----#----#----#----#----#----#----#----#----#----#----#--
-#--#-#--#-#--#-#--#-#--#-#--#-#--#-#--#-#--#-#--#-#--#-#--#-#--#-#--#-#--#-#--#-#--#-#--#-#--#-#--#
-#----#----#----#----#----#----#----#----#----#----#----#----#----#----#----#----#----#----#----#---