?diagonal=Never;
-##---##---##---##---##---##---##---##---##---##---##---##---##---##---##---##---##---##---##---##--
----------------------------------------------------------------------------------------------------
--###--###--###--###--###--###--###--###--###--###--###--###--###--###--###--###--###--###--###--###
----------------------------------------------------------------------------------------------------
----#----#----#----#----#----#----#----#----#----#----#----#----#----#----#----#----#----#----#----#
-##---##---##---##---##---##---##---##---##---##---##---##---##---##---##---##---##---##---##---##--
----------------------------------------------------------------------------------------------------
--###--###--###--###--###--###--###--###--###--###--###--###--###--###--###--###--###--###--###--###
----------------------------------------------------------------------------------------------------
----#----#----#----#----#----#----#----#----#----#----#----#----#----#----#----#----#----#----#----#
-##---##---##---##---##---##---##---##---##---##---##---##---##---##---##---##---##---##---##---##--
----------------------------------------------------------------------------------------------------
--###--###--###--###--###--###--###--###--###--###--###--###--###--###--###--###--###--###--###--###
---------------------S------------------------------------------------------------------------------
----#----#----#----#----#----#----#----#----#----#----#----#----#----#----#----#----#----#----#----#
-##---##---##---##---##---##---##---##---##---##---##---##---##---##---##---##---##---##---##---##--
----------------------------------------------------------------------------------------------------
--###--###--###--###--###--###--###--###--###--###--###--###--###--###--###--###--###--###--###--###
-----------------------------------------------------------------------------------------------E----
----#----#----#----#----#----#----#----#----#----#----#----#----#----#----#----#----#----#----#----#
-##---##---##---##---##---##---##---##---##---##---##---##---##---##---##---##---##---##---##---##--
----------------------------------------------------------------------------------------------------
--###--###--###--###--###--###--###--###--###--###--###--###--###--###--###--###--###--###--###--###
----------------------------------------------------------------------------------------------------
----#----#----#----#----#----#----#----#----#----#----#----#----#----#----#----#----#----#----#----#
-##---##---##---##---##---##---##---##---##---##---##---##---##---##---##---##---##---##---##---##--
----------------------------------------------------------------------------------------------------
--###--###--###--###--###--###--###--###--###--###--###--###--###--###--###--###--###--###--###--###
----------------------------------------------------------------------------------------------------
----#----#----#----#----#----#----#----#----#----#----#----#----#----#----#----#----#----#----#----#
-##---##---##---##---##---##---##---##---##---##---##---##---##---##---##---##---##---##---##---##--
----------------------------------------------------------------------------------------------------
--###--###--###--###--###--###--###--###--###--###--###--###--###--###--###--###--###--###--###--###
----------------------------------------------------------------------------------------------------
----#----#----#----#----#----#----#----#----#----#----#----#----#----#----#----#----#----#----#----#
-##---##---##---##---##---##---##---##---##---##---##---##---##---##---##---##---##---##---##---##--
----------------------------------------------------------------------------------------------------
--###--###--###--###--###--###--###--###--###--###--###--###--###--###--###--###--###--###--###--###
----------------------------------------------------------------------------------------------------
----#----#----#----#----#----#----#----#----#----#----#----#----#----#----#----#----#----#----#----#
-##---##---##---##---##---##---##---##---##---##---##---##---##---##---##---##---##---##---##---##--
----------------------------------------------------------------------------------------------------
--###--###--###--###--###--###--###--###--###--###--###--###--###--###--###--###--###--###--###--###
----------------------------------------------------------------------------------------------------
----#----#----#----#----#----#----#----#----#----#----#----#----#----#----#----#----#----#----#----#
-##---##---##---##---##---##---##---##---##---##---##---##---##---##---##---##---##---##---##---##--
----------------------------------------------------------------------------------------------------
--###--###--###--###--###--###--###--###--###--###--###--###--###--###--###--###--###--###--###--###
----------------------------------------------------------------------------------------------------
----#----#----#----#----#----#----#----#----#----#----#----#----#----#----#----#----#----#----#----#
-##---##---##---##---##---##---##---##---##---##---##---##---##---##---##---##---##---##---##---##--
----------------------------------------------------------------------------------------------------
--###--###--###--###--###--###--###--###--###--###--###--###--###--###--###--###--###--###--###--###
----------------------------------------------------------------------------------------------------
----#----#----#----#----#----#----#----#----#----#----#----#----#----#----#----#----#----#----#----#
-##---##---##---##---##---##---##---##---##---##---##---##---##---##---##---##---##---##---##---##--
----------------------------------------------------------------------------------------------------
--###--###--###--###--###--###--###--###--###--###--###--###--###--###--###--###--###--###--###--###
----------------------------------------------------------------------------------------------------
----#----#----#----#----#----#----#----#----#----#----#----#----#----#----#----#----#----#----#----#
-##---##---##---##---##---##---##---##---##---##---##---##---##---##---##---##---##---##---##---##--
----------------------------------------------------------------------------------------------------
--###--###--###--###--###--###--###--###--###--###--###--###--###--###--###--###--###--###--###--###
----------------------------------------------------------------------------------------------------
----#----#----#----#----#----#----#----#----#----#----#----#----#----#----#----#----#----#----#----#
-##---##---##---##---##---##---##---##---##---##---##---##---##---##---##---##---##---##---##---##--
----------------------------------------------------------------------------------------------------
--###--###--###--###--###--###--###--###--###--###--###--###--###--###--###--###--###--###--###--###
----------------------------------------------------------------------------------------------------
----#----#----#----#----#----#----#----#----#----#----#----#----#----#----#----#----#----#----#----#
-##---##---##---##---##---##---##---##---##---##---##---##---##---##---##---##---##---##---##---##--
----------------------------------------------------------------------------------------------------
--###--###--###--###--###--###--###--###--###--###--###--###--###--###--###--###--###--###--###--###
----------------------------------------------------------------------------------------------------
----#----#----#----#----#----#----#----#----#----#----#----#----#----#----#----#----#----#----#----#
-##---##---##---##---##---##---##---##---##---##---##---##---##---##---##---##---##---##---##---##--
----------------------------------------------------------------------------------------------------
--###--###--###--###--###--###--###--###--###--###--###--###--###--###--###--###--###--###--###--###
----------------------------------------------------------------------------------------------------
----#----#----#----#----#----#----#----#----#----#----#----#----#----#----#----#----#----#----#----#
-##---##---##---##---##---##---##---##---##---##---##---##---##---##---##---##---##---##---##---##--
----------------------------------------------------------------------------------------------------
--###--###--###--###--###--###--###--###--###--###--###--###--###--###--###--###--###--###--###--###
----------------------------------------------------------------------------------------------------
----#----#----#----#----#----#----#----#----#----#----#----#----#----#----#----#----#----#----#----#
-##---##---##---##---##---##---##---##---##---##---##---##---##---##---##---##---##---##---##---##--
----------------------------------------------------------------------------------------------------
--###--###--###--###--###--###--###--###--###--###--###--###--###--###--###--###--###--###--###--###
----------------------------------------------------------------------------------------------------
----#----#----#----#----#----#----#----#----#----#----#----#----#----#----#----#----#----#----#----#
-##---##---##---##---##---##---##---##---##---##---##---##---##---##---##---##---##---##---##---##--
----------------------------------------------------------------------------------------------------
--###--###--###--###--###--###--###--###--###--###--###--###--###--###--###--###--###--###--###--###
----------------------------------------------------------------------------------------------------
----#----#----#----#----#----#----#----#----#----#----#----#----#----#----#----#----#----#----#----#
-##---##---##---##---##---##---##---##---##---##---##---##---##---##---##---##---##---##---##---##--
----------------------------------------------------------------------------------------------------
--###--###--###--###--###--###--###--###--###--###--###--###--###--###--###--###--###--###--###--###
----------------------------------------------------------------------------------------------------
----#----#----#----#----#----#----#----#----#----#----#----#----#----#----#----#----#----#----#----#