?diagonal=Never;
#----#----#----#----#----#----#----#----#----#----#----#----#----#----#----#----#----#----#----#----
-#-#--#-#--#-#--#-#--#-#--#-#--#-#--#-#--#-#--#-#--#-#--#-#--#-#--#-#--#-#--#-#--#-#--#-#--#-#--#-#-
--#----#----#----#----#----#----#----#----#----#----#----#----#----#----#----#----#----#----#----#--
----------------------------------------------------------------------------------------------------
##---##---##---##---##---##---##---##---##---##---##---##---##---##---##---##---##---##---##---##---
#----#----#----#----#----#----#----#----#----#----#----#----#----#----#----#----#----#----#----#----
-#-#--#-#--#-#--#-#--#-#--#-#--#-#--#-#--#-#--#-#--#-#--#-#--#-#--#-#--#-#--#-#--#-#--#-#--#-#--#-#-
--#----#----#----#----#----#----#----#----#----#----#----#----#----#----#----#----#----#----#----#--
----------------------------------------------------------------------------------------------------
##---##---##---##---##---##---##---##---##---##---##---##---##---##---##---##---##---##---##---##---
#----#----#----#----#----#----#----#----#----#----#----#----#----#----#----#----#----#----#----#----
-#-#--#-#--#-#--#-#--#-#--#-#--#-#--#-#--#-#--#-#--#-#--#-#--#-#--#-#--#-#--#-#-S#-#--#-#--#-#--#-#-
--#----#----#----#----#----#----#----#----#----#----#----#----#----#----#----#----#----#----#----#--
----------------------------------------------------------------------------------------------------
##---##---##---##---##---##---##---##---##---##---##---##---##---##---##---##---##---##---##---##---
#----#----#----#----#----#----#----#----#----#----#----#----#----#----#----#----#----#----#----#----
-#-#--#-#--#-#--#-#--#-#--#-#--#-#--#-#--#-#--#-#--#-#--#-#--#-#--#-#--#-#--#-#--#-#--#-#--#-#--#-#-
--#----#----#----#----#----#----#----#----#----#----#----#----#----#----#----#----#----#----#----#--
----------------------------------------------------------------------------------------------------
##---##---##---##---##---##---##---##---##---##---##---##---##---##---##---##---##---##---##---##---
#----#----#----#----#----#----#----#----#----#----#----#----#----#----#----#----#----#----#----#----
-#-#--#-#--#-#--#-#--#-#--#-#--#-#--#-#--#-#--#-#--#-#--#-#--#-#--#-#--#-#--#-#--#-#--#-#--#-#--#-#-
--#----#----#----#----#----#----#----#----#----#----#----#----#----#----#----#----#----#----#----#--
----------------------------------------------------------------------------------------------------
##---##---##---##---##---##---##---##---##---##---##---##---##---##---##---##---##---##---##---##---
#----#----#----#----#----#----#----#----#----#----#----#----#----#----#----#----#----#----#----#----
-#-#--#-#--#-#--#-#--#-#--#-#--#-#--#-#--#-#--#-#--#-#--#-#--#-#--#-#--#-#--#-#--#-#--#-#--#-#--#-#-
--#----#----#----#----#----#----#----#----#----#----#----#----#----#----#----#----#----#----#----#--
----------------------------------------------------------------------------------------------------
##---##---##---##---##---##---##---##---##---##---##---##---##---##---##---##---##---##---##---##---
#----#----#----#----#----#----#----#----#----#----#----#----#----#----#----#----#----#----#----#----
-#-#--#-#--#-#--#-#--#-#--#-#--#-#--#-#--#-#--#-#--#-#--#-#--#-#--#-#--#-#--#-#--#-#--#-#--#-#--#-#-
--#----#----#----#----#----#----#----#----#----#----#----#----#----#----#----#----#----#----#----#--
----------------------------------------------------------------------------------------------------
##---##---##---##---##---##---##---##---##---##---##---##---##---##---##---##---##---##---##---##---
#----#----#----#----#----#----#----#----#----#----#----#----#----#----#----#----#----#----#----#----
-#-#--#-#--#-#--#-#--#-#--#-#--#-#--#-#--#-#--#-#--#-#--#-#--#-#--#-#--#-#--#-#--#-#--#-#--#-#--#-#-
--#----#----#----#----#----#----#----#----#----#----#----#----#----#----#----#----#----#----#----#--
----------------------------------------------------------------------------------------------------
##---##---##---##---##---##---##---##---##---##---##---##---##---##---##---##---##---##---##---##---
#----#----#----#----#----#----#----#----#----#----#----#----#----#----#----#----#----#----#----#----
-#-#--#-#--#-#--#-#--#-#--#-#--#-#--#-#--#-#--#-#--#-#--#-#--#-#--#-#--#-#--#-#--#-#--#-#--#-#--#-#-
--#----#----#----#----#----#----#----#----#----#----#----#----#----#----#----#----#----#----#----#--
----------------------------------------------------------------------------------------------------
##---##---##---##---##---##---##---##---##---##---##---##---##---##---##---##---##---##---##---##---
#----#----#----#----#----#----#----#----#----#----#----#----#----#----#----#----#----#----#----#----
-#-#--#-#--#-#--#-#--#-#--#-#--#-#--#-#--#-#--#-#--#-#--#-#--#-#--#-#--#-#--#-#--#-#--#-#--#-#--#-#-
--#----#----#----#----#----#----#----#----#----#----#----#----#----#----#----#----#----#----#----#--
----------------------------------------------------------------------------------------------------
##---##---##---##---##---##---##---##---##---##---##---##---##---##---##---##---##---##---##---##---
#----#----#----#----#----#----#----#----#----#----#----#----#----#----#----#----#----#----#----#----
-#-#--#-#--#-#--#-#--#-#--#-#--#-#--#-#--#-#--#-#--#-#--#-#--#-#--#-#--#-#--#-#--#-#--#-#--#-#--#-#-
--#----#----#----#----#----#----#----#----#----#----#----#----#----#----#----#----#----#----#----#--
----------------------------------------------------------------------------------------------------
##---##---##---##---##---##---##---##---##---##---##---##---##---##---##---##---##---##---##---##---
#----#----#----#----#----#----#----#----#----#----#----#----#----#----#----#----#----#----#----#----
-#-#--#-#--#-#--#-#--#-#--#-#--#-#--#-#--#-#--#-#--#-#--#-#--#-#--#-#--#-#--#-#--#-#--#-#--#-#--#-#-
--#----#----#----#----#----#----#----#----#----#----#----#----#----#----#----#----#----#----#----#--
----------------------------------------------------------------------------------------------------
##---##---##---##---##---##---##---##---##---##---##---##---##---##---##---##---##---##---##---##---
#----#----#----#----#----#----#----#----#----#----#----#----#----#----#----#----#----#----#----#----
-#-#--#-#--#-#--#-#--#-#--#-#--#-#--#-#--#-#--#-#--#-#--#-#--#-#--#-#--#-#--#-#--#-#--#-#--#-#--#-#-
--#----#----#----#----#----#----#----#----#----#----#----#----#----#----#----#----#----#----#----#--
----------------------------------------------------------------------------------------------------
##---##---##---##---##---##---##---##---##---##---##---##---##---##---##---##---##---##---##---##---
#----#----#----#----#----#----#----#----#----#----#----#----#----#----#----#----#----#----#----#----
-#-#--#-#--#-#--#-#--#-#--#-#--#-#--#-#--#-#--#-#--#E#--#-#--#-#--#-#--#-#--#-#--#-#--#-#--#-#--#-#-
--#----#----#----#----#----#----#----#----#----#----#----#----#----#----#----#----#----#----#----#--
----------------------------------------------------------------------------------------------------
##---##---##---##---##---##---##---##---##---##---##---##---##---##---##---##---##---##---##---##---
#----#----#----#----#----#----#----#----#----#----#----#----#----#----#----#----#----#----#----#----
-#-#--#-#--#-#--#-#--#-#--#-#--#-#--#-#--#-#--#-#--#-#--#-#--#-#--#-#--#-#--#-#--#-#--#-#--#-#--#-#-
--#----#----#----#----#----#----#----#----#----#----#----#----#----#----#----#----#----#----#----#--
----------------------------------------------------------------------------------------------------
##---##---##---##---##---##---##---##---##---##---##---##---##---##---##---##---##---##---##---##---
#----#----#----#----#----#----#----#----#----#----#----#----#----#----#----#----#----#----#----#----
-#-#--#-#--#-#--#-#--#-#--#-#--#-#--#-#--#-#--#-#--#-#--#-#--#-#--#-#--#-#--#-#--#-#--#-#--#-#--#-#-
--#----#----#----#----#----#----#----#----#----#----#----#----#----#----#----#----#----#----#----#--
----------------------------------------------------------------------------------------------------
##---##---##---##---##---##---##---##---##---##---##---##---##---##---##---##---##---##---##---##---
#----#----#----#----#----#----#----#----#----#----#----#----#----#----#----#----#----#----#----#----
-#-#--#-#--#-#--#-#--#-#--#-#--#-#--#-#--#-#--#-#--#-#--#-#--#-#--#-#--#-#--#-#--#-#--#-#--#-#--#-#-
--#----#----#----#----#----#----#----#----#----#----#----#----#----#----#----#----#----#----#----#--
----------------------------------------------------------------------------------------------------
##---##---##---##---##---##---##---##---##---##---##---##---##---##---##---##---##---##---##---##---
#----#----#----#----#----#----#----#----#----#----#----#----#----#----#----#----#----#----#----#----
-#-#--#-#--#-#--#-#--#-#--#-#--#-#--#-#--#-#--#-#--#-#--#-#--#-#--#-#--#-#--#-#--#-#--#-#--#-#--#-#-
--#----#----#----#----#----#----#----#----#----#----#----#----#----#----#----#----#----#----#----#--
----------------------------------------------------------------------------------------------------
##---##---##---##---##---##---##---##---##---##---##---##---##---##---##---##---##---##---##---##---
#----#----#----#----#----#----#----#----#----#----#----#----#----#----#----#----#----#----#----#----
-#-#--#-#--#-#--#-#--#-#--#-#--#-#--#-#--#-#--#-#--#-#--#-#--#-#--#-#--#-#--#-#--#-#--#-#--#-#--#-#-
--#----#----#----#----#----#----#----#----#----#----#----#----#----#----#----#----#----#----#----#--
----------------------------------------------------------------------------------------------------
##---##---##---##---##---##---##---##---##---##---##---##---##---##---##---##---##---##---##---##---
#----#----#----#----#----#----#----#----#----#----#----#----#----#----#----#----#----#----#----#----
-#-#--#-#--#-#--#-#--#-#--#-#--#-#--#-#--#-#--#-#--#-#--#-#--#-#--#-#--#-#--#-#--#-#--#-#--#-#--#-#-
--#----#----#----#----#----#----#----#----#----#----#----#----#----#----#----#----#----#----#----#--
----------------------------------------------------------------------------------------------------
##---##---##---##---##---##---##---##---##---##---##---##---##---##---##---##---##---##---##---##---