?diagonal=OnlyWhenNoObstacles;
----------------------------------------------------------------------------------------------------
---#----#----#----#----#----#----#----#----#----#----#----#----#----#----#----#----#----#----#----#-
-#-##-#-##-#-##-#-##-#-##-#-##-#-##-#-##-#-##-#-##-#-##-#-##-#-##-#-##-#-##-#-##-#-##-#-##-#-##-#-##
##---##---##---##---##---##---##---##---##---##---##---##---##---##---##---##---##---##---##---##---
---#----#----#----#----#----#----#----#----#----#----#----#----#----#----#----#----#----#----#----#-
----------------------------------------------------------------------------------------------------
---#----#----#----#----#----#----#----#----#----#----#----#----#----#----#----#----#----#----#----#-
-#-##-#-##-#-##-#-##-#-##-#-##-#-##-#-##-#-##-#-##-#-##-#-##-#-##-#-##-#-##-#-##-#-##-#-##-#-##-#-##
##---##---##---##---##---##---##---##---##---##---##---##---##---##---##---##---##---##---##---##---
---#----#----#----#----#----#----#----#----#----#----#----#----#----#----#----#----#----#----#----#-
----------------------------------------------------------------------------------------------------
---#----#----#----#----#----#----#----#----#----#----#----#----#----#----#----#----#----#----#----#-
-#-##-#-##-#-##-#-##-#-##-#-##-#-##-#-##-#-##-#-##-#-##-#-##-#-##-#-##-#-##-#-##-#-##-#-##-#-##-#-##
##---##---##---##---##---##---##---##---##---##---##---##---##---##---##---##---##---##---##---##---
---#----#----#----#----#----#----#----#----#----#----#----#----#----#----#----#----#----#----#----#-
----------------------------------------------------------------------------------------------------
---#----#----#----#----#----#----#----#----#----#----#----#----#----#----#----#----#----#----#----#-
-#-##-#-##-#-##-#-##-#-##-#-##-#-##-#-##-#-##-#-##-#-##-#-##-#-##-#-##-#-##-#-##-#-##-#-##-#-##-#-##
##---##---##---##---##---##---##---##---##---##---##---##---##---##---##---##---##---##---##---##---
---#----#----#----#----#----#----#----#----#----#----#----#----#----#----#----#----#----#----#----#-
----------------------------------------------------------------------------------------------------
---#----#----#----#----#----#----#----#----#----#----#----#----#----#----#----#----#----#----#----#-
-#-##-#-##-#-##-#-##-#-##-#-##-#-##-#-##-#-##-#-##-#-##-#-##-#-##-#-##-#-##-#-##-#-##-#-##-#-##-#-##
##---##---##---##---##---##---##---##---##---##---##---##---##---##---##---##---##---##---##---##---
---#----#----#----#----#----#----#----#----#----#----#----#----#----#----#----#----#----#----#----#-
----------------------------------------------------------------------------------------------------
---#----#----#----#----#----#----#----#----#----#----#----#----#----#----#----#----#----#----#----#-
-#-##-#-##-#-##-#-##-#-##-#-##-#-##-#-##-#-##-#-##-#-##-#-##-#-##-#-##-#-##-#-##-#-##-#-##-#-##-#-##
##---##---##---##---##---##---##---##---##---##---##---##---##---##---##---##---##---##---##---##---
---#----#----#----#----#----#----#----#----#----#----#----#----#----#----#----#----#----#----#----#-
----------------------------------------------------------------------------------------------------
---#----#----#----#----#----#----#----#----#----#----#----#----#----#----#----#----#----#----#----#-
-#-##-#-##-#-##-#-##-#-##-#-##-#-##-#-##-#-##-#-##-#-##-#-##-#-##-#-##-#-##-#-##-#-##-#-##-#-##-#-##
##---##---##---##---##---##---##---##---##---##---##---##---##---##---##---##---##---##---##---##---
---#----#----#----#----#----#----#----#----#----#----#----#----#----#----#----#----#----#----#----#-
----------------------------------------------------------------------------------------------------
---#----#----#----#----#----#----#----#----#----#----#----#----#----#----#----#----#----#----#----#-
-#-##-#-##-#-##-#-##-#-##-#-##-#-##-#-##-#-##-#-##-#-##-#-##-#-##-#-##-#-##-#-##-#-##-#-##-#-##-#-##
##---##---##---##---##---##---##---##---##---##---##---##---##---##---##---##---##---##---##---##---
---#----#----#----#----#----#----#----#----#----#----#----#----#----#----#----#----#----#----#----#-
----------------------------------------------------------------------------------------------------
---#----#----#----#----#----#----#----#----#----#----#----#----#----#----#----#----#----#----#----#-
-#-##-#-##-#-##-#-##-#-##-#-##-#-##-#-##-#-##-#-##-#-##-#-##-#-##-#-##-#-##-#-##-#-##-#-##-#-##-#-##
##---##---##---##---##---##---##---##---##---##---##---##---##---##---##---##---##---##---##---##---
---#----#----#----#----#----#----#----#----#----#----#----#----#----#----#----#----#----#----#----#-
----------------------------------------------------------------------------------------------------
---#----#----#----#----#----#----#----#----#----#----#----#----#----#----#----#----#----#----#----#-
-#-##-#-##-#-##-#-##-#-##-#-##-#-##-#-##-#-##-#-##-#-##-#-##-#-##-#-##-#-##-#-##-#-##-#-##-#-##-#-##
##---##---##---##---##---##---##---##---##---##---##---##---##---##---##---##---##---##---##---##---
---#----#----#----#----#----#----#----#----#----#----#----#----#----#----#----#----#----#----#----#-
----------------------------------------------------------------------------------------------------
---#----#----#----#----#----#----#----#----#----#----#----#----#----#----#----#----#----#----#----#-
-#-##-#-##-#-##-#-##-#-##-#-##-#-##-#-##-#-##-#-##-#-##-#-##-#-##-#-##-#-##-#-##-#-##-#-##-#-##-#-##
##---##---##---##---##---##---##---##---##---##---##---##---##---##---##---##---##---##---##---##---
---#----#----#----#----#----#----#----#----#----#----#----#----#----#----#----#----#----#----#----#-
----------------------------------------------------------------------------------------------------
---#----#----#----#----#----#----#----#----#----#----#----#----#----#----#----#----#----#----#----#-
-#-##-#-##-#-##-#-##-#-##-#-##-#-##-#-##-#-##-#-##-#-##-#-##-#-##-#-##-#-##-#-##-#-##-#-##-#-##-#-##
##---##---##---##---##---##---##---##---##---##---##---##---##---##---##---##---##---##---##---##---
---#----#----#----#----#----#----#----#----#----#----#----#----#----#----#----#----#----#----#----#-
----------------------------------------------------------------------------------------------------
---#----#----#----#----#----#----#--E-#----#----#----#----#----#----#----#----#----#----#----#----#-
-#-##-#-##-#-##-#-##-#-##-#-##-#-##-#-##-#-##-#-##-#-##-#-##-#-##-#-##-#-##-#-##-#-##-#-##-#-##-#-##
##---##---##---##---##---##---##---##---##---##---##---##---##---##---##---##---##---##---##---##---
---#----#----#----#----#----#----#----#----#----#----#----#-S--#----#----#----#----#----#----#----#-
----------------------------------------------------------------------------------------------------
---#----#----#----#----#----#----#----#----#----#----#----#----#----#----#----#----#----#----#----#-
-#-##-#-##-#-##-#-##-#-##-#-##-#-##-#-##-#-##-#-##-#-##-#-##-#-##-#-##-#-##-#-##-#-##-#-##-#-##-#-##
##---##---##---##---##---##---##---##---##---##---##---##---##---##---##---##---##---##---##---##---
---#----#----#----#----#----#----#----#----#----#----#----#----#----#----#----#----#----#----#----#-
----------------------------------------------------------------------------------------------------
---#----#----#----#----#----#----#----#----#----#----#----#----#----#----#----#----#----#----#----#-
-#-##-#-##-#-##-#-##-#-##-#-##-#-##-#-##-#-##-#-##-#-##-#-##-#-##-#-##-#-##-#-##-#-##-#-##-#-##-#-##
##---##---##---##---##---##---##---##---##---##---##---##---##---##---##---##---##---##---##---##---
---#----#----#----#----#----#----#----#----#----#----#----#----#----#----#----#----#----#----#----#-
----------------------------------------------------------------------------------------------------
---#----#----#----#----#----#----#----#----#----#----#----#----#----#----#----#----#----#----#----#-
-#-##-#-##-#-##-#-##-#-##-#-##-#-##-#-##-#-##-#-##-#-##-#-##-#-##-#-##-#-##-#-##-#-##-#-##-#-##-#-##
##---##---##---##---##---##---##---##---##---##---##---##---##---##---##---##---##---##---##---##---
---#----#----#----#----#----#----#----#----#----#----#----#----#----#----#----#----#----#----#----#-
----------------------------------------------------------------------------------------------------
---#----#----#----#----#----#----#----#----#----#----#----#----#----#----#----#----#----#----#----#-
-#-##-#-##-#-##-#-##-#-##-#-##-#-##-#-##-#-##-#-##-#-##-#-##-#-##-#-##-#-##-#-##-#-##-#-##-#-##-#-##
##---##---##---##---##---##---##---##---##---##---##---##---##---##---##---##---##---##---##---##---
---#----#----#----#----#----#----#----#----#----#----#----#----#----#----#----#----#----#----#----#-
----------------------------------------------------------------------------------------------------
---#----#----#----#----#----#----#----#----#----#----#----#----#----#----#----#----#----#----#----#-
-#-##-#-##-#-##-#-##-#-##-#-##-#-##-#-##-#-##-#-##-#-##-#-##-#-##-#-##-#-##-#-##-#-##-#-##-#-##-#-##
##---##---##---##---##---##---##---##---##---##---##---##---##---##---##---##---##---##---##---##---
---#----#----#----#----#----#----#----#----#----#----#----#----#----#----#----#----#----#----#----#-
----------------------------------------------------------------------------------------------------
---#----#----#----#----#----#----#----#----#----#----#----#----#----#----#----#----#----#----#----#-
-#-##-#-##-#-##-#-##-#-##-#-##-#-##-#-##-#-##-#-##-#-##-#-##-#-##-#-##-#-##-#-##-#-##-#-##-#-##-#-##
##---##---##---##---##---##---##---##---##---##---##---##---##---##---##---##---##---##---##---##---
---#----#----#----#----#----#----#----#----#----#----#----#----#----#----#----#----#----#----#----#-
----------------------------------------------------------------------------------------------------
---#----#----#----#----#----#----#----#----#----#----#----#----#----#----#----#----#----#----#----#-
-#-##-#-##-#-##-#-##-#-##-#-##-#-##-#-##-#-##-#-##-#-##-#-##-#-##-#-##-#-##-#-##-#-##-#-##-#-##-#-##
##---##---##---##---##---##---##---##---##---##---##---##---##---##---##---##---##---##---##---##---
---#----#----#----#----#----#----#----#----#----#----#----#----#----#----#----#----#----#----#----#-