?diagonal=OnlyWhenNoObstacles;
--##---##---##---##---##---##---##---##---##---##---##---##---##---##---##---##---##---##---##---##-
-----------------------------------------------------------------------------------E----------------
#--#-#--#-#--#-#--#-#--#-#--#-#--#-#--#-#--#-#--#-#--#-#--#-#--#-#--#-#--#-#--#-#--#-#--#-#--#-#--#-
----#----#----#----#----#----#----#----#----#----#----#----#----#----#----#----#----#----#----#----#
#----#----#----#----#----#----#----#----#----#----#----#----#----#----#----#----#----#----#----#----
--##---##---##---##---##---##---##---##---##---##---##---##---##---##---##---##---##---##---##---##-
----------------------------------------------------------------------------------------------------
#--#-#--#-#--#-#--#-#--#-#--#-#--#-#--#-#--#-#--#-#--#-#--#-#--#-#--#-#--#-#--#-#--#-#--#-#--#-#--#-
----#----#----#----#----#----#----#----#----#----#----#----#----#----#----#----#----#----#----#----#
#----#----#----#----#----#----#----#----#----#----#----#----#----#----#----#----#----#----#----#----
--##---##---##---##---##---##---##---##---##---##---##---##---##---##---##---##---##---##---##---##-
----------------------------------------------------------------------------------------------------
#--#-#--#-#--#-#--#-#--#-#--#-#--#-#--#-#--#-#--#-#--#-#--#-#--#-#--#-#--#-#--#-#--#-#--#-#--#-#--#-
----#----#----#----#----#----#----#----#----#----#----#----#----#----#----#----#----#----#----#----#
#----#----#----#----#----#----#----#----#----#----#----#----#----#----#----#----#----#----#----#----
--##---##---##---##---##---##---##---##---##---##---##---##---##---##---##---##---##---##---##---##-
----------------------------------------------------------------------------------------------------
#--#-#--#-#--#-#--#-#--#-#--#-#--#-#--#-#--#-#--#-#--#-#--#-#--#-#--#-#--#-#--#-#--#-#--#-#--#-#--#-
----#----#----#----#----#----#----#----#----#----#----#----#----#----#----#----#----#----#----#----#
#----#----#----#----#----#----#----#----#----#----#----#----#----#----#----#----#----#----#----#----
--##---##---##---##---##--S##---##---##---##---##---##---##---##---##---##---##---##---##---##---##-
----------------------------------------------------------------------------------------------------
#--#-#--#-#--#-#--#-#--#-#--#-#--#-#--#-#--#-#--#-#--#-#--#-#--#-#--#-#--#-#--#-#--#-#--#-#--#-#--#-
----#----#----#----#----#----#----#----#----#----#----#----#----#----#----#----#----#----#----#----#
#----#----#----#----#----#----#----#----#----#----#----#----#----#----#----#----#----#----#----#----
--##---##---##---##---##---##---##---##---##---##---##---##---##---##---##---##---##---##---##---##-
----------------------------------------------------------------------------------------------------
#--#-#--#-#--#-#--#-#--#-#--#-#--#-#--#-#--#-#--#-#--#-#--#-#--#-#--#-#--#-#--#-#--#-#--#-#--#-#--#-
----#----#----#----#----#----#----#----#----#----#----#----#----#----#----#----#----#----#----#----#
#----#----#----#----#----#----#----#----#----#----#----#----#----#----#----#----#----#----#----#----
--##---##---##---##---##---##---##---##---##---##---##---##---##---##---##---##---##---##---##---##-
----------------------------------------------------------------------------------------------------
#--#-#--#-#--#-#--#-#--#-#--#-#--#-#--#-#--#-#--#-#--#-#--#-#--#-#--#-#--#-#--#-#--#-#--#-#--#-#--#-
----#----#----#----#----#----#----#----#----#----#----#----#----#----#----#----#----#----#----#----#
#----#----#----#----#----#----#----#----#----#----#----#----#----#----#----#----#----#----#----#----
--##---##---##---##---##---##---##---##---##---##---##---##---##---##---##---##---##---##---##---##-
----------------------------------------------------------------------------------------------------
#--#-#--#-#--#-#--#-#--#-#--#-#--#-#--#-#--#-#--#-#--#-#--#-#--#-#--#-#--#-#--#-#--#-#--#-#--#-#--#-
----#----#----#----#----#----#----#----#----#----#----#----#----#----#----#----#----#----#----#----#
#----#----#----#----#----#----#----#----#----#----#----#----#----#----#----#----#----#----#----#----
--##---##---##---##---##---##---##---##---##---##---##---##---##---##---##---##---##---##---##---##-
----------------------------------------------------------------------------------------------------
#--#-#--#-#--#-#--#-#--#-#--#-#--#-#--#-#--#-#--#-#--#-#--#-#--#-#--#-#--#-#--#-#--#-#--#-#--#-#--#-
----#----#----#----#----#----#----#----#----#----#----#----#----#----#----#----#----#----#----#----#
#----#----#----#----#----#----#----#----#----#----#----#----#----#----#----#----#----#----#----#----
--##---##---##---##---##---##---##---##---##---##---##---##---##---##---##---##---##---##---##---##-
----------------------------------------------------------------------------------------------------
#--#-#--#-#--#-#--#-#--#-#--#-#--#-#--#-#--#-#--#-#--#-#--#-#--#-#--#-#--#-#--#-#--#-#--#-#--#-#--#-
----#----#----#----#----#----#----#----#----#----#----#----#----#----#----#----#----#----#----#----#
#----#----#----#----#----#----#----#----#----#----#----#----#----#----#----#----#----#----#----#----
--##---##---##---##---##---##---##---##---##---##---##---##---##---##---##---##---##---##---##---##-
----------------------------------------------------------------------------------------------------
#--#-#--#-#--#-#--#-#--#-#--#-#--#-#--#-#--#-#--#-#--#-#--#-#--#-#--#-#--#-#--#-#--#-#--#-#--#-#--#-
----#----#----#----#----#----#----#----#----#----#----#----#----#----#----#----#----#----#----#----#
#----#----#----#----#----#----#----#----#----#----#----#----#----#----#----#----#----#----#----#----
--##---##---##---##---##---##---##---##---##---##---##---##---##---##---##---##---##---##---##---##-
----------------------------------------------------------------------------------------------------
#--#-#--#-#--#-#--#-#--#-#--#-#--#-#--#-#--#-#--#-#--#-#--#-#--#-#--#-#--#-#--#-#--#-#--#-#--#-#--#-
----#----#----#----#----#----#----#----#----#----#----#----#----#----#----#----#----#----#----#----#
#----#----#----#----#----#----#----#----#----#----#----#----#----#----#----#----#----#----#----#----
--##---##---##---##---##---##---##---##---##---##---##---##---##---##---##---##---##---##---##---##-
----------------------------------------------------------------------------------------------------
#--#-#--#-#--#-#--#-#--#-#--#-#--#-#--#-#--#-#--#-#--#-#--#-#--#-#--#-#--#-#--#-#--#-#--#-#--#-#--#-
----#----#----#----#----#----#----#----#----#----#----#----#----#----#----#----#----#----#----#----#
#----#----#----#----#----#----#----#----#----#----#----#----#----#----#----#----#----#----#----#----
--##---##---##---##---##---##---##---##---##---##---##---##---##---##---##---##---##---##---##---##-
----------------------------------------------------------------------------------------------------
#--#-#--#-#--#-#--#-#--#-#--#-#--#-#--#-#--#-#--#-#--#-#--#-#--#-#--#-#--#-#--#-#--#-#--#-#--#-#--#-
----#----#----#----#----#----#----#----#----#----#----#----#----#----#----#----#----#----#----#----#
#----#----#----#----#----#----#----#----#----#----#----#----#----#----#----#----#----#----#----#----
--##---##---##---##---##---##---##---##---##---##---##---##---##---##---##---##---##---##---##---##-
----------------------------------------------------------------------------------------------------
#--#-#--#-#--#-#--#-#--#-#--#-#--#-#--#-#--#-#--#-#--#-#--#-#--#-#--#-#--#-#--#-#--#-#--#-#--#-#--#-
----#----#----#----#----#----#----#----#----#----#----#----#----#----#----#----#----#----#----#----#
#----#----#----#----#----#----#----#----#----#----#----#----#----#----#----#----#----#----#----#----
--##---##---##---##---##---##---##---##---##---##---##---##---##---##---##---##---##---##---##---##-
----------------------------------------------------------------------------------------------------
#--#-#--#-#--#-#--#-#--#-#--#-#--#-#--#-#--#-#--#-#--#-#--#-#--#-#--#-#--#-#--#-#--#-#--#-#--#-#--#-
----#----#----#----#----#----#----#----#----#----#----#----#----#----#----#----#----#----#----#----#
#----#----#----#----#----#----#----#----#----#----#----#----#----#----#----#----#----#----#----#----
--##---##---##---##---##---##---##---##---##---##---##---##---##---##---##---##---##---##---##---##-
----------------------------------------------------------------------------------------------------
#--#-#--#-#--#-#--#-#--#-#--#-#--#-#--#-#--#-#--#-#--#-#--#-#--#-#--#-#--#-#--#-#--#-#--#-#--#-#--#-
----#----#----#----#----#----#----#----#----#----#----#----#----#----#----#----#----#----#----#----#
#----#----#----#----#----#----#----#----#----#----#----#----#----#----#----#----#----#----#----#----
--##---##---##---##---##---##---##---##---##---##---##---##---##---##---##---##---##---##---##---##-
----------------------------------------------------------------------------------------------------
#--#-#--#-#--#-#--#-#--#-#--#-#--#-#--#-#--#-#--#-#--#-#--#-#--#-#--#-#--#-#--#-#--#-#--#-#--#-#--#-
----#----#----#----#----#----#----#----#----#----#----#----#----#----#----#----#----#----#----#----#
#----#----#----#----#----#----#----#----#----#----#----#----#----#----#----#----#----#----#----#----
--##---##---##---##---##---##---##---##---##---##---##---##---##---##---##---##---##---##---##---##-
----------------------------------------------------------------------------------------------------
#--#-#--#-#--#-#--#-#--#-#--#-#--#-#--#-#--#-#--#-#--#-#--#-#--#-#--#-#--#-#--#-#--#-#--#-#--#-#--#-
----#----#----#----#----#----#----#----#----#----#----#----#----#----#----#----#----#----#----#----#
#----#----#----#----#----#----#----#----#----#----#----#----#----#----#----#----#----#----#----#----
--##---##---##---##---##---##---##---##---##---##---##---##---##---##---##---##---##---##---##---##-
----------------------------------------------------------------------------------------------------
#--#-#--#-#--#-#--#-#--#-#--#-#--#-#--#-#--#-#--#-#--#-#--#-#--#-#--#-#--#-#--#-#--#-#--#-#--#-#--#-
----#----#----#----#----#----#----#----#----#----#----#----#----#----#----#----#----#----#----#----#
#----#----#----#----#----#----#----#----#----#----#----#----#----#----#----#----#----#----#----#----