?diagonal=OnlyWhenNoObstacles;
----------------------------------------------------------------------------------------------------
#-#--#-#--#-#--#-#--#-#--#-#--#-#--#-#--#-#--#-#--#-#--#-#--#-#--#-#--#-#--#-#--#-#--#-#--#-#--#-#--
###-####-####-####-####-####-####-####-####-####-####-####-####-####-####-####-####-####-####-####-#
--#----#----#----#----#----#----#----#----#----#----#----#----#----#----#----#----#----#----#----#--
----------------------------------------------------------------------------------------------------
----------------------------------------------------------------------------------------------------
#-#--#-#--#-#--#-#--#-#--#-#--#-#--#-#--#-#--#-#--#-#--#-#--#-#--#-#--#-#--#-#--#-#--#-#--#-#--#-#--
###-####-####-####-####-####-####-####-####-####-####-####-####-####-####-####-####-####-####-####-#
--#----#----#----#----#----#----#----#----#----#----#----#----#----#----#----#----#----#----#----#--
----------------------------------------------------------------------------------------------------
----------------------------------------------------------------------------------------------------
#-#--#-#--#-#--#-#--#-#--#-#--#-#--#-#--#-#--#-#--#-#--#-#--#-#--#-#--#-#--#-#--#-#--#-#--#-#--#-#--
###-####-####-####-####-####-####-####-####-####-####-####-####-####-####-####-####-####-####-####-#
--#----#----#----#----#----#----#----#----#----#----#----#----#----#----#----#----#----#----#----#--
----------------------------------------------E-----------------------------------------------------
----------------------------------------------------------------------------------------------------
#-#--#-#--#-#--#-#--#-#--#-#--#-#--#-#--#-#--#-#--#-#--#-#--#-#--#-#--#-#--#-#--#-#--#-#--#-#--#-#--
###-####-####-####-####-####-####-####-####-####-####-####-####-####-####-####-####-####-####-####-#
--#----#----#----#----#----#----#----#----#----#----#----#----#----#----#----#----#----#----#----#--
----------------------------------------------------------------------------------------------------
----------------------------------------------------------------------------------------------------
#-#--#-#--#-#--#-#--#-#--#-#--#-#--#-#--#-#--#-#--#-#--#-#--#-#--#-#--#-#--#-#--#-#--#-#--#-#--#-#--
###-####-####-####-####-####-####-####-####-####-####-####-####-####-####-####-####-####-####-####-#
--#----#----#----#----#----#----#----#----#----#----#----#----#----#----#----#----#----#----#----#--
----------------------------------------------------------------------------------------------------
----------------------------------------------------------------------------------------------------
#-#--#-#--#-#--#-#--#-#--#-#--#-#--#-#--#-#--#-#--#-#--#-#--#-#--#-#--#-#--#-#--#-#--#-#--#-#--#-#--
###-####-####-####-####-####-####-####-####-####-####-####-####-####-####-####-####-####-####-####-#
--#----#----#----#----#----#----#----#----#----#----#----#----#----#----#----#----#----#----#----#--
----------------------------------------------------------------------------------------------------
----------------------------------------------------------------------------------------------------
#-#--#-#--#-#--#-#--#-#--#-#--#-#--#-#--#-#--#-#--#-#--#-#--#-#--#-#--#-#--#-#--#-#--#-#--#-#--#-#--
###-####-####-####-####-####-####-####-####-####-####-####-####-####-####-####-####-####-####-####-#
--#----#----#----#----#----#----#----#----#----#----#----#----#----#----#----#----#----#----#----#--
----------------------------------------------------------------------------------------------------
----------------------------------------------------------------------------------------------------
#-#--#-#--#-#--#-#--#-#--#-#--#-#--#-#--#-#--#-#--#-#--#-#--#-#--#-#--#-#--#-#--#-#--#-#--#-#--#-#--
###-####-####-####-####-####-####-####-####-####-####-####-####-####-####-####-####-####-####-####-#
--#----#----#----#----#----#----#----#----#----#----#----#----#----#----#----#----#----#----#----#--
----------------------------------------------------------------------------------------------------
----------------------------------------------------------------------------------------------------
#-#--#-#--#-#--#-#--#-#--#-#--#-#--#-#--#-#--#-#--#-#--#-#--#-#--#-#--#-#--#-#--#-#--#-#--#-#--#-#--
###-####-####-####-####-####-####-####-####-####-####-####-####-####-####-####-####-####-####-####-#
--#----#----#----#----#----#----#----#----#----#----#----#----#----#----#----#----#----#----#----#--
----------------------------------------------------------------------------------------------------
----------------------------------------------------------------------------------------------------
#-#--#-#--#-#--#-#--#-#--#-#--#-#--#-#--#-#--#-#--#-#--#-#--#-#--#-#--#-#--#-#--#-#--#-#--#-#--#-#--
###-####-####-####-####-####-####-####-####-####-####-####-####-####-####-####-####-####-####-####-#
--#----#----#----#----#----#----#----#----#----#----#----#----#----#----#----#----#----#----#----#--
----------------------------------------------------------------------------------------------------
----------------------------------------------------------------------------------------------------
#-#--#-#--#-#--#-#--#-#--#-#--#-#--#-#--#-#--#-#--#-#--#-#--#-#--#-#--#-#--#-#--#-#--#-#--#-#--#-#--
###-####-####-####-####-####-####-####-####-####-####-####-####-####-####-####-####-####-####-####-#
--#----#----#----#----#----#----#----#----#----#----#----#----#----#----#----#----#----#----#----#--
----------------------------------------------------------------------------------------------------
----------------------------------------------------------------------------------------------------
#-#--#-#--#-#--#-#--#-#--#-#--#-#--#-#--#-#--#-#--#-#--#-#--#-#--#-#--#-#--#-#--#-#--#-#--#-#--#-#--
###-####-####-####-####-####-####-####-####-####-####-####-####-####-####-####-####-####-####-####-#
--#----#----#----#----#----#----#----#----#----#----#----#----#----#----#----#----#----#----#----#--
----------------------------------------------------------------------------------------------------
----------------------------------------------------------------------------------------------------
#-#--#-#--#-#--#-#--#-#--#-#--#-#--#-#--#-#--#-#--#-#--#-#--#-#--#-#--#-#--#-#--#-#--#-#--#-#--#-#--
###-####-####-####-####-####-####-####-####-####-####-####-####-####-####-####-####-####-####-####-#
--#----#----#----#----#----#----#----#----#----#----#----#----#----#----#----#----#----#----#----#--
----------------------------------------------------------------------------------------------------
----------------------------------------------------------------------------------------------------
#-#--#-#--#-#--#-#--#-#--#-#--#-#--#-#--#-#--#-#--#-#--#-#--#-#--#-#--#-#--#-#--#-#--#-#--#-#--#-#--
###-####-####-####-####-####-####-####-####-####-####-####-####-####-####-####-####-####-####-####-#
--#----#----#----#----#----#----#----#----#----#----#----#----#----#----#----#----#----#----#----#--
----------------------------------------------------------------------------------------------------
---------S------------------------------------------------------------------------------------------
#-#--#-#--#-#--#-#--#-#--#-#--#-#--#-#--#-#--#-#--#-#--#-#--#-#--#-#--#-#--#-#--#-#--#-#--#-#--#-#--
###-####-####-####-####-####-####-####-####-####-####-####-####-####-####-####-####-####-####-####-#
--#----#----#----#----#----#----#----#----#----#----#----#----#----#----#----#----#----#----#----#--
----------------------------------------------------------------------------------------------------
----------------------------------------------------------------------------------------------------
#-#--#-#--#-#--#-#--#-#--#-#--#-#--#-#--#-#--#-#--#-#--#-#--#-#--#-#--#-#--#-#--#-#--#-#--#-#--#-#--
###-####-####-####-####-####-####-####-####-####-####-####-####-####-####-####-####-####-####-####-#
--#----#----#----#----#----#----#----#----#----#----#----#----#----#----#----#----#----#----#----#--
----------------------------------------------------------------------------------------------------
----------------------------------------------------------------------------------------------------
#-#--#-#--#-#--#-#--#-#--#-#--#-#--#-#--#-#--#-#--#-#--#-#--#-#--#-#--#-#--#-#--#-#--#-#--#-#--#-#--
###-####-####-####-####-####-####-####-####-####-####-####-####-####-####-####-####-####-####-####-#
--#----#----#----#----#----#----#----#----#----#----#----#----#----#----#----#----#----#----#----#--
----------------------------------------------------------------------------------------------------
----------------------------------------------------------------------------------------------------
#-#--#-#--#-#--#-#--#-#--#-#--#-#--#-#--#-#--#-#--#-#--#-#--#-#--#-#--#-#--#-#--#-#--#-#--#-#--#-#--
###-####-####-####-####-####-####-####-####-####-####-####-####-####-####-####-####-####-####-####-#
--#----#----#----#----#----#----#----#----#----#----#----#----#----#----#----#----#----#----#----#--
----------------------------------------------------------------------------------------------------
----------------------------------------------------------------------------------------------------
#-#--#-#--#-#--#-#--#-#--#-#--#-#--#-#--#-#--#-#--#-#--#-#--#-#--#-#--#-#--#-#--#-#--#-#--#-#--#-#--
###-####-####-####-####-####-####-####-####-####-####-####-####-####-####-####-####-####-####-####-#
--#----#----#----#----#----#----#----#----#----#----#----#----#----#----#----#----#----#----#----#--
----------------------------------------------------------------------------------------------------
----------------------------------------------------------------------------------------------------
#-#--#-#--#-#--#-#--#-#--#-#--#-#--#-#--#-#--#-#--#-#--#-#--#-#--#-#--#-#--#-#--#-#--#-#--#-#--#-#--
###-####-####-####-####-####-####-####-####-####-####-####-####-####-####-####-####-####-####-####-#
--#----#----#----#----#----#----#----#----#----#----#----#----#----#----#----#----#----#----#----#--
----------------------------------------------------------------------------------------------------