?diagonal=OnlyWhenNoObstacles;
-#--#-#--#-#--#-#--#-#--#-#--#-#--#-#--#-#--#-#--#-#--#-#--#-#--#-#--#-#--#-#--#-#--#-#--#-#--#-#--#
----------------------------------------------------------------------------------------------------
#--#-#--#-#--#-#--#-#--#-#--#-#--#-#--#-#--#-#--#-#--#-#--#-#--#-#--#-#--#-#--#-#--#-#--#-#--#-#--#-
----#----#----#----#----#----#----#----#----#----#----#----#----#----#----#----#----#----#----#----#
-#----#----#----#----#----#----#----#----#----#----#----#----#----#----#----#----#----#----#----#---
-#--#-#--#-#--#-#--#-#--#-#--#-#--#-#--#-#--#-#--#-#--#-#--#-#--#-#--#-#--#-#--#-#--#-#--#-#--#-#--#
----------------------------------------------------------------------------------------------------
#--#-#--#-#--#-#--#-#--#-#--#-#--#-#--#-#--#-#--#-#--#-#--#-#--#-#--#-#--#-#--#-#--#-#--#-#--#-#--#-
----#----#----#----#----#----#----#----#----#----#----#----#----#----#----#----#----#----#----#----#
-#----#----#----#----#----#----#----#----#----#----#----#----#----#----#----#----#----#----#----#---
-#--#-#--#-#--#-#--#-#--#-#--#-#--#-#--#-#--#-#--#-#--#-#--#-#--#-#--#-#--#-#--#-#--#-#--#-#--#-#--#
----------------------------------------------------------------------------------------------------
#--#-#--#-#--#-#--#-#--#-#--#-#--#-#--#-#--#-#--#-#--#-#--#-#--#-#--#-#--#-#--#-#--#-#--#-#--#-#--#-
----#----#----#----#----#----#----#----#----#----#----#----#----#----#----#----#----#----#----#----#
-#----#----#----#----#----#----#----#----#----#----#----#----#----#----#----#----#----#----#----#---
-#--#-#--#-#--#-#--#-#--#-#--#-#--#-#--#-#--#-#--#-#--#-#--#-#--#-#--#-#--#-#--#-#--#-#--#-#--#-#--#
----------------------------------------------------------------------------------------------------
#--#-#--#-#--#-#--#-#--#-#--#-#--#-#--#-#--#-#--#-#--#-#--#-#--#-#--#-#--#-#--#-#--#-#--#-#--#-#--#-
----#----#----#----#----#----#----#----#----#----#----#----#----#----#----#----#----#----#----#----#
-#----#----#----#----#----#----#----#----#----#----#----#----#----#----#----#----#----#----#----#---
-#--#-#--#-#--#-#--#-#--#-#--#-#--#-#--#-#--#-#--#-#--#-#--#-#--#-#--#-#--#-#--#-#--#-#--#-#--#-#--#
----------------------------------------------------------------------------------------------------
#--#-#--#-#--#-#--#-#--#-#--#-#--#-#--#-#--#-#--#-#--#-#--#-#--#-#--#-#--#-#--#-#--#-#--#-#--#-#--#-
----#----#----#----#----#----#----#----#----#----#----#----#----#----#----#----#----#----#----#----#
-#----#----#----#----#----#----#----#----#----#----#----#----#----#----#----#----#----#----#----#---
-#--#-#--#-#--#-#--#-#--#-#--#-#--#-#--#-#--#-#--#-#--#-#--#-#--#-#--#-#--#-#--#-#--#-#--#-#--#-#--#
----------------------------------------------------------------------------------------------------
#--#-#--#-#--#-#--#-#--#-#--#-#--#-#--#-#--#-#--#-#--#-#--#-#--#-#--#-#--#-#--#-#--#-#--#-#--#-#--#-
----#----#----#----#----#----#----#----#----#----#----#----#----#----#----#----#----#----#----#----#
-#----#----#----#----#----#----#----#----#----#----#----#----#----#----#----#----#----#----#----#---
-#--#-#--#-#--#-#--#-#--#-#--#-#--#-#--#-#--#-#--#-#--#-#--#-#--#-#--#-#--#-#--#-#--#-#--#-#-S#-#--#
----------------------------------------------------------------------------------------------------
#--#-#--#-#--#-#--#-#--#-#--#-#--#-#--#-#--#-#--#-#--#-#--#-#--#-#--#-#--#-#--#-#--#-#--#-#--#-#--#-
----#----#----#----#----#----#----#----#----#----#----#----#----#----#----#----#----#----#----#----#
-#----#----#----#----#----#----#----#----#----#----#----#----#----#----#----#----#----#----#----#---
-#--#-#--#-#--#-#--#-#--#-#--#-#--#-#--#-#--#-#--#-#--#-#--#-#--#-#--#-#--#-#--#-#--#-#--#-#--#-#--#
----------------------------------------------------------------------------------------------------
#--#-#--#-#--#-#--#-#--#-#--#-#--#-#--#-#--#-#--#-#--#-#--#-#--#-#--#-#--#-#--#-#--#-#--#-#--#-#--#-
----#----#----#----#----#----#----#----#----#----#----#----#----#----#----#----#----#----#----#----#
-#----#----#----#----#----#----#----#----#----#----#----#----#----#----#----#----#----#----#----#---
-#--#-#--#-#--#-#--#-#--#-#--#-#--#-#--#-#--#-#--#-#--#-#--#-#--#-#--#-#--#-#--#-#--#-#--#-#--#-#--#
----------------------------------------------------------------------------------------------------
#--#-#--#-#--#-#--#-#--#-#--#-#--#-#--#-#--#-#--#-#--#-#--#-#--#-#--#-#--#-#--#-#--#-#--#-#--#-#--#-
----#----#----#----#----#----#----#----#----#----#----#----#----#----#----#----#----#----#----#----#
-#----#----#----#----#----#----#----#----#----#----#----#----#----#----#----#----#----#----#----#---
-#--#-#--#-#--#-#--#-#--#-#--#-#--#-#--#-#--#-#--#-#--#-#--#-#--#-#--#-#--#-#--#-#--#-#--#-#--#-#--#
----------------------------------------------------------------------------------------------------
#--#-#--#-#--#-#--#-#--#-#--#-#--#-#--#-#--#-#--#-#--#-#--#-#--#-#--#-#--#-#--#-#--#-#--#-#--#-#--#-
----#----#----#----#----#----#----#----#----#----#----#----#----#----#----#----#----#----#----#----#
-#----#----#----#----#----#----#----#----#----#----#----#----#----#----#----#----#----#----#----#---
-#--#-#--#-#--#-#--#-#--#-#--#-#--#-#--#-#--#-#--#-#--#-#--#-#--#-#--#-#--#-#--#-#--#-#--#-#--#-#--#
----------------------------------------------------------------------------------------------------
#--#-#--#-#--#-#--#-#--#-#--#-#--#-#--#-#--#-#--#-#--#-#--#-#--#-#--#-#--#-#--#-#--#-#--#-#--#-#--#-
----#----#----#----#----#----#----#----#----#----#----#----#----#----#----#----#----#----#----#----#
-#----#----#----#----#----#----#----#----#----#----#----#----#----#----#----#----#----#----#----#---
-#--#-#--#-#--#-#--#-#--#-#--#-#--#-#--#-#--#-#--#-#--#-#--#-#--#-#--#-#--#-#--#-#--#-#--#-#--#-#--#
----------------------------------------------------------------------------------------------------
#--#-#--#-#--#-#--#-#--#-#--#-#--#-#--#-#--#-#--#-#--#-#--#-#--#-#--#-#--#-#--#-#--#-#--#-#--#-#--#-
----#----#----#----#----#----#----#----#----#----#----#----#----#----#----#----#----#----#----#----#
-#----#----#----#----#----#----#----#----#----#----#----#----#----#----#----#----#----#----#----#---
-#--#-#--#-#--#-#--#-#--#-#--#-#--#-#--#-#--#-#--#-#--#-#--#-#--#-#--#-#--#-#--#-#--#-#--#-#--#-#--#
----------------------------------------------------------------------------------------------------
#--#-#--#-#--#-#--#-#--#-#--#-#--#-#--#-#--#-#--#-#--#-#--#-#--#-#--#-#--#-#--#-#--#-#--#-#--#-#--#-
----#----#----#----#----#----#----#----#----#----#----#----#----#----#----#----#----#----#----#----#
-#----#----#----#----#----#----#----#----#----#----#----#----#----#----#----#----#----#----#----#---
-#--#-#--#-#--#-#--#-#--#-#--#-#--#-#--#-#--#-#--#-#--#-#--#-#--#-#--#-#--#-#--#-#--#-#--#-#--#-#--#
----------------------------------------------------------------------------------------------------
#--#-#--#-#--#-#--#-#--#-#--#-#--#-#--#-#--#-#--#-#--#-#--#-#--#-#--#-#--#-#--#-#--#-#--#-#--#-#--#-
----#----#----#----#----#----#----#----#----#----#----#----#----#----#----#----#----#----#----#----#
-#----#----#----#----#----#----#----#----#----#----#----#----#----#----#----#----#----#----#----#---
-#--#-#--#-#--#-#--#-#--#-#--#-#--#-#--#-#--#-#--#-#--#-#--#-#--#-#--#-#--#-#--#-#--#-#--#-#--#-#--#
----------------------------------------------------------------------------------------------------
#--#-#--#-#--#-#--#-#--#-#--#-#--#-#--#-#--#-#--#-#--#-#--#-#--#-#--#-#--#-#--#-#--#-#--#-#--#-#--#-
----#----#----#----#----#----#----#----#----#----#----#----#----#----#----#----#----#----#----#----#
-#----#----#----#----#----#----#----#----#----#----#----#----#----#----#----#----#----#----#----#---
-#--#-#--#-#--#-#--#-#--#-#--#-#--#-#--#-#--#-#--#-#--#-#--#-#--#-#--#-#--#-#--#-#--#-#--#-#--#-#--#
----------------------------------------------------------------------------------------------------
#--#-#--#-#--#-#--#-#--#-#--#-#--#-#--#-#--#-#--#-#--#-#--#-#--#-#--#-#--#-#--#-#--#-#--#-#--#-#--#-
----#----#----#----#----#----#----#----#----#----#----#----#----#----#----#----#----#----#----#----#
-#----#----#----#----#----#----#----#----#----#----#----#----#----#----#----#----#----#----#----#---
-#--#-#--#-#--#-#--#-#--#-#--#-#--#-#--#-#--#-#--#-#--#-#--#-#--#-#--#-#--#-#--#-#--#-#--#-#--#-#--#
----------------------------------------------------------------------------------------------------
#--#-#--#-#--#-#--#-#--#-#--#-#--#-#--#-#--#-#--#-#--#-#--#-#--#-#--#-#--#-#--#-#--#-#--#-#--#-#--#-
----#----#----#----#----#----#----#----#----#----#----#----#----#----#----#----#----#----#----#----#
-#----#----#----#----#----#----#----#----#----#----#----#----#----#----#----#----#----#----#----#---
-#--#-#--#-#--#-#--#-#--#-#--#-#--#-#--#-#--#-#--#-#--#-#--#-#--#-#--#-#--#-#--#-#--#-#--#-#--#-#--#
----------------------------------------------------------------------------------------------------
#--#-#--#-#--#-#--#-#--#-#--#-#--#-#--#-#--#-#--#-#--#-#--#-#--#-#--#-#--#-#--#-#--#-#--#-#--#-#--#-
----#----#----#----#----#----#----#----#----#----#----#----#----#----#----#----#----#----#----#----#
-#----#----#----#----#----#----#----#----#----#----#----#----#----#----#----#----#----#----#----#---
-#--#-#--#-#--#-#--#-#--#-#--#-#--#-#--#-#--#-#--#-#--#-#--#-#--#-#--#-#--#-#--#-#--#-#--#-#--#E#--#
----------------------------------------------------------------------------------------------------
#--#-#--#-#--#-#--#-#--#-#--#-#--#-#--#-#--#-#--#-#--#-#--#-#--#-#--#-#--#-#--#-#--#-#--#-#--#-#--#-
----#----#----#----#----#----#----#----#----#----#----#----#----#----#----#----#----#----#----#----#
-#----#----#----#----#----#----#----#----#----#----#----#----#----#----#----#----#----#----#----#---
-#--#-#--#-#--#-#--#-#--#-#--#-#--#-#--#-#--#-#--#-#--#-#--#-#--#-#--#-#--#-#--#-#--#-#--#-#--#-#--#
----------------------------------------------------------------------------------------------------
#--#-#--#-#--#-#--#-#--#-#--#-#--#-#--#-#--#-#--#-#--#-#--#-#--#-#--#-#--#-#--#-#--#-#--#-#--#-#--#-
----#----#----#----#----#----#----#----#----#----#----#----#----#----#----#----#----#----#----#----#
-#----#----#----#----#----#----#----#----#----#----#----#----#----#----#----#----#----#----#----#---