?diagonal=OnlyWhenNoObstacles;
---#----#----#----#----#----#----#----#----#----#----#----#----#----#----#----#----#----#----#----#-
----------------------------------------------------------------------------------------------------
-##-#-##-#-##-#-##-#-##-#-##-#-##-#-##-#-##-#-##-#-##-#-##-#-##-#-##-#-##-#-##-#-##-#-##-#-##-#-##-#
#---##---##---##---##---##---##---##---##---##---##---##---##---##---##---##---##---##---##---##---#
-#----#----#----#----#----#----#----#----#----#----#----#----#----#----#----#----#----#----#----#---
---#----#----#----#----#----#----#----#----#----#----#----#----#----#----#----#----#----#----#----#-
----------------------------------------------------------------------------------------------------
-##-#-##-#-##-#-##-#-##-#-##-#-##-#-##-#-##-#-##-#-##-#-##-#-##-#-##-#-##-#-##-#-##-#-##-#-##-#-##-#
#---##---##---##---##---##---##---##---##---##---##---##---##---##---##---##---##---##---##---##---#
-#----#----#----#----#----#----#----#----#----#----#----#----#----#----#----#----#----#----#----#---
---#----#----#----#----#----#----#----#----#----#----#----#----#----#----#----#----#----#----#----#-
----------------------------------------------------------------------------------------------------
-##-#-##-#-##-#-##-#-##-#-##-#-##-#-##-#-##-#-##-#-##-#-##-#-##-#-##-#-##-#-##-#-##-#-##-#-##-#-##-#
#---##---##---##---##---##---##---##---##---##---##---##---##---##---##---##---##---##---##---##---#
-#----#----#----#----#----#----#----#----#----#----#----#----#----#----#----#----#----#----#----#---
---#----#----#----#----#----#----#----#----#----#----#----#----#----#----#----#----#----#----#----#-
----------------------------------------------------------------------------------------------------
-##-#-##-#-##-#-##-#-##-#-##-#-##-#-##-#-##-#-##-#-##-#-##-#-##-#-##-#-##-#-##-#-##-#-##-#-##-#-##-#
#---##---##---##---##---##---##---##---##---##---##---##---##---##---##---##---##---##---##---##---#
-#----#----#----#----#----#----#----#----#----#----#----#----#----#----#----#----#----#----#----#---
---#----#----#----#----#----#----#----#----#----#----#----#----#----#----#----#----#----#----#----#-
----------------------------------------------------------------------------------------------------
-##-#-##-#-##-#-##-#-##-#-##-#-##-#-##-#-##-#-##-#-##-#-##-#-##-#-##-#-##-#-##-#-##-#-##-#-##-#-##-#
#---##---##---##---##---##---##---##---##---##---##---##---##---##---##---##---##---##---##---##---#
-#----#----#----#----#----#----#----#----#----#----#----#----#----#----#----#----#----#----#----#---
---#----#----#----#----#----#----#----#----#----#----#----#----#----#----#----#----#----#----#----#-
----------------------------------------------------------------------------------------------------
-##-#-##-#-##-#-##-#-##-#-##-#-##-#-##-#-##-#-##-#-##-#-##-#-##-#-##-#-##-#-##-#-##-#-##-#-##-#-##-#
#---##---##---##---##---##---##---##---##---##---##---##---##---##---##---##---##---##---##---##---#
-#----#----#----#----#----#----#----#----#----#----#----#----#----#----#----#----#----#----#----#---
---#----#----#----#----#----#----#----#----#----#----#----#----#----#----#----#----#----#----#----#-
----------------------------------------------------------------------------------------------------
-##-#-##-#-##-#-##-#-##-#-##-#-##-#-##-#-##-#-##-#-##-#-##-#-##-#-##-#-##-#-##-#-##-#-##-#-##-#-##-#
#---##---##---##---##---##---##---##---##---##---##---##---##---##---##---##---##---##---##---##---#
-#----#----#----#----#----#----#----#----#----#----#----#----#----#----#----#----#----#----#----#---
---#----#----#----#----#----#----#----#----#----#----#----#----#----#----#----#----#----#----#----#-
--------------------S-------------------------------------------------------------------------------
-##-#-##-#-##-#-##-#-##-#-##-#-##-#-##-#-##-#-##-#-##-#-##-#-##-#-##-#-##-#-##-#-##-#-##-#-##-#-##-#
#---##---##---##---##---##---##---##---##---##---##---##---##---##---##---##---##---##---##---##---#
-#----#----#----#----#----#----#----#----#----#----#----#----#----#----#----#----#----#----#----#---
---#----#----#----#----#----#----#----#----#----#----#----#----#----#----#----#----#----#----#----#-
----------------------------------------------------------------------------------------------------
-##-#-##-#-##-#-##-#-##-#-##-#-##-#-##-#-##-#-##-#-##-#-##-#-##-#-##-#-##-#-##-#-##-#-##-#-##-#-##-#
#---##---##---##---##---##---##---##---##---##---##---##---##---##---##---##---##---##---##---##---#
-#----#----#----#----#----#----#----#----#----#----#----#----#----#----#----#----#----#----#----#---
---#----#----#----#----#----#----#----#----#----#----#----#----#----#----#----#----#----#----#----#-
----------------------------------------------------------------------------------------------------
-##-#-##-#-##-#-##-#-##-#-##-#-##-#-##-#-##-#-##-#-##-#-##-#-##-#-##-#-##-#-##-#-##-#-##-#-##-#-##-#
#---##---##---##---##---##---##---##---##---##---##---##---##---##---##---##---##---##---##---##---#
-#----#----#----#----#----#----#----#----#----#----#----#----#----#----#----#----#----#----#----#---
---#----#----#----#----#----#----#----#----#----#----#----#----#----#----#----#----#----#----#----#-
----------------------------------------------------------------------------------------------------
-##-#-##-#-##-#-##-#-##-#-##-#-##-#-##-#-##-#-##-#-##-#-##-#-##-#-##-#-##-#-##-#-##-#-##-#-##-#-##-#
#---##---##---##---##---##---##---##---##---##---##---##---##---##---##---##---##---##---##---##---#
-#----#----#----#----#----#----#----#----#----#----#----#----#----#----#----#----#----#----#----#---
---#----#----#----#----#----#----#----#----#----#----#----#----#----#----#----#----#----#----#----#-
----------------------------------------------------------------------------------------------------
-##-#-##-#-##-#-##-#-##-#-##-#-##-#-##-#-##-#-##-#-##-#-##-#-##-#-##-#-##-#-##-#-##-#-##-#-##-#-##-#
#---##---##---##---##---##---##---##---##---##---##---##---##---##---##---##---##---##---##---##---#
-#----#----#----#----#----#----#----#----#----#----#----#----#----#----#----#----#----#----#----#---
---#----#----#----#----#----#----#----#----#----#----#----#----#----#----#----#----#----#----#----#-
----------------------------------------------------------------------------------------------------
-##-#-##-#-##-#-##-#-##-#-##-#-##-#-##-#-##-#-##-#-##-#-##-#-##-#-##-#E##-#-##-#-##-#-##-#-##-#-##-#
#---##---##---##---##---##---##---##---##---##---##---##---##---##---##---##---##---##---##---##---#
-#----#----#----#----#----#----#----#----#----#----#----#----#----#----#----#----#----#----#----#---
---#----#----#----#----#----#----#----#----#----#----#----#----#----#----#----#----#----#----#----#-
----------------------------------------------------------------------------------------------------
-##-#-##-#-##-#-##-#-##-#-##-#-##-#-##-#-##-#-##-#-##-#-##-#-##-#-##-#-##-#-##-#-##-#-##-#-##-#-##-#
#---##---##---##---##---##---##---##---##---##---##---##---##---##---##---##---##---##---##---##---#
-#----#----#----#----#----#----#----#----#----#----#----#----#----#----#----#----#----#----#----#---
---#----#----#----#----#----#----#----#----#----#----#----#----#----#----#----#----#----#----#----#-
----------------------------------------------------------------------------------------------------
-##-#-##-#-##-#-##-#-##-#-##-#-##-#-##-#-##-#-##-#-##-#-##-#-##-#-##-#-##-#-##-#-##-#-##-#-##-#-##-#
#---##---##---##---##---##---##---##---##---##---##---##---##---##---##---##---##---##---##---##---#
-#----#----#----#----#----#----#----#----#----#----#----#----#----#----#----#----#----#----#----#---
---#----#----#----#----#----#----#----#----#----#----#----#----#----#----#----#----#----#----#----#-
----------------------------------------------------------------------------------------------------
-##-#-##-#-##-#-##-#-##-#-##-#-##-#-##-#-##-#-##-#-##-#-##-#-##-#-##-#-##-#-##-#-##-#-##-#-##-#-##-#
#---##---##---##---##---##---##---##---##---##---##---##---##---##---##---##---##---##---##---##---#
-#----#----#----#----#----#----#----#----#----#----#----#----#----#----#----#----#----#----#----#---
---#----#----#----#----#----#----#----#----#----#----#----#----#----#----#----#----#----#----#----#-
----------------------------------------------------------------------------------------------------
-##-#-##-#-##-#-##-#-##-#-##-#-##-#-##-#-##-#-##-#-##-#-##-#-##-#-##-#-##-#-##-#-##-#-##-#-##-#-##-#
#---##---##---##---##---##---##---##---##---##---##---##---##---##---##---##---##---##---##---##---#
-#----#----#----#----#----#----#----#----#----#----#----#----#----#----#----#----#----#----#----#---
---#----#----#----#----#----#----#----#----#----#----#----#----#----#----#----#----#----#----#----#-
----------------------------------------------------------------------------------------------------
-##-#-##-#-##-#-##-#-##-#-##-#-##-#-##-#-##-#-##-#-##-#-##-#-##-#-##-#-##-#-##-#-##-#-##-#-##-#-##-#
#---##---##---##---##---##---##---##---##---##---##---##---##---##---##---##---##---##---##---##---#
-#----#----#----#----#----#----#----#----#----#----#----#----#----#----#----#----#----#----#----#---
---#----#----#----#----#----#----#----#----#----#----#----#----#----#----#----#----#----#----#----#-
----------------------------------------------------------------------------------------------------
-##-#-##-#-##-#-##-#-##-#-##-#-##-#-##-#-##-#-##-#-##-#-##-#-##-#-##-#-##-#-##-#-##-#-##-#-##-#-##-#
#---##---##---##---##---##---##---##---##---##---##---##---##---##---##---##---##---##---##---##---#
-#----#----#----#----#----#----#----#----#----#----#----#----#----#----#----#----#----#----#----#---
---#----#----#----#----#----#----#----#----#----#----#----#----#----#----#----#----#----#----#----#-
----------------------------------------------------------------------------------------------------
-##-#-##-#-##-#-##-#-##-#-##-#-##-#-##-#-##-#-##-#-##-#-##-#-##-#-##-#-##-#-##-#-##-#-##-#-##-#-##-#
#---##---##---##---##---##---##---##---##---##---##---##---##---##---##---##---##---##---##---##---#
-#----#----#----#----#----#----#----#----#----#----#----#----#----#----#----#----#----#----#----#---