?diagonal=OnlyWhenNoObstacles;
----#----#----#----#----#----#----#----#----#----#----#----#----#----#----#----#----#----#----#----#
-#-#--#-#--#-#--#-#--#-#--#-#--#-#--#-#--#-#--#-#--#-#--#-#--#-#--#-#--#-#--#-#--#-#--#-#--#-#--#-#-
#----#----#----#----#----#----#----#----#----#----#----#----#----#----#----#----#----#----#----#----
-#----#----#----#----#----#----#----#----#----#----#----#----#----#----#----#----#----#----#----#---
-#--#-#--#-#--#-#--#-#--#-#--#-#--#-#--#-#--#-#--#-#--#-#--#-#--#-#--#-#--#-#--#-#--#-#--#-#--#-#--#
----#----#----#----#----#----#----#----#----#----#----#----#----#----#----#----#----#----#----#----#
-#-#--#-#--#-#--#-#--#-#--#-#--#-#--#-#--#-#--#-#--#-#--#-#--#-#--#-#--#-#--#-#--#-#--#-#--#-#--#-#-
#----#----#----#----#----#----#----#----#----#----#----#----#----#----#----#----#----#----#----#----
-#----#----#----#----#----#----#----#----#----#----#----#----#----#----#----#----#----#----#----#---
-#--#-#--#-#--#-#--#-#--#-#--#-#--#-#--#-#--#-#--#-#--#-#--#-#--#-#--#-#--#-#--#-#--#-#--#-#--#-#--#
----#----#----#----#----#----#----#----#----#----#----#----#----#----#----#----#----#----#----#----#
-#-#--#-#--#-#--#-#--#-#--#-#--#-#--#-#--#-#--#-#--#-#--#-#--#-#--#-#--#-#--#-#--#-#--#-#--#-#--#-#-
#----#----#----#----#----#----#----#----#----#----#----#----#----#----#----#----#----#----#----#----
-#----#----#----#----#----#----#----#----#----#----#----#----#----#----#----#----#----#----#----#---
-#--#-#--#-#--#-#--#-#--#-#--#-#--#-#--#-#--#-#--#-#--#-#--#-#--#-#--#-#--#-#--#-#--#-#--#-#--#-#--#
----#----#----#----#----#----#----#----#----#----#----#----#----#----#----#----#----#----#----#----#
-#-#--#-#--#-#--#-#--#-#--#-#--#-#--#-#--#-#--#-#--#-#--#-#--#-#--#-#--#-#--#-#--#-#--#-#--#-#--#-#-
#----#----#----#----#----#----#----#----#----#----#----#----#----#----#----#----#----#----#----#----
-#----#----#----#----#----#----#----#----#----#----#----#----#----#----#----#----#----#----#----#---
-#--#-#--#-#--#-#--#-#--#-#--#-#--#-#--#-#--#-#--#-#--#-#--#-#--#-#--#-#--#-#--#-#--#-#--#-#--#-#--#
----#----#----#----#----#----#----#----#----#----#----#----#----#----#----#----#----#----#----#----#
-#-#--#-#--#-#--#-#--#-#--#-#--#-#--#-#--#-#--#-#--#-#--#-#--#-#--#-#--#-#--#-#--#-#--#-#--#-#--#-#-
#----#----#----#----#----#----#----#----#----#----#----#----#----#----#----#----#----#----#----#----
-#----#----#----#----#----#----#----#----#----#----#----#----#----#----#----#----#----#----#----#---
-#--#-#--#-#--#-#--#-#--#-#--#-#--#-#--#-#--#-#--#-#--#-#--#-#--#-#--#-#--#-#--#-#--#-#--#-#--#-#--#
----#----#----#----#----#----#----#----#----#----#----#----#----#----#----#----#----#----#----#----#
-#-#--#-#--#-#--#-#--#-#--#-#--#-#--#-#--#-#--#-#--#-#--#-#--#-#--#-#--#-#--#-#--#-#--#-#--#-#--#-#-
#----#----#----#----#----#----#----#----#----#----#----#----#----#----#----#----#----#----#----#----
-#----#----#----#----#----#----#----#----#----#----#----#----#----#----#----#----#----#----#----#---
-#--#-#--#-#--#-#--#-#--#-#--#-#--#-#--#-#--#-#--#-#--#-#--#-#--#-#--#-#--#-#--#-#--#-#--#-#--#-#--#
----#----#----#----#----#----#----#----#----#----#----#----#----#----#----#----#----#----#----#----#
-#-#--#-#--#-#--#-#--#-#--#-#--#-#--#-#--#-#--#-#--#-#--#-#--#-#--#-#--#-#--#-#--#-#--#-#--#-#--#-#-
#----#----#----#----#----#----#----#----#----#----#----#----#----#----#----#----#----#----#----#----
-#----#----#----#----#----#----#----#----#----#----#----#----#----#----#----#----#----#----#----#---
-#--#-#--#-#--#-#--#-#--#-#--#-#--#-#--#-#--#-#--#-#--#-#--#-#--#-#--#-#--#-#--#-#--#-#--#-#--#-#--#
----#----#----#----#----#----#----#----#----#----#----#----#----#----#----#----#----#----#----#----#
-#-#--#-#--#-#--#-#--#-#--#-#--#-#--#-#--#-#--#-#--#-#--#-#--#-#--#-#--#-#--#-#--#-#--#-#--#-#--#-#-
#----#----#----#----#----#----#----#----#----#----#----#----#----#----#----#----#----#----#----#----
-#----#----#----#----#----#----#----#----#----#----#----#----#----#----#----#----#----#----#----#---
-#--#-#--#-#--#-#--#-#--#-#--#-#--#-#--#-#--#-#--#-#--#-#--#-#--#-#--#-#--#-#--#-#--#-#--#-#--#-#--#
----#----#----#----#----#----#----#----#----#----#----#----#----#----#----#----#----#----#----#----#
-#-#--#-#--#-#--#-#--#-#--#-#--#-#--#-#--#-#--#-#--#-#--#-#--#-#--#-#--#-#--#-#--#-#--#-#--#-#--#-#-
#----#----#----#----#----#----#----#----#----#----#----#----#----#----#----#----#----#----#----#----
-#----#----#----#----#----#----#----#----#----#----#----#----#----#----#----#----#----#----#----#---
-#--#-#--#-#--#-#--#-#--#-#--#-#--#-#--#-#--#-#--#-#--#-#--#-#--#-#--#-#--#-#--#-#--#-#--#-#--#-#--#
----#----#----#----#----#----#----#----#----#----#----#----#----#----#----#----#----#----#----#----#
-#-#--#-#--#-#--#-#--#-#--#-#--#-#--#-#--#-#--#-#--#-#--#-#--#-#--#-#--#-#--#-#--#-#--#-#--#-#--#-#-
#----#----#----#----#----#----#----#----#----#----#----#----#----#----#----#----#----#----#----#----
-#----#----#----#----#----#----#----#----#----#----#----#----#----#----#----#----#----#----#----#---
-#--#-#--#-#--#-#--#-#--#-#--#-#--#-#--#-#--#-#--#-#--#-#--#-#--#-#--#-#--#-#--#-#--#-#--#-#--#-#--#
----#----#----#----#----#----#----#----#----#----#----#--S-#----#----#----#----#----#----#----#----#
-#-#--#-#--#-#--#-#--#-#--#-#--#-#--#-#--#-#--#-#--#-#--#-#--#-#--#-#--#-#--#-#--#-#--#-#--#-#--#-#-
#----#----#----#----#----#----#----#----#----#----#----#----#----#----#----#----#----#----#----#----
-#----#----#----#----#----#----#----#----#----#----#----#----#----#----#----#----#----#----#----#---
-#--#-#--#-#--#-#--#-#--#-#--#-#--#-#--#-#--#-#--#-#--#-#--#-#--#-#--#-#--#-#--#-#--#-#--#-#--#-#--#
----#----#----#----#----#----#----#----#----#----#----#----#----#----#----#----#----#----#----#----#
-#-#--#-#--#-#--#-#--#-#--#-#--#-#--#-#--#-#--#-#--#-#--#-#--#-#--#-#--#-#--#-#--#-#--#-#--#-#--#-#-
#----#----#----#----#----#----#----#----#----#----#----#----#----#----#----#----#----#----#----#----
-#----#----#----#----#----#----#----#----#----#----#----#----#----#----#----#----#----#----#----#---
-#--#-#--#-#--#-#--#-#--#-#--#-#--#-#--#-#--#-#--#-#--#-#--#-#--#-#--#-#--#-#--#-#--#-#--#-#--#-#--#
----#----#----#----#----#----#----#----#----#----#----#----#----#----#----#----#----#----#----#----#
-#-#--#-#--#-#--#-#--#-#--#-#--#-#--#-#--#-#--#-#--#-#--#-#--#-#--#-#--#-#--#-#--#-#--#-#--#-#--#-#-
#----#----#----#----#----#----#----#----#----#----#----#----#----#----#----#----#----#----#----#----
-#----#----#----#----#----#----#----#----#----#----#----#----#----#----#----#----#----#----#E---#---
-#--#-#--#-#--#-#--#-#--#-#--#-#--#-#--#-#--#-#--#-#--#-#--#-#--#-#--#-#--#-#--#-#--#-#--#-#--#-#--#
----#----#----#----#----#----#----#----#----#----#----#----#----#----#----#----#----#----#----#----#
-#-#--#-#--#-#--#-#--#-#--#-#--#-#--#-#--#-#--#-#--#-#--#-#--#-#--#-#--#-#--#-#--#-#--#-#--#-#--#-#-
#----#----#----#----#----#----#----#----#----#----#----#----#----#----#----#----#----#----#----#----
-#----#----#----#----#----#----#----#----#----#----#----#----#----#----#----#----#----#----#----#---
-#--#-#--#-#--#-#--#-#--#-#--#-#--#-#--#-#--#-#--#-#--#-#--#-#--#-#--#-#--#-#--#-#--#-#--#-#--#-#--#
----#----#----#----#----#----#----#----#----#----#----#----#----#----#----#----#----#----#----#----#
-#-#--#-#--#-#--#-#--#-#--#-#--#-#--#-#--#-#--#-#--#-#--#-#--#-#--#-#--#-#--#-#--#-#--#-#--#-#--#-#-
#----#----#----#----#----#----#----#----#----#----#----#----#----#----#----#----#----#----#----#----
-#----#----#----#----#----#----#----#----#----#----#----#----#----#----#----#----#----#----#----#---
-#--#-#--#-#--#-#--#-#--#-#--#-#--#-#--#-#--#-#--#-#--#-#--#-#--#-#--#-#--#-#--#-#--#-#--#-#--#-#--#
----#----#----#----#----#----#----#----#----#----#----#----#----#----#----#----#----#----#----#----#
-#-#--#-#--#-#--#-#--#-#--#-#--#-#--#-#--#-#--#-#--#-#--#-#--#-#--#-#--#-#--#-#--#-#--#-#--#-#--#-#-
#----#----#----#----#----#----#----#----#----#----#----#----#----#----#----#----#----#----#----#----
-#----#----#----#----#----#----#----#----#----#----#----#----#----#----#----#----#----#----#----#---
-#--#-#--#-#--#-#--#-#--#-#--#-#--#-#--#-#--#-#--#-#--#-#--#-#--#-#--#-#--#-#--#-#--#-#--#-#--#-#--#
----#----#----#----#----#----#----#----#----#----#----#----#----#----#----#----#----#----#----#----#
-#-#--#-#--#-#--#-#--#-#--#-#--#-#--#-#--#-#--#-#--#-#--#-#--#-#--#-#--#-#--#-#--#-#--#-#--#-#--#-#-
#----#----#----#----#----#----#----#----#----#----#----#----#----#----#----#----#----#----#----#----
-#----#----#----#----#----#----#----#----#----#----#----#----#----#----#----#----#----#----#----#---
-#--#-#--#-#--#-#--#-#--#-#--#-#--#-#--#-#--#-#--#-#--#-#--#-#--#-#--#-#--#-#--#-#--#-#--#-#--#-#--#
----#----#----#----#----#----#----#----#----#----#----#----#----#----#----#----#----#----#----#----#
-#-#--#-#--#-#--#-#--#-#--#-#--#-#--#-#--#-#--#-#--#-#--#-#--#-#--#-#--#-#--#-#--#-#--#-#--#-#--#-#-
#----#----#----#----#----#----#----#----#----#----#----#----#----#----#----#----#----#----#----#----
-#----#----#----#----#----#----#----#----#----#----#----#----#----#----#----#----#----#----#----#---
-#--#-#--#-#--#-#--#-#--#-#--#-#--#-#--#-#--#-#--#-#--#-#--#-#--#-#--#-#--#-#--#-#--#-#--#-#--#-#--#
----#----#----#----#----#----#----#----#----#----#----#----#----#----#----#----#----#----#----#----#
-#-#--#-#--#-#--#-#--#-#--#-#--#-#--#-#--#-#--#-#--#-#--#-#--#-#--#-#--#-#--#-#--#-#--#-#--#-#--#-#-
#----#----#----#----#----#----#----#----#----#----#----#----#----#----#----#----#----#----#----#----
-#----#----#----#----#----#----#----#----#----#----#----#----#----#----#----#----#----#----#----#---
-#--#-#--#-#--#-#--#-#--#-#--#-#--#-#--#-#--#-#--#-#--#-#--#-#--#-#--#-#--#-#--#-#--#-#--#-#--#-#--#
----#----#----#----#----#----#----#----#----#----#----#----#----#----#----#----#----#----#----#----#
-#-#--#-#--#-#--#-#--#-#--#-#--#-#--#-#--#-#--#-#--#-#--#-#--#-#--#-#--#-#--#-#--#-#--#-#--#-#--#-#-
#----#----#----#----#----#----#----#----#----#----#----#----#----#----#----#----#----#----#----#----
-#----#----#----#----#----#----#----#----#----#----#----#----#----#----#----#----#----#----#----#---
-#--#-#--#-#--#-#--#-#--#-#--#-#--#-#--#-#--#-#--#-#--#-#--#-#--#-#--#-#--#-#--#-#--#-#--#-#--#-#--#