?diagonal=OnlyWhenNoObstacles;
---#----#----#----#----#----#----#----#----#----#----#----#----#----#----#----#----#----#----#----#-
#----#----#----#----#----#----#----#----#----#----#----#----#----#----#----#----#----#----#----#----
#-#-##-#-##-#-##-#-##-#-##-#-##-#-##-#-##-#-##-#-##-#-##-#-##-#-##-#-##-#-##-#-##-#-##-#-##-#-##-#-#
#----#----#----#----#----#----#----#----#----#----#----#----#----#----#----#----#----#----#----#----
--#----#----#----#----#----#----#----#----#----#----#----#----#----#----#----#----#----#----#----#--
---#----#----#----#----#----#----#----#----#----#----#----#----#----#----#----#----#----#----#----#-
#----#----#----#----#----#----#----#----#----#----#----#----#----#----#----#----#----#----#----#----
#-#-##-#-##-#-##-#-##-#-##-#-##-#-##-#-##-#-##-#-##-#-##-#-##-#-##-#-##-#-##-#-##-#-##-#-##-#-##-#-#
#----#----#----#----#----#----#----#----#----#----#----#----#----#S---#----#----#----#----#----#----
--#----#----#----#----#----#----#----#----#----#----#----#----#----#----#----#----#----#----#----#--
---#----#----#----#----#----#----#----#----#----#----#----#----#----#----#----#----#----#----#----#-
#----#----#----#----#----#----#----#----#----#----#----#----#----#----#----#----#----#----#----#----
#-#-##-#-##-#-##-#-##-#-##-#-##-#-##-#-##-#-##-#-##-#-##-#-##-#-##-#-##-#-##-#-##-#-##-#-##-#-##-#-#
#----#----#----#----#----#----#----#----#----#----#----#----#----#----#----#----#----#----#----#----
--#----#----#----#----#----#----#----#----#----#----#----#----#----#----#----#----#----#----#----#--
---#----#----#----#----#----#----#----#----#----#----#----#----#----#----#----#----#----#----#----#-
#----#----#----#----#----#----#----#----#----#----#----#----#----#----#----#----#----#----#----#----
#-#-##-#-##-#-##-#-##-#-##-#-##-#-##-#-##-#-##-#-##-#-##-#-##-#-##-#-##-#-##-#-##-#-##-#-##-#-##-#-#
#----#----#----#----#----#----#----#----#----#----#----#----#----#----#----#----#----#----#----#----
--#----#----#----#----#----#----#----#----#----#----#----#----#----#----#----#----#----#----#----#--
---#----#----#----#----#----#----#----#----#----#----#----#----#----#----#----#----#----#----#----#-
#----#----#----#----#----#----#----#----#----#----#----#----#----#----#----#----#----#----#----#----
#-#-##-#-##-#-##-#-##-#-##-#-##-#-##-#-##-#-##-#-##-#-##-#-##-#-##-#-##-#-##-#-##-#-##-#-##-#-##-#-#
#----#----#----#----#----#----#----#----#----#----#----#----#----#----#----#----#----#----#----#----
--#----#----#----#----#----#----#----#----#----#----#----#----#----#----#----#----#----#----#----#--
---#----#----#----#----#----#----#----#----#----#----#----#----#----#----#----#----#----#----#----#-
#----#----#----#----#----#----#----#----#----#----#----#----#----#----#----#----#----#----#----#----
#-#-##-#-##-#-##-#-##-#-##-#-##-#-##-#-##-#-##-#-##-#-##-#-##-#-##-#-##-#-##-#-##-#-##-#-##-#-##-#-#
#----#----#----#----#----#----#----#----#----#----#----#----#----#----#----#----#----#----#----#----
--#----#----#----#----#----#----#----#----#----#----#----#----#----#----#----#----#----#----#----#--
---#----#----#----#----#----#----#----#----#----#----#----#----#----#----#----#----#----#----#----#-
#----#----#----#----#----#----#----#----#----#----#----#----#----#----#----#----#----#----#----#----
#-#-##-#-##-#-##-#-##-#-##-#-##-#-##-#-##-#-##-#-##-#-##-#-##-#-##-#-##-#-##-#-##-#-##-#-##-#-##-#-#
#----#----#----#----#----#----#----#----#----#----#----#----#----#----#----#----#----#----#----#----
--#----#----#----#----#----#----#----#----#----#----#----#----#----#----#----#----#----#----#----#--
---#----#----#----#----#----#----#----#----#----#----#----#----#----#----#----#----#----#----#----#-
#----#----#----#----#----#----#----#----#----#----#----#----#----#----#----#----#----#----#----#----
#-#-##-#-##-#-##-#-##-#-##-#-##-#-##-#-##-#-##-#-##-#-##-#-##-#-##-#-##-#-##-#-##-#-##-#-##-#-##-#-#
#----#----#----#----#----#----#----#----#----#----#----#----#----#----#----#----#----#----#----#----
--#----#----#----#----#----#----#----#----#----#----#----#----#----#----#----#----#----#----#----#--
---#----#----#----#----#----#----#----#----#----#----#----#----#----#----#----#----#----#----#----#-
#----#----#----#----#----#----#----#----#----#----#----#----#----#----#----#----#----#----#----#----
#-#-##-#-##-#-##-#-##-#-##-#-##-#-##-#-##-#-##-#-##-#-##-#-##-#-##-#-##-#-##-#-##-#-##-#-##-#-##-#-#
#----#----#----#----#----#----#----#----#----#----#----#----#----#----#----#----#----#----#----#----
--#----#----#----#----#----#----#----#----#----#----#----#----#----#----#----#----#----#----#----#--
---#----#----#----#----#----#----#----#----#----#----#----#----#----#----#----#----#----#----#----#-
#----#----#----#----#----#----#----#----#----#----#----#----#----#----#----#----#----#----#----#----
#-#-##-#-##-#-##-#-##-#-##-#-##-#-##-#-##-#-##-#-##-#-##-#-##-#-##-#-##-#-##-#-##-#-##-#-##-#-##-#-#
#----#----#----#----#----#----#----#----#----#----#----#----#----#----#----#----#----#----#----#----
--#----#----#----#----#----#----#----#----#----#----#----#----#----#----#----#----#----#----#----#--
---#----#----#----#----#----#----#----#----#----#----#----#----#----#----#----#----#----#----#----#-
#----#----#----#----#----#----#----#----#----#----#----#----#----#----#----#----#----#----#----#----
#-#-##-#-##-#-##-#-##-#-##-#-##-#-##-#-##-#-##-#-##-#-##-#-##-#-##-#-##-#-##-#-##-#-##-#-##-#-##-#-#
#----#----#----#----#----#----#----#----#----#----#----#----#----#----#----#----#----#----#----#----
--#----#----#----#----#----#----#----#----#----#----#----#----#----#----#----#----#----#----#----#--
---#----#----#----#----#----#----#----#----#----#----#----#----#----#----#----#----#----#----#----#-
#----#----#----#----#----#----#----#----#----#----#----#----#----#----#----#----#----#----#----#----
#-#-##-#-##-#-##-#-##-#-##-#-##-#-##-#-##-#-##-#-##-#-##-#-##-#-##-#-##-#-##-#-##-#-##-#-##-#-##-#-#
#----#----#----#----#----#----#----#----#----#----#----#----#----#----#----#----#----#----#----#----
--#----#----#----#----#----#----#----#----#----#----#----#----#----#----#----#----#----#----#----#--
---#----#----#----#----#----#----#----#----#----#----#----#----#----#----#----#----#----#----#----#-
#----#----#----#----#----#----#----#----#----#----#----#----#----#----#----#----#----#----#----#----
#-#-##-#-##-#-##-#-##-#-##-#-##-#-##-#-##-#-##-#-##-#-##-#-##-#-##-#-##-#-##-#-##-#-##-#-##-#-##-#-#
#----#----#----#----#----#----#----#----#----#----#----#----#----#----#----#----#----#----#----#----
--#----#----#----#----#----#----#----#----#----#----#----#----#----#----#----#----#----#----#----#--
---#----#----#----#----#----#----#----#----#----#----#----#----#----#----#----#----#----#----#----#-
#----#----#----#----#----#----#----#----#----#----#----#----#----#----#----#----#----#----#----#----
#-#-##-#-##-#-##-#-##-#-##-#-##-#-##-#-##-#-##-#-##-#-##-#-##-#-##-#-##-#-##-#-##-#-##-#-##-#-##-#-#
#----#----#----#----#----#----#----#----#----#----#----#----#----#----#----#----#----#----#----#----
--#----#----#----#----#----#----#----#----#----#----#----#----#----#----#----#----#----#----#----#--
---#----#----#----#----#----#----#----#----#----#----#----#----#----#----#----#----#----#----#----#-
#----#----#----#----#----#----#----#----#----#----#----#----#----#----#----#----#----#----#----#----
#-#-##-#-##-#-##-#-##-#-##-#-##-#-##-#-##-#-##-#-##-#-##-#-##-#-##-#-##-#-##-#-##-#-##-#-##-#-##-#-#
#----#----#----#----#----#----#----#----#----#----#----#----#----#----#----#----#----#----#----#----
--#----#----#----#----#----#-E--#----#----#----#----#----#----#----#----#----#----#----#----#----#--
---#----#----#----#----#----#----#----#----#----#----#----#----#----#----#----#----#----#----#----#-
#----#----#----#----#----#----#----#----#----#----#----#----#----#----#----#----#----#----#----#----
#-#-##-#-##-#-##-#-##-#-##-#-##-#-##-#-##-#-##-#-##-#-##-#-##-#-##-#-##-#-##-#-##-#-##-#-##-#-##-#-#
#----#----#----#----#----#----#----#----#----#----#----#----#----#----#----#----#----#----#----#----
--#----#----#----#----#----#----#----#----#----#----#----#----#----#----#----#----#----#----#----#--
---#----#----#----#----#----#----#----#----#----#----#----#----#----#----#----#----#----#----#----#-
#----#----#----#----#----#----#----#----#----#----#----#----#----#----#----#----#----#----#----#----
#-#-##-#-##-#-##-#-##-#-##-#-##-#-##-#-##-#-##-#-##-#-##-#-##-#-##-#-##-#-##-#-##-#-##-#-##-#-##-#-#
#----#----#----#----#----#----#----#----#----#----#----#----#----#----#----#----#----#----#----#----
--#----#----#----#----#----#----#----#----#----#----#----#----#----#----#----#----#----#----#----#--
---#----#----#----#----#----#----#----#----#----#----#----#----#----#----#----#----#----#----#----#-
#----#----#----#----#----#----#----#----#----#----#----#----#----#----#----#----#----#----#----#----
#-#-##-#-##-#-##-#-##-#-##-#-##-#-##-#-##-#-##-#-##-#-##-#-##-#-##-#-##-#-##-#-##-#-##-#-##-#-##-#-#
#----#----#----#----#----#----#----#----#----#----#----#----#----#----#----#----#----#----#----#----
--#----#----#----#----#----#----#----#----#----#----#----#----#----#----#----#----#----#----#----#--
---#----#----#----#----#----#----#----#----#----#----#----#----#----#----#----#----#----#----#----#-
#----#----#----#----#----#----#----#----#----#----#----#----#----#----#----#----#----#----#----#----
#-#-##-#-##-#-##-#-##-#-##-#-##-#-##-#-##-#-##-#-##-#-##-#-##-#-##-#-##-#-##-#-##-#-##-#-##-#-##-#-#
#----#----#----#----#----#----#----#----#----#----#----#----#----#----#----#----#----#----#----#----
--#----#----#----#----#----#----#----#----#----#----#----#----#----#----#----#----#----#----#----#--
---#----#----#----#----#----#----#----#----#----#----#----#----#----#----#----#----#----#----#----#-
#----#----#----#----#----#----#----#----#----#----#----#----#----#----#----#----#----#----#----#----
#-#-##-#-##-#-##-#-##-#-##-#-##-#-##-#-##-#-##-#-##-#-##-#-##-#-##-#-##-#-##-#-##-#-##-#-##-#-##-#-#
#----#----#----#----#----#----#----#----#----#----#----#----#----#----#----#----#----#----#----#----
--#----#----#----#----#----#----#----#----#----#----#----#----#----#----#----#----#----#----#----#--