?diagonal=OnlyWhenNoObstacles;
#--#-#--#-#--#-#--#-#--#-#--#-#--#-#--#-#--#-#--#-#--#-#--#-#--#-#--#-#--#-#--#-#--#-#--#-#--#-#--#-
--------------------------------------------------------------------------------------------------E-
----------------------------------------------------------------------------------------------------
-##---##---##---##---##---##---##---##---##---##---##---##---##---##---##---##---##---##---##---##--
#----#----#----#----#----#----#----#----#----#----#----#----#----#----#----#----#----#----#----#----
#--#-#--#-#--#-#--#-#--#-#--#-#--#-#--#-#--#-#--#-#--#-#--#-#--#-#--#-#--#-#--#-#--#-#--#-#--#-#--#-
----------------------------------------------------------------------------------------------------
----------------------------------------------------------------------------------------------------
-##---##---##---##---##---##---##---##---##---##---##---##---##---##---##---##---##---##---##---##--
#----#----#----#----#----#----#----#----#----#----#----#----#----#----#----#----#----#----#----#----
#--#-#--#-#--#-#--#-#--#-#--#-#--#-#--#-#--#-#--#-#--#-#--#-#--#-#--#-#--#-#--#-#--#-#--#-#--#-#--#-
----------------------------------------------------------------------------------------------------
----------------------------------------------------------------------------------------------------
-##---##---##---##---##---##---##---##---##---##---##---##---##---##---##---##---##---##---##---##--
#----#----#----#----#----#----#----#----#----#----#----#----#----#----#----#----#----#----#----#----
#--#-#--#-#--#-#--#-#--#-#--#-#--#-#--#-#--#-#--#-#--#-#--#-#--#-#--#-#--#-#--#-#--#-#--#-#--#-#--#-
---------------------------------------------------------S------------------------------------------
----------------------------------------------------------------------------------------------------
-##---##---##---##---##---##---##---##---##---##---##---##---##---##---##---##---##---##---##---##--
#----#----#----#----#----#----#----#----#----#----#----#----#----#----#----#----#----#----#----#----
#--#-#--#-#--#-#--#-#--#-#--#-#--#-#--#-#--#-#--#-#--#-#--#-#--#-#--#-#--#-#--#-#--#-#--#-#--#-#--#-
----------------------------------------------------------------------------------------------------
----------------------------------------------------------------------------------------------------
-##---##---##---##---##---##---##---##---##---##---##---##---##---##---##---##---##---##---##---##--
#----#----#----#----#----#----#----#----#----#----#----#----#----#----#----#----#----#----#----#----
#--#-#--#-#--#-#--#-#--#-#--#-#--#-#--#-#--#-#--#-#--#-#--#-#--#-#--#-#--#-#--#-#--#-#--#-#--#-#--#-
----------------------------------------------------------------------------------------------------
----------------------------------------------------------------------------------------------------
-##---##---##---##---##---##---##---##---##---##---##---##---##---##---##---##---##---##---##---##--
#----#----#----#----#----#----#----#----#----#----#----#----#----#----#----#----#----#----#----#----
#--#-#--#-#--#-#--#-#--#-#--#-#--#-#--#-#--#-#--#-#--#-#--#-#--#-#--#-#--#-#--#-#--#-#--#-#--#-#--#-
----------------------------------------------------------------------------------------------------
----------------------------------------------------------------------------------------------------
-##---##---##---##---##---##---##---##---##---##---##---##---##---##---##---##---##---##---##---##--
#----#----#----#----#----#----#----#----#----#----#----#----#----#----#----#----#----#----#----#----
#--#-#--#-#--#-#--#-#--#-#--#-#--#-#--#-#--#-#--#-#--#-#--#-#--#-#--#-#--#-#--#-#--#-#--#-#--#-#--#-
----------------------------------------------------------------------------------------------------
----------------------------------------------------------------------------------------------------
-##---##---##---##---##---##---##---##---##---##---##---##---##---##---##---##---##---##---##---##--
#----#----#----#----#----#----#----#----#----#----#----#----#----#----#----#----#----#----#----#----
#--#-#--#-#--#-#--#-#--#-#--#-#--#-#--#-#--#-#--#-#--#-#--#-#--#-#--#-#--#-#--#-#--#-#--#-#--#-#--#-
----------------------------------------------------------------------------------------------------
----------------------------------------------------------------------------------------------------
-##---##---##---##---##---##---##---##---##---##---##---##---##---##---##---##---##---##---##---##--
#----#----#----#----#----#----#----#----#----#----#----#----#----#----#----#----#----#----#----#----
#--#-#--#-#--#-#--#-#--#-#--#-#--#-#--#-#--#-#--#-#--#-#--#-#--#-#--#-#--#-#--#-#--#-#--#-#--#-#--#-
----------------------------------------------------------------------------------------------------
----------------------------------------------------------------------------------------------------
-##---##---##---##---##---##---##---##---##---##---##---##---##---##---##---##---##---##---##---##--
#----#----#----#----#----#----#----#----#----#----#----#----#----#----#----#----#----#----#----#----
#--#-#--#-#--#-#--#-#--#-#--#-#--#-#--#-#--#-#--#-#--#-#--#-#--#-#--#-#--#-#--#-#--#-#--#-#--#-#--#-
----------------------------------------------------------------------------------------------------
----------------------------------------------------------------------------------------------------
-##---##---##---##---##---##---##---##---##---##---##---##---##---##---##---##---##---##---##---##--
#----#----#----#----#----#----#----#----#----#----#----#----#----#----#----#----#----#----#----#----
#--#-#--#-#--#-#--#-#--#-#--#-#--#-#--#-#--#-#--#-#--#-#--#-#--#-#--#-#--#-#--#-#--#-#--#-#--#-#--#-
----------------------------------------------------------------------------------------------------
----------------------------------------------------------------------------------------------------
-##---##---##---##---##---##---##---##---##---##---##---##---##---##---##---##---##---##---##---##--
#----#----#----#----#----#----#----#----#----#----#----#----#----#----#----#----#----#----#----#----
#--#-#--#-#--#-#--#-#--#-#--#-#--#-#--#-#--#-#--#-#--#-#--#-#--#-#--#-#--#-#--#-#--#-#--#-#--#-#--#-
----------------------------------------------------------------------------------------------------
----------------------------------------------------------------------------------------------------
-##---##---##---##---##---##---##---##---##---##---##---##---##---##---##---##---##---##---##---##--
#----#----#----#----#----#----#----#----#----#----#----#----#----#----#----#----#----#----#----#----
#--#-#--#-#--#-#--#-#--#-#--#-#--#-#--#-#--#-#--#-#--#-#--#-#--#-#--#-#--#-#--#-#--#-#--#-#--#-#--#-
----------------------------------------------------------------------------------------------------
----------------------------------------------------------------------------------------------------
-##---##---##---##---##---##---##---##---##---##---##---##---##---##---##---##---##---##---##---##--
#----#----#----#----#----#----#----#----#----#----#----#----#----#----#----#----#----#----#----#----
#--#-#--#-#--#-#--#-#--#-#--#-#--#-#--#-#--#-#--#-#--#-#--#-#--#-#--#-#--#-#--#-#--#-#--#-#--#-#--#-
----------------------------------------------------------------------------------------------------
----------------------------------------------------------------------------------------------------
-##---##---##---##---##---##---##---##---##---##---##---##---##---##---##---##---##---##---##---##--
#----#----#----#----#----#----#----#----#----#----#----#----#----#----#----#----#----#----#----#----
#--#-#--#-#--#-#--#-#--#-#--#-#--#-#--#-#--#-#--#-#--#-#--#-#--#-#--#-#--#-#--#-#--#-#--#-#--#-#--#-
----------------------------------------------------------------------------------------------------
----------------------------------------------------------------------------------------------------
-##---##---##---##---##---##---##---##---##---##---##---##---##---##---##---##---##---##---##---##--
#----#----#----#----#----#----#----#----#----#----#----#----#----#----#----#----#----#----#----#----
#--#-#--#-#--#-#--#-#--#-#--#-#--#-#--#-#--#-#--#-#--#-#--#-#--#-#--#-#--#-#--#-#--#-#--#-#--#-#--#-
----------------------------------------------------------------------------------------------------
----------------------------------------------------------------------------------------------------
-##---##---##---##---##---##---##---##---##---##---##---##---##---##---##---##---##---##---##---##--
#----#----#----#----#----#----#----#----#----#----#----#----#----#----#----#----#----#----#----#----
#--#-#--#-#--#-#--#-#--#-#--#-#--#-#--#-#--#-#--#-#--#-#--#-#--#-#--#-#--#-#--#-#--#-#--#-#--#-#--#-
----------------------------------------------------------------------------------------------------
----------------------------------------------------------------------------------------------------
-##---##---##---##---##---##---##---##---##---##---##---##---##---##---##---##---##---##---##---##--
#----#----#----#----#----#----#----#----#----#----#----#----#----#----#----#----#----#----#----#----
#--#-#--#-#--#-#--#-#--#-#--#-#--#-#--#-#--#-#--#-#--#-#--#-#--#-#--#-#--#-#--#-#--#-#--#-#--#-#--#-
----------------------------------------------------------------------------------------------------
----------------------------------------------------------------------------------------------------
-##---##---##---##---##---##---##---##---##---##---##---##---##---##---##---##---##---##---##---##--
#----#----#----#----#----#----#----#----#----#----#----#----#----#----#----#----#----#----#----#----
#--#-#--#-#--#-#--#-#--#-#--#-#--#-#--#-#--#-#--#-#--#-#--#-#--#-#--#-#--#-#--#-#--#-#--#-#--#-#--#-
----------------------------------------------------------------------------------------------------
----------------------------------------------------------------------------------------------------
-##---##---##---##---##---##---##---##---##---##---##---##---##---##---##---##---##---##---##---##--
#----#----#----#----#----#----#----#----#----#----#----#----#----#----#----#----#----#----#----#----