?diagonal=OnlyWhenNoObstacles;
---#----#----#----#----#----#----#----#----#----#----#----#----#----#----#----#----#----#----#----#-
#---##---##---##---##---##---##---##---##---##---##---##---##---##---##---##---##---##---##---##---#
-------------------------------------------------------------------------E--------------------------
---#----#----#----#----#----#----#----#----#----#----#----#----#----#----#----#----#----#----#----#-
--#-#--#-#--#-#--#-#--#-#--#-#--#-#--#-#--#-#--#-#--#-#--#-#--#-#--#-#--#-#--#-#--#-#--#-#--#-#--#-#
---#----#----#----#----#----#----#----#----#----#----#----#----#----#----#----#----#----#----#----#-
#---##---##---##---##---##---##---##---##---##---##---##---##---##---##---##---##---##---##---##---#
----------------------------------------------------------------------------------------------------
---#----#----#----#----#----#----#----#----#----#----#----#----#----#----#----#----#----#----#----#-
--#-#--#-#--#-#--#-#--#-#--#-#--#-#--#-#--#-#--#-#--#-#--#-#--#-#--#-#--#-#--#-#--#-#--#-#--#-#--#-#
---#----#----#----#----#----#----#----#----#----#----#----#----#----#----#----#----#----#----#----#-
#---##---##---##---##---##---##---##---##---##---##---##---##---##---##---##---##---##---##---##---#
----------------------------------------------------------------------------------------------------
---#----#----#----#----#----#----#----#----#----#----#----#----#----#----#----#----#----#----#----#-
--#-#--#-#--#-#--#-#--#-#--#-#--#-#--#-#--#-#--#-#--#-#--#-#--#-#--#-#--#-#--#-#--#-#--#-#--#-#--#-#
---#----#----#----#----#----#----#----#----#----#----#----#----#----#----#----#----#----#----#----#-
#---##---##---##---##---##---##---##---##---##---##---##---##---##---##---##---##---##---##---##---#
----------------------------------------------------------------------------------------------------
---#----#----#----#----#----#----#----#----#----#----#----#----#----#----#----#----#----#----#----#-
--#-#--#-#--#-#--#-#--#-#--#-#--#-#--#-#--#-#--#-#--#-#--#-#--#-#--#-#--#-#--#-#--#-#--#-#--#-#--#-#
---#----#----#----#----#----#----#----#----#----#----#----#----#----#----#----#----#----#----#----#-
#---##---##---##---##---##---##---##---##---##---##---##---##---##---##---##---##---##---##---##---#
----------------------------------------------------------------------------------------------------
---#----#----#----#----#----#----#----#----#----#----#----#----#----#----#----#----#----#----#----#-
--#-#--#-#--#-#--#-#--#-#--#-#--#-#--#-#--#-#--#-#--#-#--#-#--#-#--#-#--#-#--#-#--#-#--#-#--#-#--#-#
---#----#----#----#----#----#----#----#----#----#----#----#----#----#----#----#----#----#----#----#-
#---##---##---##---##---##---##---##---##---##---##---##---##---##---##---##---##---##---##---##---#
----------------------------------------------------------------------------------------------------
---#----#----#----#----#----#----#----#----#----#----#----#----#----#----#----#----#----#----#----#-
--#-#--#-#--#-#--#-#--#-#--#-#--#-#--#-#--#-#--#-#--#-#--#-#--#-#--#-#--#-#--#-#--#-#--#-#--#-#--#-#
---#----#----#----#----#----#----#----#----#----#----#----#----#----#----#----#----#----#----#----#-
#---##---##---##---##---##---##---##---##---##---##---##---##---##---##---##---##---##---##---##---#
----------------------------------------------------------------------------------------------------
---#----#----#----#----#----#----#----#----#----#----#----#----#----#----#----#----#----#----#----#-
--#-#--#-#--#-#--#-#--#-#--#-#--#-#--#-#--#-#--#-#--#-#--#-#--#-#--#-#--#-#--#-#--#-#--#-#--#-#--#-#
---#----#----#----#----#----#----#----#----#----#----#----#----#----#----#----#----#----#----#----#-
#---##---##---##---##---##---##---##---##---##---##---##---##---##---##---##---##---##---##---##---#
----------------------------------------------------------------------------------------------------
---#----#----#----#----#----#----#----#----#----#----#----#----#----#----#----#----#----#----#----#-
--#-#--#-#--#-#--#-#--#-#--#-#--#-#--#-#--#-#--#-#--#-#--#-#--#-#--#-#--#-#--#-#--#-#--#-#--#-#--#-#
---#----#----#----#----#----#----#----#----#----#----#----#----#----#----#----#----#----#----#----#-
#---##---##---##---##---##---##---##---##---##---##---##---##---##---##---##---##---##---##---##---#
----------------------------------------------------------------------------------------------------
---#----#----#----#----#----#----#----#----#----#----#----#----#----#----#----#----#----#----#----#-
--#-#--#-#--#-#--#-#--#-#--#-#--#-#--#-#--#-#--#-#--#-#--#-#--#-#--#-#--#-#--#-#--#-#--#-#--#-#--#-#
---#----#----#----#----#----#----#----#----#----#----#----#----#----#----#----#----#----#----#----#-
#---##---##---##---##---##---##---##---##---##---##---##---##---##---##---##---##---##---##---##---#
----------------------------------------------------------------------------------------------------
---#----#----#----#----#----#----#----#----#----#----#----#----#----#----#----#----#----#----#----#-
--#-#--#-#--#-#--#-#--#-#--#-#--#-#--#-#--#-#S-#-#--#-#--#-#--#-#--#-#--#-#--#-#--#-#--#-#--#-#--#-#
---#----#----#----#----#----#----#----#----#----#----#----#----#----#----#----#----#----#----#----#-
#---##---##---##---##---##---##---##---##---##---##---##---##---##---##---##---##---##---##---##---#
----------------------------------------------------------------------------------------------------
---#----#----#----#----#----#----#----#----#----#----#----#----#----#----#----#----#----#----#----#-
--#-#--#-#--#-#--#-#--#-#--#-#--#-#--#-#--#-#--#-#--#-#--#-#--#-#--#-#--#-#--#-#--#-#--#-#--#-#--#-#
---#----#----#----#----#----#----#----#----#----#----#----#----#----#----#----#----#----#----#----#-
#---##---##---##---##---##---##---##---##---##---##---##---##---##---##---##---##---##---##---##---#
----------------------------------------------------------------------------------------------------
---#----#----#----#----#----#----#----#----#----#----#----#----#----#----#----#----#----#----#----#-
--#-#--#-#--#-#--#-#--#-#--#-#--#-#--#-#--#-#--#-#--#-#--#-#--#-#--#-#--#-#--#-#--#-#--#-#--#-#--#-#
---#----#----#----#----#----#----#----#----#----#----#----#----#----#----#----#----#----#----#----#-
#---##---##---##---##---##---##---##---##---##---##---##---##---##---##---##---##---##---##---##---#
----------------------------------------------------------------------------------------------------
---#----#----#----#----#----#----#----#----#----#----#----#----#----#----#----#----#----#----#----#-
--#-#--#-#--#-#--#-#--#-#--#-#--#-#--#-#--#-#--#-#--#-#--#-#--#-#--#-#--#-#--#-#--#-#--#-#--#-#--#-#
---#----#----#----#----#----#----#----#----#----#----#----#----#----#----#----#----#----#----#----#-
#---##---##---##---##---##---##---##---##---##---##---##---##---##---##---##---##---##---##---##---#
----------------------------------------------------------------------------------------------------
---#----#----#----#----#----#----#----#----#----#----#----#----#----#----#----#----#----#----#----#-
--#-#--#-#--#-#--#-#--#-#--#-#--#-#--#-#--#-#--#-#--#-#--#-#--#-#--#-#--#-#--#-#--#-#--#-#--#-#--#-#
---#----#----#----#----#----#----#----#----#----#----#----#----#----#----#----#----#----#----#----#-
#---##---##---##---##---##---##---##---##---##---##---##---##---##---##---##---##---##---##---##---#
----------------------------------------------------------------------------------------------------
---#----#----#----#----#----#----#----#----#----#----#----#----#----#----#----#----#----#----#----#-
--#-#--#-#--#-#--#-#--#-#--#-#--#-#--#-#--#-#--#-#--#-#--#-#--#-#--#-#--#-#--#-#--#-#--#-#--#-#--#-#
---#----#----#----#----#----#----#----#----#----#----#----#----#----#----#----#----#----#----#----#-
#---##---##---##---##---##---##---##---##---##---##---##---##---##---##---##---##---##---##---##---#
----------------------------------------------------------------------------------------------------
---#----#----#----#----#----#----#----#----#----#----#----#----#----#----#----#----#----#----#----#-
--#-#--#-#--#-#--#-#--#-#--#-#--#-#--#-#--#-#--#-#--#-#--#-#--#-#--#-#--#-#--#-#--#-#--#-#--#-#--#-#
---#----#----#----#----#----#----#----#----#----#----#----#----#----#----#----#----#----#----#----#-
#---##---##---##---##---##---##---##---##---##---##---##---##---##---##---##---##---##---##---##---#
----------------------------------------------------------------------------------------------------
---#----#----#----#----#----#----#----#----#----#----#----#----#----#----#----#----#----#----#----#-
--#-#--#-#--#-#--#-#--#-#--#-#--#-#--#-#--#-#--#-#--#-#--#-#--#-#--#-#--#-#--#-#--#-#--#-#--#-#--#-#
---#----#----#----#----#----#----#----#----#----#----#----#----#----#----#----#----#----#----#----#-
#---##---##---##---##---##---##---##---##---##---##---##---##---##---##---##---##---##---##---##---#
----------------------------------------------------------------------------------------------------
---#----#----#----#----#----#----#----#----#----#----#----#----#----#----#----#----#----#----#----#-
--#-#--#-#--#-#--#-#--#-#--#-#--#-#--#-#--#-#--#-#--#-#--#-#--#-#--#-#--#-#--#-#--#-#--#-#--#-#--#-#
---#----#----#----#----#----#----#----#----#----#----#----#----#----#----#----#----#----#----#----#-
#---##---##---##---##---##---##---##---##---##---##---##---##---##---##---##---##---##---##---##---#
----------------------------------------------------------------------------------------------------
---#----#----#----#----#----#----#----#----#----#----#----#----#----#----#----#----#----#----#----#-
--#-#--#-#--#-#--#-#--#-#--#-#--#-#--#-#--#-#--#-#--#-#--#-#--#-#--#-#--#-#--#-#--#-#--#-#--#-#--#-#
---#----#----#----#----#----#----#----#----#----#----#----#----#----#----#----#----#----#----#----#-
#---##---##---##---##---##---##---##---##---##---##---##---##---##---##---##---##---##---##---##---#
----------------------------------------------------------------------------------------------------
---#----#----#----#----#----#----#----#----#----#----#----#----#----#----#----#----#----#----#----#-
--#-#--#-#--#-#--#-#--#-#--#-#--#-#--#-#--#-#--#-#--#-#--#-#--#-#--#-#--#-#--#-#--#-#--#-#--#-#--#-#