?diagonal=OnlyWhenNoObstacles;
--###--###--###--###--###--###--###--###--###--###--###--###--###--###--###--###--###--###--###--###
----#----#----#----#----#----#----#----#----#----#----#----#----#----#----#----#----#----#----#----#
--#-#--#-#--#-#--#-#--#-#--#-#--#-#--#-#--#-#--#-#--#-#--#-#--#-#--#-#--#-#--#-#--#-#--#-#--#-#--#-#
#----#----#----#----#----#----#----#----#----#----#----#----#----#----#----#----#----#----#----#----
----------------------------------------------------------------------------------------------------
--###--###--###--###--###--###--###--###--###--###--###--###--###--###--###--###--###--###--###--###
----#----#----#----#----#----#----#----#----#----#----#----#----#----#----#----#----#----#----#----#
--#-#--#-#--#-#--#-#--#-#--#-#--#-#--#-#--#-#--#-#--#-#--#-#--#-#--#-#--#-#--#-#--#-#--#-#--#-#--#-#
#----#----#----#----#----#----#----#----#----#----#----#----#----#----#----#----#----#----#----#----
-------------------------------------------------E--------------------------------------------------
--###--###--###--###--###--###--###--###--###--###--###--###--###--###--###--###--###--###--###--###
----#----#----#----#----#----#----#----#----#----#----#----#----#----#----#----#----#----#----#----#
--#-#--#-#--#-#--#-#--#-#--#-#--#-#--#-#--#-#--#-#--#-#--#-#--#-#--#-#--#-#--#-#--#-#--#-#--#-#--#-#
#----#----#----#----#----#----#----#----#----#----#----#----#----#----#----#----#----#----#----#----
----------------------------------------------------------------------------------------------------
--###--###--###--###--###--###--###--###--###--###--###--###--###--###--###--###--###--###--###--###
----#----#----#----#----#----#----#----#----#----#----#----#----#----#----#----#----#----#----#----#
--#-#--#-#--#-#--#-#--#-#--#-#--#-#--#-#--#-#--#-#--#-#--#-#--#-#--#-#--#-#--#-#--#-#--#-#--#-#--#-#
#----#----#----#----#----#----#----#----#----#----#----#----#----#----#----#----#----#----#----#----
----------------------------------------------------------------------------------------------------
--###--###--###--###--###--###--###--###--###--###--###--###--###--###--###--###--###--###--###--###
----#----#----#----#----#----#----#----#----#----#----#----#----#----#----#----#----#----#----#----#
--#-#--#-#--#-#--#-#--#-#--#-#--#-#--#-#--#-#--#-#--#-#--#-#--#-#--#-#--#-#--#-#--#-#--#-#--#-#--#-#
#----#----#----#----#----#----#----#----#----#----#----#----#----#----#----#----#----#----#----#----
----------------------------------------------------------------------------------------------------
--###--###--###--###--###--###--###--###--###--###--###--###--###--###--###--###--###--###--###--###
----#----#----#----#----#----#----#----#----#----#----#----#----#----#----#----#----#----#----#----#
--#-#--#-#--#-#--#-#--#-#--#-#--#-#--#-#--#-#--#-#--#-#--#-#--#-#--#-#--#-#--#-#--#-#--#-#--#-#--#-#
#----#----#----#----#----#----#----#----#----#----#----#----#----#----#----#----#----#----#----#----
-------------------------------------S--------------------------------------------------------------
--###--###--###--###--###--###--###--###--###--###--###--###--###--###--###--###--###--###--###--###
----#----#----#----#----#----#----#----#----#----#----#----#----#----#----#----#----#----#----#----#
--#-#--#-#--#-#--#-#--#-#--#-#--#-#--#-#--#-#--#-#--#-#--#-#--#-#--#-#--#-#--#-#--#-#--#-#--#-#--#-#
#----#----#----#----#----#----#----#----#----#----#----#----#----#----#----#----#----#----#----#----
----------------------------------------------------------------------------------------------------
--###--###--###--###--###--###--###--###--###--###--###--###--###--###--###--###--###--###--###--###
----#----#----#----#----#----#----#----#----#----#----#----#----#----#----#----#----#----#----#----#
--#-#--#-#--#-#--#-#--#-#--#-#--#-#--#-#--#-#--#-#--#-#--#-#--#-#--#-#--#-#--#-#--#-#--#-#--#-#--#-#
#----#----#----#----#----#----#----#----#----#----#----#----#----#----#----#----#----#----#----#----
----------------------------------------------------------------------------------------------------
--###--###--###--###--###--###--###--###--###--###--###--###--###--###--###--###--###--###--###--###
----#----#----#----#----#----#----#----#----#----#----#----#----#----#----#----#----#----#----#----#
--#-#--#-#--#-#--#-#--#-#--#-#--#-#--#-#--#-#--#-#--#-#--#-#--#-#--#-#--#-#--#-#--#-#--#-#--#-#--#-#
#----#----#----#----#----#----#----#----#----#----#----#----#----#----#----#----#----#----#----#----
----------------------------------------------------------------------------------------------------
--###--###--###--###--###--###--###--###--###--###--###--###--###--###--###--###--###--###--###--###
----#----#----#----#----#----#----#----#----#----#----#----#----#----#----#----#----#----#----#----#
--#-#--#-#--#-#--#-#--#-#--#-#--#-#--#-#--#-#--#-#--#-#--#-#--#-#--#-#--#-#--#-#--#-#--#-#--#-#--#-#
#----#----#----#----#----#----#----#----#----#----#----#----#----#----#----#----#----#----#----#----
----------------------------------------------------------------------------------------------------
--###--###--###--###--###--###--###--###--###--###--###--###--###--###--###--###--###--###--###--###
----#----#----#----#----#----#----#----#----#----#----#----#----#----#----#----#----#----#----#----#
--#-#--#-#--#-#--#-#--#-#--#-#--#-#--#-#--#-#--#-#--#-#--#-#--#-#--#-#--#-#--#-#--#-#--#-#--#-#--#-#
#----#----#----#----#----#----#----#----#----#----#----#----#----#----#----#----#----#----#----#----
----------------------------------------------------------------------------------------------------
--###--###--###--###--###--###--###--###--###--###--###--###--###--###--###--###--###--###--###--###
----#----#----#----#----#----#----#----#----#----#----#----#----#----#----#----#----#----#----#----#
--#-#--#-#--#-#--#-#--#-#--#-#--#-#--#-#--#-#--#-#--#-#--#-#--#-#--#-#--#-#--#-#--#-#--#-#--#-#--#-#
#----#----#----#----#----#----#----#----#----#----#----#----#----#----#----#----#----#----#----#----
----------------------------------------------------------------------------------------------------
--###--###--###--###--###--###--###--###--###--###--###--###--###--###--###--###--###--###--###--###
----#----#----#----#----#----#----#----#----#----#----#----#----#----#----#----#----#----#----#----#
--#-#--#-#--#-#--#-#--#-#--#-#--#-#--#-#--#-#--#-#--#-#--#-#--#-#--#-#--#-#--#-#--#-#--#-#--#-#--#-#
#----#----#----#----#----#----#----#----#----#----#----#----#----#----#----#----#----#----#----#----
----------------------------------------------------------------------------------------------------
--###--###--###--###--###--###--###--###--###--###--###--###--###--###--###--###--###--###--###--###
----#----#----#----#----#----#----#----#----#----#----#----#----#----#----#----#----#----#----#----#
--#-#--#-#--#-#--#-#--#-#--#-#--#-#--#-#--#-#--#-#--#-#--#-#--#-#--#-#--#-#--#-#--#-#--#-#--#-#--#-#
#----#----#----#----#----#----#----#----#----#----#----#----#----#----#----#----#----#----#----#----
----------------------------------------------------------------------------------------------------
--###--###--###--###--###--###--###--###--###--###--###--###--###--###--###--###--###--###--###--###
----#----#----#----#----#----#----#----#----#----#----#----#----#----#----#----#----#----#----#----#
--#-#--#-#--#-#--#-#--#-#--#-#--#-#--#-#--#-#--#-#--#-#--#-#--#-#--#-#--#-#--#-#--#-#--#-#--#-#--#-#
#----#----#----#----#----#----#----#----#----#----#----#----#----#----#----#----#----#----#----#----
----------------------------------------------------------------------------------------------------
--###--###--###--###--###--###--###--###--###--###--###--###--###--###--###--###--###--###--###--###
----#----#----#----#----#----#----#----#----#----#----#----#----#----#----#----#----#----#----#----#
--#-#--#-#--#-#--#-#--#-#--#-#--#-#--#-#--#-#--#-#--#-#--#-#--#-#--#-#--#-#--#-#--#-#--#-#--#-#--#-#
#----#----#----#----#----#----#----#----#----#----#----#----#----#----#----#----#----#----#----#----
----------------------------------------------------------------------------------------------------
--###--###--###--###--###--###--###--###--###--###--###--###--###--###--###--###--###--###--###--###
----#----#----#----#----#----#----#----#----#----#----#----#----#----#----#----#----#----#----#----#
--#-#--#-#--#-#--#-#--#-#--#-#--#-#--#-#--#-#--#-#--#-#--#-#--#-#--#-#--#-#--#-#--#-#--#-#--#-#--#-#
#----#----#----#----#----#----#----#----#----#----#----#----#----#----#----#----#----#----#----#----
----------------------------------------------------------------------------------------------------
--###--###--###--###--###--###--###--###--###--###--###--###--###--###--###--###--###--###--###--###
----#----#----#----#----#----#----#----#----#----#----#----#----#----#----#----#----#----#----#----#
--#-#--#-#--#-#--#-#--#-#--#-#--#-#--#-#--#-#--#-#--#-#--#-#--#-#--#-#--#-#--#-#--#-#--#-#--#-#--#-#
#----#----#----#----#----#----#----#----#----#----#----#----#----#----#----#----#----#----#----#----
----------------------------------------------------------------------------------------------------
--###--###--###--###--###--###--###--###--###--###--###--###--###--###--###--###--###--###--###--###
----#----#----#----#----#----#----#----#----#----#----#----#----#----#----#----#----#----#----#----#
--#-#--#-#--#-#--#-#--#-#--#-#--#-#--#-#--#-#--#-#--#-#--#-#--#-#--#-#--#-#--#-#--#-#--#-#--#-#--#-#
#----#----#----#----#----#----#----#----#----#----#----#----#----#----#----#----#----#----#----#----
----------------------------------------------------------------------------------------------------
--###--###--###--###--###--###--###--###--###--###--###--###--###--###--###--###--###--###--###--###
----#----#----#----#----#----#----#----#----#----#----#----#----#----#----#----#----#----#----#----#
--#-#--#-#--#-#--#-#--#-#--#-#--#-#--#-#--#-#--#-#--#-#--#-#--#-#--#-#--#-#--#-#--#-#--#-#--#-#--#-#
#----#----#----#----#----#----#----#----#----#----#----#----#----#----#----#----#----#----#----#----
----------------------------------------------------------------------------------------------------