?diagonal=OnlyWhenNoObstacles;
----------------------------------------------------------------------------------------------------
-#-#--#-#--#-#--#-#--#-#--#-#--#-#--#-#--#-#--#-#--#-#--#-#--#-#--#-#--#-#--#-#--#-#--#-#--#-#--#-#-
#---##---##---##---##---##---##---##---##---##---##---##---##---##---##---##---##---##---##---##---#
#----#----#----#----#----#----#----#----#----#----#----#----#----#----#----#----#----#----#----#----
--##---##---##---##---##---##---##---##---##---##---##---##---##---##---##---##---##---##---##---##-
----------------------------------------------------------------------------------------E-----------
-#-#--#-#--#-#--#-#--#-#--#-#--#-#--#-#--#-#--#-#--#-#--#-#--#-#--#-#--#-#--#-#--#-#--#-#--#-#--#-#-
#---##---##---##---##---##---##---##---##---##---##---##---##---##---##---##---##---##---##---##---#
#----#----#----#----#----#----#----#----#----#----#----#----#----#----#----#----#----#----#----#----
--##---##---##---##---##---##---##---##---##---##---##---##---##---##---##---##---##---##---##---##-
----------------------------------------------------------------------------------------------------
-#-#--#-#--#-#--#-#--#-#--#-#--#-#--#-#--#-#--#-#--#-#--#-#--#-#--#-#--#-#--#-#--#-#--#-#--#-#--#-#-
#---##---##---##---##---##---##---##---##---##---##---##---##---##---##---##---##---##---##---##---#
#----#----#----#----#----#----#----#----#----#----#----#----#----#----#----#----#----#----#----#----
--##---##---##---##---##---##---##---##---##---##---##---##---##---##---##---##---##---##---##---##-
----------------------------------------------------------------------------------------------------
-#-#--#-#--#-#--#-#--#-#--#-#--#-#--#-#--#-#--#-#--#-#--#-#--#-#--#-#--#-#--#-#--#-#--#-#--#-#--#-#-
#---##---##---##---##---##---##---##---##---##---##---##---##---##---##---##---##---##---##---##---#
#----#----#----#----#----#----#----#----#----#----#----#----#----#----#----#----#----#----#----#----
--##---##---##---##---##---##---##---##---##---##---##---##---##---##---##---##---##---##---##---##-
----------------------------------------------------------------------------------------------------
-#-#--#-#--#-#--#-#--#-#--#-#--#-#--#-#--#-#--#-#--#-#--#-#--#-#--#-#--#-#--#-#--#-#--#-#--#-#--#-#-
#---##---##---##---##---##---##---##---##---##---##---##---##---##---##---##---##---##---##---##---#
#----#----#----#----#----#----#----#----#----#----#----#----#----#----#----#----#----#----#----#----
--##---##---##---##---##---##---##---##---##---##---##---##---##---##---##---##---##---##---##---##-
----------------------------------------------------------------------------------------------------
-#-#--#-#--#-#--#-#--#-#--#-#--#-#--#-#--#-#--#-#--#-#--#-#--#-#--#-#--#-#--#-#--#-#--#-#--#-#--#-#-
#---##---##---##---##---##---##---##---##---##---##---##---##---##---##---##---##---##---##---##---#
#----#----#----#----#----#----#----#----#----#----#----#----#----#----#----#----#----#----#----#----
--##---##---##---##---##---##---##---##---##---##---##---##---##---##---##---##---##---##---##---##-
----------------------------------------------------------------------------------------------------
-#-#--#-#--#-#--#-#--#-#--#-#--#-#--#-#--#-#--#-#--#-#--#-#--#-#--#-#--#-#--#-#--#-#--#-#--#-#--#-#-
#---##---##---##---##---##---##---##---##---##---##---##---##---##---##---##---##---##---##---##---#
#----#----#----#----#----#----#----#----#----#----#----#----#----#----#----#----#----#----#----#----
--##---##---##---##---##---##---##---##---##---##---##---##---##---##---##---##---##---##---##---##-
----------------------------------------------------------------------------------------------------
-#-#--#-#--#-#--#-#--#-#--#-#--#-#--#-#--#-#--#-#--#-#--#-#--#-#--#-#--#-#--#-#--#-#--#-#--#-#--#-#-
#---##---##---##---##---##---##---##---##---##---##---##---##---##---##---##---##---##---##---##---#
#----#----#----#----#----#----#----#----#----#----#----#----#----#----#----#----#----#----#----#----
--##---##---##---##---##---##---##---##---##---##---##---##---##---##---##---##---##---##---##---##-
----------------------------------------------------------------------------------------------------
-#-#--#-#--#-#--#-#--#-#--#-#--#-#--#-#--#-#--#-#--#-#--#-#--#-#--#-#--#-#--#-#--#-#--#-#--#-#--#-#-
#---##---##---##---##---##---##---##---##---##---##---##---##---##---##---##---##---##---##---##---#
#----#----#----#----#----#----#----#----#----#----#----#----#----#----#----#----#----#----#----#----
--##---##---##---##---##---##---##---##---##---##---##---##---##---##---##---##---##---##---##---##-
----------------------------------------------------------------------------------------------------
-#-#--#-#--#-#--#-#--#-#--#-#--#-#--#-#--#-#--#-#--#-#--#-#--#-#--#-#--#-#--#-#--#-#--#-#--#-#--#-#-
#---##---##---##---##---##---##---##---##---##---##---##---##---##---##---##---##---##---##---##---#
#----#----#----#----#----#----#----#----#----#----#----#----#----#----#----#----#----#----#----#----
--##---##---##---##---##---##---##---##---##---##---##---##---##---##---##---##---##---##---##---##-
----------------------------------------------------------------------------------------------------
-#-#--#-#--#-#--#-#--#-#--#-#--#-#--#-#--#-#--#-#--#-#--#-#--#-#--#-#--#-#--#-#--#-#--#-#--#-#--#-#-
#---##---##---##---##---##---##---##---##---##---##---##---##---##---##---##---##---##---##---##---#
#----#----#----#----#----#----#----#----#----#----#----#----#----#----#----#----#----#----#----#----
--##---##---##---##---##---##---##---##---##---##---##---##---##---##---##---##---##---##---##---##-
----------------------------------------------------------------------------------------------------
-#-#--#-#--#-#--#-#--#-#--#-#--#-#--#-#--#-#--#-#--#-#--#-#--#-#--#-#--#-#--#-#--#-#--#-#--#-#--#-#-
#---##---##---##---##---##---##---##---##---##---##---##---##---##---##---##---##---##---##---##---#
#----#----#----#----#----#----#----#----#----#----#----#----#----#----#----#----#----#----#----#----
--##---##---##---##---##---##---##---##---##---##---##---##---##---##---##---##---##---##---##---##-
----------------------------------------------------------------------------------------------------
-#-#--#-#--#-#--#-#--#-#--#-#--#-#--#-#--#-#--#-#--#-#--#-#--#-#--#-#--#-#--#-#--#-#--#-#--#-#--#-#-
#---##---##---##---##---##---##---##---##---##---##---##---##---##---##---##---##---##---##---##---#
#----#----#----#----#----#----#----#----#----#----#----#----#----#----#----#----#----#----#----#----
--##---##---##---##---##---##---##---##---##---##---##---##---##---##---##---##---##---##---##---##-
----------------------------------------------------------------------------------------------------
-#-#--#-#--#-#--#-#--#-#--#-#--#-#--#-#--#-#--#-#--#-#--#-#--#-#--#-#--#-#--#-#--#-#--#-#--#-#--#-#-
#---##---##---##---##---##---##---##---##---##---##---##---##---##---##---##---##---##---##---##---#
#----#----#----#----#----#----#----#----#----#----#----#----#----#----#----#----#----#----#----#----
--##---##---##---##---##---##---##---##---##---##---##---##---##---##---##---##---##---##---##---##-
----------------------------------------------------------------------------------------------------
-#-#--#-#--#-#--#-#--#-#--#-#--#-#--#-#--#-#--#-#--#-#--#-#--#-#--#-#--#-#--#-#--#-#--#-#--#-#--#-#-
#---##---##---##---##---##---##---##---##---##---##---##---##---##---##---##---##---##---##---##---#
#----#----#----#----#----#----#----#----#----#----#----#----#----#----#----#----#----#----#----#----
--##---##---##---##---##---##---##---##---##---##---##---##---##---##---##---##---##---##---##---##-
----------------------------------------------------------------------------------------------------
-#-#--#-#--#-#--#-#--#-#--#-#--#-#--#-#--#-#--#-#--#-#--#-#--#-#--#-#--#-#--#-#--#-#--#-#--#-#--#-#-
#---##---##---##---##---##---##---##---##---##---##---##---##---##---##---##---##---##---##---##---#
#----#----#----#----#----#----#----#----#----#----#----#----#----#----#----#----#----#----#----#----
--##---##---##---##---##---##---##---##---##---##---##---##---##---##---##---##---##---##---##---##-
----------------------------------------------------------------------------------------------------
-#-#--#-#--#-#--#-#--#-#--#-#--#-#--#-#--#-#--#-#--#-#--#-#--#-#--#-#--#-#--#-#--#-#--#-#--#-#--#-#-
#---##---##---##---##---##---##---##---##---##---##---##---##---##---##---##---##---##---##---##---#
#----#----#----#----#----#----#----#----#----#----#----#----#----#----#----#----#----#----#----#----
--##---##---##---##---##---##---##---##---##---##---##---##---##---##---##---##---##---##---##---##-
----------------------------------------------------------------------------------------------------
-#-#--#-#--#-#--#-#--#-#--#-#--#-#--#-#--#-#--#-#--#-#--#-#--#-#--#-#--#-#--#-#--#-#--#-#--#-#--#-#-
#---##---##---##---##---##---##---##---##---##---##---##---##---##---##---##---##---##---##---##---#
#----#----#----#----#----#----#----#----#----#----#----#----#----#----#----#----#----#----#----#----
--##---##---##---##---##---##---##---##---##---##---##---##---##---##---##---##---##---##---##---##-
---------------------------------------S------------------------------------------------------------
-#-#--#-#--#-#--#-#--#-#--#-#--#-#--#-#--#-#--#-#--#-#--#-#--#-#--#-#--#-#--#-#--#-#--#-#--#-#--#-#-
#---##---##---##---##---##---##---##---##---##---##---##---##---##---##---##---##---##---##---##---#
#----#----#----#----#----#----#----#----#----#----#----#----#----#----#----#----#----#----#----#----
--##---##---##---##---##---##---##---##---##---##---##---##---##---##---##---##---##---##---##---##-
----------------------------------------------------------------------------------------------------
-#-#--#-#--#-#--#-#--#-#--#-#--#-#--#-#--#-#--#-#--#-#--#-#--#-#--#-#--#-#--#-#--#-#--#-#--#-#--#-#-
#---##---##---##---##---##---##---##---##---##---##---##---##---##---##---##---##---##---##---##---#
#----#----#----#----#----#----#----#----#----#----#----#----#----#----#----#----#----#----#----#----
--##---##---##---##---##---##---##---##---##---##---##---##---##---##---##---##---##---##---##---##-