?diagonal=OnlyWhenNoObstacles;
----------------------------------------------------------------------------------------------------
#----#----#----#----#----#----#----#----#----#----#----#----#----#----#----#----#----#----#----#----
-##---##---##---##---##---##---##---##---##---##---##---##---##---##---##---##---##---##---##---##--
-##---##---##---##---##---##---##---##---##---##---##---##---##---##---##---##---##---##---##---##--
##---##---##---##---##---##---##---##---##---##---##---##---##---##---##---##---##---##---##---##---
----------------------------------------------------------------------------------------------------
#----#----#----#----#----#----#----#----#----#----#----#----#----#----#----#----#----#----#----#----
-##---##---##---##---##---##---##---##---##---##---##---##---##---##---##---##---##---##---##---##--
-##---##---##---##---##---##---##---##---##---##---##---##---##---##---##---##---##---##---##---##--
##S--##---##---##---##---##---##---##---##---##---##---##---##---##---##---##---##---##---##---##---
----------------------------------------------------------------------------------------------------
#----#----#----#----#----#----#----#----#----#----#----#----#----#----#----#----#----#----#----#----
-##---##---##---##---##---##---##---##---##---##---##---##---##---##---##---##---##---##---##---##--
-##---##---##---##---##---##---##---##---##---##---##---##---##---##---##---##---##---##---##---##--
##---##---##---##---##---##---##---##---##---##---##---##---##---##---##---##---##---##---##---##---
----------------------------------------------------------------------------------------------------
#----#----#----#----#----#----#----#----#----#----#----#----#----#----#----#----#----#----#----#----
-##---##---##---##---##---##---##---##---##---##---##---##---##---##---##---##---##---##---##---##--
-##---##---##---##---##---##---##---##---##---##---##---##---##---##---##---##---##---##---##---##--
##---##---##---##---##---##---##---##---##---##---##---##---##---##---##---##---##---##---##---##---
----------------------------------------------------------------------------------------------------
#----#----#----#----#----#----#----#----#----#----#----#----#----#----#----#----#----#----#----#----
-##---##---##---##---##---##---##---##---##---##---##---##---##---##---##---##---##---##---##---##--
-##---##---##---##---##---##---##---##---##---##---##---##---##---##---##---##---##---##---##---##--
##---##---##---##---##---##---##---##---##---##---##---##---##---##---##---##---##---##---##---##---
----------------------------------------------------------------------------------------------------
#----#----#----#----#----#----#----#----#----#----#----#----#----#----#----#----#----#----#----#----
-##---##---##---##---##---##---##---##---##---##---##---##---##---##---##---##---##---##---##---##--
-##---##---##---##---##---##---##---##---##---##---##---##---##---##---##---##---##---##---##---##--
##---##---##---##---##---##---##---##---##---##---##---##---##---##---##---##---##---##---##---##---
----------------------------------------------------------------------------------------------------
#----#----#----#----#----#----#----#----#----#----#----#----#----#----#----#----#----#----#----#----
-##---##---##---##---##---##---##---##---##---##---##---##---##---##---##---##---##---##---##---##--
-##---##---##---##---##---##---##---##---##---##---##---##---##---##---##---##---##---##---##---##--
##---##---##---##---##---##---##---##---##---##---##---##---##---##---##---##---##---##---##---##---
----------------------------------------------------------------------------------------------------
#----#----#----#----#----#----#----#----#----#----#----#----#----#----#----#----#----#----#----#----
-##---##---##---##---##---##---##---##---##---##---##---##---##---##---##---##---##---##---##---##--
-##---##---##---##---##---##---##---##---##---##---##---##---##---##---##---##---##---##---##---##--
##---##---##---##---##---##---##---##---##---##---##---##---##---##---##---##---##---##---##---##---
----------------------------------------------------------------------------------------------------
#----#----#----#----#----#----#----#----#----#----#----#----#----#----#----#----#----#----#----#----
-##---##---##---##---##---##---##---##---##---##---##---##---##---##---##---##---##---##---##---##--
-##---##---##---##---##---##---##---##---##---##---##---##---##---##---##---##---##---##---##---##--
##---##---##---##---##---##---##---##---##---##---##---##---##---##---##---##---##---##---##---##---
----------------------------------------------------------------------------------------------------
#----#----#----#----#----#----#----#----#----#----#----#----#----#----#----#----#----#----#----#----
-##---##---##---##---##---##---##---##---##---##---##---##---##---##---##---##---##---##---##---##--
-##---##---##---##---##---##---##---##---##---##---##---##---##---##---##---##---##---##---##---##--
##---##---##---##---##---##---##---##---##---##---##---##---##---##---##---##---##---##---##---##---
----------------------------------------------------------------------------------------------------
#----#----#----#----#----#----#----#----#----#----#----#----#----#----#----#----#----#----#----#----
-##---##---##---##---##---##---##---##---##---##---##---##---##---##---##---##---##---##---##---##--
-##---##---##---##---##---##---##---##---##---##---##---##---##---##---##---##---##---##---##---##--
##---##---##---##---##---##---##---##---##---##---##---##---##---##---##---##---##---##---##---##---
----------------------------------------------------------------------------------------------------
#----#----#----#----#----#----#----#----#----#----#----#----#----#----#----#----#----#----#----#----
-##---##---##---##---##---##---##---##---##---##---##---##---##---##---##---##---##---##---##---##--
-##---##---##---##---##---##---##---##---##---##---##---##---##---##---##---##---##---##---##---##--
##---##---##---##---##---##---##---##---##---##---##---##---##---##---##---##---##---##---##---##---
----------------------------------------------------------------------------------------------------
#----#----#----#----#----#----#----#----#----#----#----#----#----#----#----#----#----#----#----#----
-##---##---##---##---##---##---##---##---##---##---##---##---##---##---##---##---##---##---##---##--
-##---##---##---##---##---##---##---##---##---##---##---##---##---##---##---##---##---##---##---##--
##---##---##---##---##---##---##---##---##---##---##---##---##---##---##---##---##---##---##---##---
----------------------------------------------------------------------------------------------------
#----#----#----#----#----#----#----#----#----#----#----#----#----#----#----#----#----#----#----#----
-##---##---##---##---##---##---##---##---##---##---##---##---##---##---##---##---##---##---##---##--
-##---##---##---##---##---##---##---##---##---##---##---##---##---##---##---##---##---##---##---##--
##---##---##---##---##---##---##---##---##---##---##---##---##---##---##---##---##---##---##---##---
----------------------------------------------------------------------------------------------------
#----#----#----#----#----#----#----#----#----#----#----#----#----#----#----#----#----#----#----#----
-##---##---##---##---##---##---##---##---##---##---##---##---##---##---##---##---##---##---##---##--
-##---##---##---##---##---##---##---##---##---##---##---##---##---##---##---##---##---##---##---##--
##---##---##---##---##---##---##---##---##---##---##---##---##---##---##---##---##---##---##---##---
----------------------------------------------------------------------------------------------------
#----#E---#----#----#----#----#----#----#----#----#----#----#----#----#----#----#----#----#----#----
-##---##---##---##---##---##---##---##---##---##---##---##---##---##---##---##---##---##---##---##--
-##---##---##---##---##---##---##---##---##---##---##---##---##---##---##---##---##---##---##---##--
##---##---##---##---##---##---##---##---##---##---##---##---##---##---##---##---##---##---##---##---
----------------------------------------------------------------------------------------------------
#----#----#----#----#----#----#----#----#----#----#----#----#----#----#----#----#----#----#----#----
-##---##---##---##---##---##---##---##---##---##---##---##---##---##---##---##---##---##---##---##--
-##---##---##---##---##---##---##---##---##---##---##---##---##---##---##---##---##---##---##---##--
##---##---##---##---##---##---##---##---##---##---##---##---##---##---##---##---##---##---##---##---
----------------------------------------------------------------------------------------------------
#----#----#----#----#----#----#----#----#----#----#----#----#----#----#----#----#----#----#----#----
-##---##---##---##---##---##---##---##---##---##---##---##---##---##---##---##---##---##---##---##--
-##---##---##---##---##---##---##---##---##---##---##---##---##---##---##---##---##---##---##---##--
##---##---##---##---##---##---##---##---##---##---##---##---##---##---##---##---##---##---##---##---
----------------------------------------------------------------------------------------------------
#----#----#----#----#----#----#----#----#----#----#----#----#----#----#----#----#----#----#----#----
-##---##---##---##---##---##---##---##---##---##---##---##---##---##---##---##---##---##---##---##--
-##---##---##---##---##---##---##---##---##---##---##---##---##---##---##---##---##---##---##---##--
##---##---##---##---##---##---##---##---##---##---##---##---##---##---##---##---##---##---##---##---
----------------------------------------------------------------------------------------------------
#----#----#----#----#----#----#----#----#----#----#----#----#----#----#----#----#----#----#----#----
-##---##---##---##---##---##---##---##---##---##---##---##---##---##---##---##---##---##---##---##--
-##---##---##---##---##---##---##---##---##---##---##---##---##---##---##---##---##---##---##---##--
##---##---##---##---##---##---##---##---##---##---##---##---##---##---##---##---##---##---##---##---