?diagonal=OnlyWhenNoObstacles;
--#----#----#----#----#----#----#----#----#----#----#----#----#----#----#----#----#----#----#----#--
--###--###--###--###--###--###--###--###--###--###--###--###--###--###--###--###--###--###--###--###
----------------------------------------------------------------------------------------------------
----------------------------------------------------------------------------------------------------
#-#--#-#--#-#--#-#--#-#--#-#--#-#--#-#--#-#--#-#--#-#--#-#--#-#--#-#--#-#--#-#--#-#--#-#--#-#--#-#--
--#----#----#----#----#----#----#----#----#----#----#----#----#----#----#----#----#----#----#----#--
--###--###--###--###--###--###--###--###--###--###--###--###--###--###--###--###--###--###--###--###
----------------------------------------------------------------------------------------------------
----------------------------------------------------------------------------------------------------
#-#--#-#--#-#--#-#--#-#--#-#--#-#--#-#--#-#--#-#--#-#--#-#--#-#--#-#--#-#--#-#--#-#--#-#--#-#--#-#--
--#----#----#----#----#----#----#----#----#----#----#----#----#----#----#----#----#----#----#----#--
--###--###--###--###--###--###--###--###--###--###--###--###--###--###--###--###--###--###--###-E###
----------------------------------------------------------------------------------------------------
----------------------------------------------------------------------------------------------------
#-#--#-#--#-#--#-#--#-#--#-#--#-#--#-#--#-#--#-#--#-#--#-#--#-#--#-#--#-#--#-#--#-#--#-#--#-#--#-#--
--#----#----#----#----#----#----#----#----#----#----#----#----#----#----#----#----#----#----#----#--
--###--###--###--###--###--###--###--###--###--###--###--###--###--###--###--###--###--###--###--###
----------------------------------------------------------------------------------------------------
----------------------------------------------------------------------------------------------------
#-#--#-#--#-#--#-#--#-#--#-#--#-#--#-#--#-#--#-#--#-#--#-#--#-#--#-#--#-#--#-#--#-#--#-#--#-#--#-#--
--#----#----#----#----#----#----#----#----#----#----#----#----#----#----#----#----#----#----#----#--
--###--###--###--###--###--###--###--###--###--###--###--###--###--###--###--###--###--###--###--###
----------------------------------------------------------------------------------------------------
----------------------------------------------------------------------------------------------------
#-#--#-#--#-#--#-#--#-#--#-#--#-#--#-#--#-#--#-#--#-#--#-#--#-#--#-#--#-#--#-#--#-#--#-#--#-#--#-#--
--#----#----#----#----#----#----#----#----#----#----#----#----#----#----#----#----#----#----#----#--
--###--###--###--###--###--###--###--###--###--###--###--###--###--###--###--###--###--###--###--###
----------------------------------------------------------------------------------------------------
---------------------S------------------------------------------------------------------------------
#-#--#-#--#-#--#-#--#-#--#-#--#-#--#-#--#-#--#-#--#-#--#-#--#-#--#-#--#-#--#-#--#-#--#-#--#-#--#-#--
--#----#----#----#----#----#----#----#----#----#----#----#----#----#----#----#----#----#----#----#--
--###--###--###--###--###--###--###--###--###--###--###--###--###--###--###--###--###--###--###--###
----------------------------------------------------------------------------------------------------
----------------------------------------------------------------------------------------------------
#-#--#-#--#-#--#-#--#-#--#-#--#-#--#-#--#-#--#-#--#-#--#-#--#-#--#-#--#-#--#-#--#-#--#-#--#-#--#-#--
--#----#----#----#----#----#----#----#----#----#----#----#----#----#----#----#----#----#----#----#--
--###--###--###--###--###--###--###--###--###--###--###--###--###--###--###--###--###--###--###--###
----------------------------------------------------------------------------------------------------
----------------------------------------------------------------------------------------------------
#-#--#-#--#-#--#-#--#-#--#-#--#-#--#-#--#-#--#-#--#-#--#-#--#-#--#-#--#-#--#-#--#-#--#-#--#-#--#-#--
--#----#----#----#----#----#----#----#----#----#----#----#----#----#----#----#----#----#----#----#--
--###--###--###--###--###--###--###--###--###--###--###--###--###--###--###--###--###--###--###--###
----------------------------------------------------------------------------------------------------
----------------------------------------------------------------------------------------------------
#-#--#-#--#-#--#-#--#-#--#-#--#-#--#-#--#-#--#-#--#-#--#-#--#-#--#-#--#-#--#-#--#-#--#-#--#-#--#-#--
--#----#----#----#----#----#----#----#----#----#----#----#----#----#----#----#----#----#----#----#--
--###--###--###--###--###--###--###--###--###--###--###--###--###--###--###--###--###--###--###--###
----------------------------------------------------------------------------------------------------
----------------------------------------------------------------------------------------------------
#-#--#-#--#-#--#-#--#-#--#-#--#-#--#-#--#-#--#-#--#-#--#-#--#-#--#-#--#-#--#-#--#-#--#-#--#-#--#-#--
--#----#----#----#----#----#----#----#----#----#----#----#----#----#----#----#----#----#----#----#--
--###--###--###--###--###--###--###--###--###--###--###--###--###--###--###--###--###--###--###--###
----------------------------------------------------------------------------------------------------
----------------------------------------------------------------------------------------------------
#-#--#-#--#-#--#-#--#-#--#-#--#-#--#-#--#-#--#-#--#-#--#-#--#-#--#-#--#-#--#-#--#-#--#-#--#-#--#-#--
--#----#----#----#----#----#----#----#----#----#----#----#----#----#----#----#----#----#----#----#--
--###--###--###--###--###--###--###--###--###--###--###--###--###--###--###--###--###--###--###--###
----------------------------------------------------------------------------------------------------
----------------------------------------------------------------------------------------------------
#-#--#-#--#-#--#-#--#-#--#-#--#-#--#-#--#-#--#-#--#-#--#-#--#-#--#-#--#-#--#-#--#-#--#-#--#-#--#-#--
--#----#----#----#----#----#----#----#----#----#----#----#----#----#----#----#----#----#----#----#--
--###--###--###--###--###--###--###--###--###--###--###--###--###--###--###--###--###--###--###--###
----------------------------------------------------------------------------------------------------
----------------------------------------------------------------------------------------------------
#-#--#-#--#-#--#-#--#-#--#-#--#-#--#-#--#-#--#-#--#-#--#-#--#-#--#-#--#-#--#-#--#-#--#-#--#-#--#-#--
--#----#----#----#----#----#----#----#----#----#----#----#----#----#----#----#----#----#----#----#--
--###--###--###--###--###--###--###--###--###--###--###--###--###--###--###--###--###--###--###--###
----------------------------------------------------------------------------------------------------
----------------------------------------------------------------------------------------------------
#-#--#-#--#-#--#-#--#-#--#-#--#-#--#-#--#-#--#-#--#-#--#-#--#-#--#-#--#-#--#-#--#-#--#-#--#-#--#-#--
--#----#----#----#----#----#----#----#----#----#----#----#----#----#----#----#----#----#----#----#--
--###--###--###--###--###--###--###--###--###--###--###--###--###--###--###--###--###--###--###--###
----------------------------------------------------------------------------------------------------
----------------------------------------------------------------------------------------------------
#-#--#-#--#-#--#-#--#-#--#-#--#-#--#-#--#-#--#-#--#-#--#-#--#-#--#-#--#-#--#-#--#-#--#-#--#-#--#-#--
--#----#----#----#----#----#----#----#----#----#----#----#----#----#----#----#----#----#----#----#--
--###--###--###--###--###--###--###--###--###--###--###--###--###--###--###--###--###--###--###--###
----------------------------------------------------------------------------------------------------
----------------------------------------------------------------------------------------------------
#-#--#-#--#-#--#-#--#-#--#-#--#-#--#-#--#-#--#-#--#-#--#-#--#-#--#-#--#-#--#-#--#-#--#-#--#-#--#-#--
--#----#----#----#----#----#----#----#----#----#----#----#----#----#----#----#----#----#----#----#--
--###--###--###--###--###--###--###--###--###--###--###--###--###--###--###--###--###--###--###--###
----------------------------------------------------------------------------------------------------
----------------------------------------------------------------------------------------------------
#-#--#-#--#-#--#-#--#-#--#-#--#-#--#-#--#-#--#-#--#-#--#-#--#-#--#-#--#-#--#-#--#-#--#-#--#-#--#-#--
--#----#----#----#----#----#----#----#----#----#----#----#----#----#----#----#----#----#----#----#--
--###--###--###--###--###--###--###--###--###--###--###--###--###--###--###--###--###--###--###--###
----------------------------------------------------------------------------------------------------
----------------------------------------------------------------------------------------------------
#-#--#-#--#-#--#-#--#-#--#-#--#-#--#-#--#-#--#-#--#-#--#-#--#-#--#-#--#-#--#-#--#-#--#-#--#-#--#-#--
--#----#----#----#----#----#----#----#----#----#----#----#----#----#----#----#----#----#----#----#--
--###--###--###--###--###--###--###--###--###--###--###--###--###--###--###--###--###--###--###--###
----------------------------------------------------------------------------------------------------
----------------------------------------------------------------------------------------------------
#-#--#-#--#-#--#-#--#-#--#-#--#-#--#-#--#-#--#-#--#-#--#-#--#-#--#-#--#-#--#-#--#-#--#-#--#-#--#-#--
--#----#----#----#----#----#----#----#----#----#----#----#----#----#----#----#----#----#----#----#--
--###--###--###--###--###--###--###--###--###--###--###--###--###--###--###--###--###--###--###--###
----------------------------------------------------------------------------------------------------
----------------------------------------------------------------------------------------------------
#-#--#-#--#-#--#-#--#-#--#-#--#-#--#-#--#-#--#-#--#-#--#-#--#-#--#-#--#-#--#-#--#-#--#-#--#-#--#-#--