?diagonal=OnlyWhenNoObstacles;
#----#----#----#----#----#----#----#----#----#----#----#----#----#----#----#----#----#----#----#----
----#----#----#----#----#----#----#----#----#----#----#----#----#----#----#----#----#----#----#----#
-#-#--#-#--#-#--#-#--#-#--#-#--#-#--#-#--#-#--#-#--#-#--#-#--#-#--#-#--#-#--#-#--#-#--#-#--#-#--#-#-
--#-#--#-#--#-#--#-#--#-#--#-#--#-#--#-#--#-#--#-#--#-#--#-#--#-#--#-#--#-#--#-#--#-#--#-#--#-#--#-#
--#----#----#----#----#----#----#----#----#----#----#----#----#----#----#----#----#----#----#----#--
#----#----#----#----#----#----#----#----#----#----#----#----#----#----#----#----#----#----#----#----
----#----#----#----#----#----#----#----#----#----#----#----#----#----#----#----#----#----#----#----#
-#-#--#-#--#-#--#-#--#-#--#-#--#-#--#-#--#-#--#-#--#-#--#-#--#-#--#-#--#-#--#-#--#-#--#-#--#-#--#-#-
--#-#--#-#--#-#--#-#--#-#--#-#--#-#--#-#--#-#--#-#--#-#--#-#--#-#--#-#--#-#--#-#--#-#--#-#--#-#--#-#
--#----#----#----#----#----#----#----#----#----#----#----#----#----#----#----#----#----#----#----#--
#----#----#----#----#----#----#----#----#----#----#----#----#----#----#----#----#----#----#----#----
----#----#----#----#----#----#----#----#----#----#----#----#----#----#----#----#----#----#----#----#
-#-#--#-#--#-#--#-#--#-#--#-#--#-#--#-#--#-#--#-#--#-#--#-#--#-#--#-#--#-#--#-#--#-#--#-#--#-#--#-#-
--#-#--#-#--#-#--#-#--#-#--#-#--#-#--#-#--#-#--#-#--#-#--#-#--#-#--#-#--#-#--#-#--#-#--#-#--#-#--#-#
--#----#----#----#----#----#----#----#----#----#----#----#----#----#----#----#----#----#----#----#--
#----#----#----#----#----#----#----#----#----#----#----#----#----#----#----#----#----#----#----#----
----#----#----#----#----#----#----#----#----#----#----#----#----#----#----#----#----#----#----#----#
-#-#--#-#--#-#--#-#--#-#--#-#--#-#--#-#--#-#--#-#--#-#--#-#--#-#--#-#--#-#--#-#--#-#--#-#--#-#--#-#-
--#-#--#-#--#-#--#-#--#-#--#-#--#-#--#-#--#-#--#-#--#-#--#-#--#-#--#-#--#-#--#-#--#-#--#-#--#-#--#-#
--#----#----#----#----#----#----#----#----#----#----#----#----#----#----#----#----#----#----#----#--
#----#----#----#----#----#----#----#----#----#----#----#----#----#----#----#----#----#----#----#----
----#----#----#----#----#----#----#----#----#----#----#----#----#----#----#----#----#----#----#----#
-#-#--#E#--#-#--#-#--#-#--#-#--#-#--#-#--#-#--#-#--#-#--#-#--#-#--#-#--#-#--#-#--#-#--#-#--#-#--#-#-
--#-#--#-#--#-#--#-#--#-#--#-#--#-#--#-#--#-#--#-#--#-#--#-#--#-#--#-#--#-#--#-#--#-#--#-#--#-#--#-#
--#----#----#----#----#----#----#----#----#----#----#----#----#----#----#----#----#----#----#----#--
#----#----#----#----#----#----#----#----#----#----#----#----#----#----#----#----#----#----#----#----
----#----#----#----#----#----#----#----#----#----#----#----#----#----#----#----#----#----#----#----#
-#-#--#-#--#-#--#-#--#-#--#-#--#-#--#-#--#-#--#-#--#-#--#-#--#-#--#-#--#-#--#-#--#-#--#-#--#-#--#-#-
--#-#--#-#--#-#--#-#--#-#--#-#--#-#--#-#--#-#--#-#--#-#--#-#--#-#--#-#--#-#--#-#--#-#--#-#--#-#--#-#
--#----#----#----#----#----#----#----#----#----#----#----#----#----#----#----#----#----#----#----#--
#----#----#----#----#----#----#----#----#----#----#----#----#----#----#----#----#----#----#----#----
----#----#----#----#----#----#----#----#----#----#----#----#----#----#----#----#----#----#----#----#
-#-#--#-#--#-#--#-#--#-#--#-#--#-#--#-#--#-#--#-#--#-#--#-#--#-#--#-#--#-#--#-#--#-#--#-#--#-#--#-#-
--#-#--#-#--#-#--#-#--#-#--#-#--#-#--#-#--#-#--#-#--#-#--#-#--#-#--#-#--#-#--#-#--#-#--#-#--#-#--#-#
--#----#----#----#----#----#----#----#----#----#----#----#----#----#----#----#----#----#----#----#--
#----#----#----#----#----#----#----#----#----#----#----#----#----#----#----#----#----#----#----#----
----#----#----#----#----#----#----#----#----#----#----#----#----#----#----#----#----#----#----#----#
-#-#--#-#--#-#--#-#--#-#--#-#--#-#--#-#--#-#--#-#--#-#--#-#--#-#--#-#--#-#--#-#--#-#--#-#--#-#--#-#-
--#-#--#-#--#-#--#-#--#-#--#-#--#-#--#-#--#-#--#-#--#-#--#-#--#-#--#-#--#-#--#-#--#-#--#-#--#-#--#-#
--#----#----#----#----#----#----#----#----#----#----#----#----#----#----#----#----#----#----#----#--
#----#----#----#----#----#----#----#----#----#----#----#----#----#----#----#----#----#----#----#----
----#----#----#----#----#----#----#----#----#----#----#----#----#----#----#----#----#----#----#----#
-#-#--#-#--#-#--#-#--#-#--#-#--#-#--#-#--#-#--#-#--#-#--#-#--#-#--#-#--#-#--#-#--#-#--#-#--#-#--#-#-
--#-#--#-#--#-#--#-#--#-#--#-#--#-#--#-#--#-#--#-#--#-#--#-#--#-#--#-#--#-#--#-#--#-#--#-#--#-#--#-#
--#----#----#----#----#----#----#----#----#----#----#----#----#----#----#----#----#----#----#----#--
#----#----#----#----#----#----#----#----#----#----#----#----#----#----#----#----#----#----#----#----
----#----#----#----#----#----#----#----#----#----#----#----#----#----#----#----#----#----#----#----#
-#-#--#-#--#-#--#-#--#-#--#-#--#-#--#-#--#-#--#-#--#-#--#-#--#-#--#-#--#-#--#-#--#-#--#-#--#-#--#-#-
--#-#--#-#--#-#--#-#--#-#--#-#--#-#--#-#--#-#--#-#--#-#--#-#--#-#--#-#--#-#--#-#--#-#--#-#--#-#--#-#
--#----#----#----#----#----#----#----#----#----#----#----#----#----#----#----#----#----#----#----#--
#----#----#----#----#----#----#----#----#----#----#----#----#----#----#----#----#----#----#----#----
----#----#----#----#----#----#----#----#----#----#----#----#----#----#----#----#----#----#----#----#
-#-#--#-#--#-#--#-#--#-#--#-#--#-#--#-#--#-#--#-#--#-#--#-#--#-#--#-#--#-#--#-#--#-#--#-#--#-#--#-#-
--#-#--#-#--#-#--#-#--#-#--#-#--#-#--#-#--#-#--#-#--#-#--#-#--#-#--#-#--#-#--#-#--#-#--#-#--#-#--#-#
--#----#----#----#----#----#----#----#----#----#----#----#----#----#----#----#----#----#----#----#--
#----#----#----#----#----#----#----#----#----#----#----#----#----#----#----#----#----#----#----#----
----#----#----#----#----#----#----#----#----#----#----#----#----#----#----#----#----#----#----#----#
-#-#--#-#--#-#--#-#--#-#--#-#--#-#--#-#--#-#--#-#--#-#--#-#--#-#--#-#--#-#--#-#--#-#--#-#--#-#--#-#-
--#-#--#-#--#-#--#-#--#-#--#-#--#-#--#-#--#-#--#-#--#-#--#-#--#-#--#-#--#-#--#-#--#-#--#-#--#-#--#-#
--#----#----#----#----#----#----#----#----#----#----#----#----#----#----#----#----#----#----#----#--
#----#----#----#----#----#----#----#----#----#----#----#----#----#----#----#----#----#----#----#----
----#----#----#----#----#----#----#----#----#----#----#----#----#----#----#----#----#----#----#----#
-#-#--#-#--#-#--#-#--#-#--#-#--#-#--#-#--#-#--#-#--#-#--#-#--#-#--#-#--#-#--#-#--#-#--#-#--#-#--#-#-
--#-#--#-#--#-#--#-#--#-#--#-#--#-#--#-#--#-#--#-#--#-#--#-#--#-#--#-#--#-#--#-#--#-#--#-#--#-#--#-#
--#----#----#----#----#----#----#----#----#----#----#----#----#----#----#----#----#----#----#----#--
#----#----#----#----#----#----#----#----#----#----#----#----#----#----#----#----#----#----#----#----
----#----#----#----#----#----#----#----#----#----#----#----#----#----#----#----#----#----#----#----#
-#-#--#-#--#-#--#-#--#-#--#-#--#-#--#-#--#-#--#-#--#-#--#-#--#-#--#-#--#-#--#-#--#-#--#-#--#-#--#-#-
--#-#--#-#--#-#--#-#--#-#--#-#--#-#--#-#--#-#--#-#--#-#--#-#--#-#--#-#--#-#--#-#--#-#--#-#--#-#--#-#
--#----#----#----#----#----#----#----#----#----#----#----#----#----#----#----#----#----#----#----#--
#----#----#----#----#----#----#----#----#----#----#----#----#----#----#----#----#----#----#----#----
----#----#----#----#----#----#----#----#----#----#----#----#----#----#----#----#----#----#----#----#
-#-#--#-#--#-#--#-#--#-#--#-#--#-#--#-#--#-#--#-#--#-#--#-#--#-#--#-#--#-#--#-#--#-#--#-#--#-#--#-#-
--#-#--#-#--#-#--#-#--#-#--#-#--#-#--#-#--#-#--#-#--#-#--#-#--#-#--#-#--#-#--#-#--#-#--#-#--#-#--#-#
--#----#----#----#----#----#----#----#----#----#----#----#----#----#----#----#----#----#----#----#--
#----#----#----#----#----#----#----#----#----#----#----#----#----#----#----#----#----#----#----#----
----#----#----#----#----#----#----#----#----#----#----#----#----#----#----#----#----#----#----#----#
-#-#--#-#--#-#--#-#--#-#--#-#--#-#--#-#--#-#--#-#--#-#--#-#--#-#--#-#--#-#--#-#--#-#--#-#--#-#--#-#-
--#-#--#-#--#-#--#-#--#-#--#-#--#-#--#-#--#-#--#-#--#-#--#-#--#-#--#-#--#-#--#-#--#-#--#-#--#-#--#-#
--#----#----#----#----#----#----#----#----#----#----#----#----#----#----#----#----#----#----#----#--
#----#----#----#----#----#----#----#----#----#----#----#----#----#----#----#----#--S-#----#----#----
----#----#----#----#----#----#----#----#----#----#----#----#----#----#----#----#----#----#----#----#
-#-#--#-#--#-#--#-#--#-#--#-#--#-#--#-#--#-#--#-#--#-#--#-#--#-#--#-#--#-#--#-#--#-#--#-#--#-#--#-#-
--#-#--#-#--#-#--#-#--#-#--#-#--#-#--#-#--#-#--#-#--#-#--#-#--#-#--#-#--#-#--#-#--#-#--#-#--#-#--#-#
--#----#----#----#----#----#----#----#----#----#----#----#----#----#----#----#----#----#----#----#--
#----#----#----#----#----#----#----#----#----#----#----#----#----#----#----#----#----#----#----#----
----#----#----#----#----#----#----#----#----#----#----#----#----#----#----#----#----#----#----#----#
-#-#--#-#--#-#--#-#--#-#--#-#--#-#--#-#--#-#--#-#--#-#--#-#--#-#--#-#--#-#--#-#--#-#--#-#--#-#--#-#-
--#-#--#-#--#-#--#-#--#-#--#-#--#-#--#-#--#-#--#-#--#-#--#-#--#-#--#-#--#-#--#-#--#-#--#-#--#-#--#-#
--#----#----#----#----#----#----#----#----#----#----#----#----#----#----#----#----#----#----#----#--
#----#----#----#----#----#----#----#----#----#----#----#----#----#----#----#----#----#----#----#----
----#----#----#----#----#----#----#----#----#----#----#----#----#----#----#----#----#----#----#----#
-#-#--#-#--#-#--#-#--#-#--#-#--#-#--#-#--#-#--#-#--#-#--#-#--#-#--#-#--#-#--#-#--#-#--#-#--#-#--#-#-
--#-#--#-#--#-#--#-#--#-#--#-#--#-#--#-#--#-#--#-#--#-#--#-#--#-#--#-#--#-#--#-#--#-#--#-#--#-#--#-#
--#----#----#----#----#----#----#----#----#----#----#----#----#----#----#----#----#----#----#----#--
#----#----#----#----#----#----#----#----#----#----#----#----#----#----#----#----#----#----#----#----
----#----#----#----#----#----#----#----#----#----#----#----#----#----#----#----#----#----#----#----#
-#-#--#-#--#-#--#-#--#-#--#-#--#-#--#-#--#-#--#-#--#-#--#-#--#-#--#-#--#-#--#-#--#-#--#-#--#-#--#-#-
--#-#--#-#--#-#--#-#--#-#--#-#--#-#--#-#--#-#--#-#--#-#--#-#--#-#--#-#--#-#--#-#--#-#--#-#--#-#--#-#
--#----#----#----#----#----#----#----#----#----#----#----#----#----#----#----#----#----#----#----#--