?diagonal=OnlyWhenNoObstacles;
#--#-#--#-#--#-#--#-#--#-#--#-#--#-#--#-#--#-#--#-#--#-#--#-#--#-#--#-#--#-#--#-#--#-#--#-#--#-#--#-
---#----#----#----#----#----#----#----#----#----#----#----#----#----#----#----#----#----#----#----#-
--###--###--###--###--###--###--###--###--###--###--###--###--###--###--###--###--###--###--###--###
--#----#----#----#----#----#----#----#----#----#----#----#----#----#----#----#----#----#----#----#--
----#----#----#----#----#----#----#----#----#----#----#----#----#----#----#----#----#----#----#----#
#--#-#--#-#--#-#--#-#--#-#--#-#--#-#--#-#--#-#--#-#--#-#--#-#--#-#--#-#--#-#--#-#--#-#--#-#--#-#--#-
---#----#----#----#----#----#----#----#----#----#----#----#----#----#----#----#----#----#----#----#-
--###--###--###--###--###--###--###--###--###--###--###--###--###--###--###--###--###--###--###--###
--#----#----#----#----#----#----#----#----#----#----#----#----#----#----#----#----#----#----#----#--
----#----#----#----#----#----#----#----#----#----#----#----#----#----#----#----#----#----#----#----#
#--#-#--#-#--#-#--#-#--#-#--#-#--#-#--#-#--#-#--#-#--#-#--#-#--#-#--#-#--#-#E-#-#--#-#--#-#--#-#--#-
---#----#----#----#----#----#----#----#----#----#----#----#----#----#----#----#----#----#----#----#-
--###--###--###--###--###--###--###--###--###--###--###--###--###--###--###--###--###--###--###--###
--#----#----#----#----#----#----#----#----#----#----#----#----#----#----#----#----#----#----#----#--
----#----#----#----#----#----#----#----#----#----#----#----#----#----#----#----#----#----#----#----#
#--#-#--#-#--#-#--#-#--#-#--#-#--#-#--#-#--#-#--#-#--#-#--#-#--#-#--#-#--#-#--#-#--#-#--#-#--#-#--#-
---#----#----#----#----#----#----#----#----#----#----#----#----#----#----#----#----#----#----#----#-
--###--###--###--###--###--###--###--###--###--###--###--###--###--###--###--###--###--###--###--###
--#----#----#----#----#----#----#----#----#----#----#----#----#----#----#----#----#----#----#----#--
----#----#----#----#----#----#----#----#----#----#----#----#----#----#----#----#----#----#----#----#
#--#-#--#-#--#-#--#-#--#-#--#-#--#-#--#-#--#-#--#-#--#-#--#-#--#-#--#-#--#-#--#-#--#-#--#-#--#-#--#-
---#----#----#----#----#----#----#----#----#----#----#----#----#----#----#----#----#----#----#----#-
--###--###--###--###--###--###--###--###--###--###--###--###--###--###--###--###--###--###--###--###
--#----#----#----#----#----#----#----#----#----#----#----#----#----#----#----#----#----#----#----#--
----#----#----#----#----#----#----#----#----#----#----#----#----#----#----#----#----#----#----#----#
#--#-#--#-#--#-#--#-#--#-#--#-#--#-#--#-#--#-#--#-#--#-#--#-#--#-#--#-#--#-#--#-#--#-#--#-#--#-#--#-
---#----#----#----#----#----#----#----#----#----#----#----#----#----#----#----#----#----#----#----#-
--###--###--###--###--###--###--###--###--###--###--###--###--###--###--###--###--###--###--###--###
--#----#----#----#----#----#----#----#----#----#----#----#----#----#----#----#----#----#----#----#--
----#----#----#----#----#----#----#----#----#----#----#----#----#----#----#----#----#----#----#----#
#--#-#--#-#--#-#--#-#--#-#--#-#--#-#--#-#--#-#--#-#--#-#--#-#--#-#--#-#--#-#--#-#--#-#--#-#--#-#--#-
---#----#----#----#----#----#----#----#----#----#----#----#----#----#----#----#----#----#----#----#-
--###--###--###--###--###--###--###--###--###--###--###--###--###--###--###--###--###--###--###--###
--#----#----#----#----#----#----#----#----#----#----#----#----#----#----#----#----#----#----#----#--
----#----#----#----#----#----#----#----#----#----#----#----#----#----#----#----#----#----#----#----#
#--#-#--#-#--#-#--#-#--#-#--#-#--#-#--#-#--#-#--#-#--#-#--#-#--#-#--#-#--#-#--#-#--#-#--#-#--#-#--#-
---#----#----#----#----#----#----#----#----#----#----#----#----#----#----#----#----#----#----#----#-
--###--###--###--###--###--###--###--###--###--###--###--###--###--###--###--###--###--###--###--###
--#----#----#----#----#----#----#----#----#----#----#----#----#----#----#----#----#----#----#----#--
----#----#----#----#----#----#----#----#----#----#----#----#----#----#----#----#----#----#----#----#
#--#-#--#-#--#-#--#-#--#-#--#-#--#-#--#-#--#-#--#-#--#-#--#-#--#-#--#-#--#-#--#-#--#-#--#-#--#-#--#-
---#----#----#----#----#----#----#----#----#----#----#----#----#----#----#----#----#----#----#----#-
--###--###--###--###--###--###--###--###--###--###--###--###--###--###--###--###--###--###--###--###
--#----#----#----#----#----#----#----#----#----#----#----#----#----#----#----#----#----#----#----#--
----#----#----#----#----#----#----#----#----#----#----#----#----#----#----#----#----#----#----#----#
#--#-#--#-#--#-#--#-#--#-#--#-#--#-#--#-#--#-#--#-#--#-#--#-#--#-#--#-#--#-#--#-#--#-#--#-#--#-#--#-
---#----#----#----#----#----#----#----#----#----#----#----#----#----#----#----#----#----#----#----#-
--###--###--###--###--###--###--###--###--###--###--###--###--###--###--###--###--###--###--###--###
--#----#----#----#----#----#----#----#----#----#----#----#----#----#----#----#----#----#----#----#--
----#----#----#----#----#----#----#----#----#----#----#----#----#----#----#----#----#----#----#----#
#--#-#--#-#--#-#--#-#--#-#--#-#--#-#--#-#--#-#--#-#--#-#--#-#--#-#--#-#--#-#--#-#--#-#--#-#--#-#--#-
---#----#----#----#----#----#----#----#----#----#----#----#----#----#----#----#----#----#----#----#-
--###--###--###--###--###--###--###--###--###--###--###--###--###--###--###--###--###--###--###--###
--#----#----#----#----#----#----#----#----#----#----#----#----#----#----#----#----#----#----#----#--
----#----#----#----#----#----#----#----#----#----#----#----#----#----#----#----#----#----#----#----#
#--#-#--#-#--#-#--#-#--#-#--#-#--#-#--#-#--#-#--#-#--#-#--#-#--#-#--#-#--#-#--#-#--#-#--#-#--#-#--#-
---#----#----#----#----#----#----#----#----#----#----#----#----#----#----#----#----#----#----#----#-
--###--###--###--###--###--###--###--###--###--###--###--###--###--###--###--###--###--###--###--###
--#----#----#----#----#----#----#----#----#----#----#----#----#----#----#----#----#----#----#----#--
----#----#----#----#----#----#----#----#----#----#----#----#----#----#----#----#----#----#----#----#
#--#-#--#-#--#-#--#-#--#-#--#-#--#-#--#-#--#-#--#-#--#-#--#-#--#-#--#-#--#-#--#-#--#-#--#-#--#-#--#-
---#----#----#----#----#----#----#----#----#----#----#----#----#----#----#----#----#----#----#----#-
--###--###--###--###--###--###--###--###--###--###--###--###--###--###--###--###--###--###--###--###
--#----#----#----#----#----#----#----#----#----#----#----#----#----#----#----#----#----#----#----#--
----#----#----#----#----#----#----#----#----#----#----#----#----#----#----#----#----#----#----#----#
#--#-#--#-#--#-#--#-#--#-#--#-#--#-#--#-#--#-#--#-#--#-#--#-#--#-#--#-#--#-#--#-#--#-#--#-#--#-#--#-
---#----#----#----#----#----#----#----#----#----#----#----#----#----#----#----#----#----#----#----#-
--###--###--###--###--###--###--###--###--###--###--###--###--###--###--###--###--###--###--###--###
--#----#----#----#----#----#----#----#----#----#----#----#----#----#----#----#----#----#----#----#--
----#----#----#----#----#----#----#----#----#----#----#----#----#----#----#----#----#----#----#----#
#--#-#--#-#--#-#--#-#--#-#--#-#--#-#--#-#--#-#--#-#--#-#--#-#--#-#--#-#--#-#--#-#--#-#--#-#--#-#--#-
---#----#----#----#----#----#----#----#----#----#----#----#----#----#----#----#----#----#----#----#-
--###--###--###--###--###--###--###--###--###--###--###--###--###--###--###--###--###--###--###--###
--#----#----#----#----#----#----#----#----#----#----#----#----#----#----#----#----#----#----#----#--
----#----#----#----#----#----#----#----#----#----#----#----#----#----#----#----#----#----#----#----#
#--#-#--#-#--#-#--#-#--#-#--#-#--#-#--#-#--#-#--#-#--#-#--#-#--#-#--#-#--#-#--#-#--#-#--#-#--#-#--#-
---#----#----#----#----#----#----#----#----#----#----#----#----#----#----#----#----#----#----#----#-
--###--###--###--###--###--###--###--###--###--###--###--###--###--###--###--###--###--###--###--###
--#----#----#----#----#----#----#----#----#----#----#----#----#----#----#----#----#----#----#----#--
----#----#----#----#----#----#----#----#----#----#----#----#----#----#----#----#----#----#----#----#
#--#-#--#-#--#-#--#-#--#-#--#-#--#-#--#-#--#-#--#-#--#-#--#-#--#-#--#-#--#-#--#-#--#-#--#-#--#-#--#-
---#----#----#----#----#----#----#----#----#----#----#----#----#----#----#----#----#----#----#----#-
--###--###--###--###--###--###--###--###--###--###--###--###--###--###--###--###--###--###--###--###
--#----#----#----#----#----#----#----#----#----#----#----#----#----#----#----#----#----#----#----#--
----#----#----#----#----#----#----#----#----#----#----#----#----#----#----#----#----#----#----#----#
#--#-#--#-#--#-#--#-#--#-#--#-#--#-#--#-#--#-#--#-#--#-#--#-#--#-#--#-#--#-#--#-#--#-#--#-#--#-#--#-
---#----#----#----#----#----#----#----#----#----#----#----#----#----#----#----#----#----#----#----#-
--###--###--###--###--###--###--###--###--###--###--###--###--###--###--###--###--###--###--###--###
--#----#----#----#----#----#----#----#----#----#----#----#----#----#----#----#----#----#----#----#--
----#----#----#----#----#----#----#----#----#----#----#----#----#----#----#----#----#----#----#----#
#--#-#--#-#--#-#--#-#--#-#--#-#--#-#--#-#--#-#--#-#--#-#--#-#--#-#--#-#--#-#--#-#--#-#--#-#--#-#--#-
---#----#----#----#----#----#----#----#----#----#----#----#----#----#----#----#----#----#S---#----#-
--###--###--###--###--###--###--###--###--###--###--###--###--###--###--###--###--###--###--###--###
--#----#----#----#----#----#----#----#----#----#----#----#----#----#----#----#----#----#----#----#--
----#----#----#----#----#----#----#----#----#----#----#----#----#----#----#----#----#----#----#----#
#--#-#--#-#--#-#--#-#--#-#--#-#--#-#--#-#--#-#--#-#--#-#--#-#--#-#--#-#--#-#--#-#--#-#--#-#--#-#--#-
---#----#----#----#----#----#----#----#----#----#----#----#----#----#----#----#----#----#----#----#-
--###--###--###--###--###--###--###--###--###--###--###--###--###--###--###--###--###--###--###--###
--#----#----#----#----#----#----#----#----#----#----#----#----#----#----#----#----#----#----#----#--
----#----#----#----#----#----#----#----#----#----#----#----#----#----#----#----#----#----#----#----#