?diagonal=OnlyWhenNoObstacles;
-##---##---##---##---##---##---##---##---##---##---##---##---##---##---##---##---##---##---##---##--
-#----#----#----#----#----#----#----#----#----#----#----#----#----#----#----#----#----#----#----#---
---##---##---##---##---##---##---##---##---##---##---##---##---##---##---##---##---##---##---##---##
----------------------------------------------------------------------------------------------------
-#----#----#----#----#----#----#----#----#----#----#----#----#----#----#----#----#----#----#----#---
-##---##---##---##---##---##---##---##---##---##---##---##---##---##---##---##---##---##---##---##--
-#--E-#----#----#----#----#----#----#----#----#----#----#----#----#----#----#----#----#----#----#---
---##---##---##---##---##---##---##---##---##---##---##---##---##---##---##---##---##---##---##---##
----------------------------------------------------------------------------------------------------
-#----#----#----#----#----#----#----#----#----#----#----#----#----#----#----#----#----#----#----#---
-##---##---##---##---##---##---##---##---##---##---##---##---##---##---##---##---##---##---##---##--
-#----#----#----#----#----#----#----#----#----#----#----#----#----#----#----#----#----#----#----#---
---##---##---##---##---##---##---##---##---##---##---##---##---##---##---##---##---##---##---##---##
----------------------------------------------------------------------------------------------------
-#----#----#----#----#----#----#----#----#----#----#----#----#----#----#----#----#----#----#----#---
-##---##---##---##---##---##---##---##---##---##---##---##---##---##---##---##---##---##---##---##--
-#----#----#----#----#----#----#----#----#----#----#----#----#----#----#----#----#----#----#----#---
---##---##---##---##---##---##---##---##---##---##---##---##---##---##---##---##---##---##---##---##
----------------------------------------------------------------------------------------------------
-#----#----#----#----#----#----#----#----#----#----#----#----#----#----#----#----#----#----#----#---
-##---##---##---##---##---##---##---##---##---##---##---##---##---##---##---##---##---##---##---##--
-#----#----#----#----#----#----#----#----#----#----#----#----#----#----#----#----#----#----#----#---
---##---##---##---##---##---##---##---##---##---##---##---##---##---##---##---##---##---##---##---##
----------------------------------------------------------------------------------------------------
-#----#----#----#----#----#----#----#----#----#----#----#----#----#----#----#----#----#----#----#---
-##---##---##---##---##---##---##---##---##---##---##---##---##---##---##---##---##---##---##---##--
-#----#----#----#----#----#----#----#----#----#----#----#----#----#----#----#----#----#----#----#---
---##---##---##---##---##---##---##---##---##---##---##---##---##---##---##---##---##---##---##---##
----------------------------------------------------------------------------------------------------
-#----#----#----#----#----#----#----#----#----#----#----#----#----#----#----#----#----#----#----#---
-##---##---##---##---##---##---##---##---##---##---##---##---##---##---##---##---##---##---##---##--
-#----#----#----#----#----#----#----#----#----#----#----#----#----#----#----#----#----#----#----#---
---##---##---##---##---##---##---##---##---##---##---##---##---##---##---##---##---##---##---##---##
----------------------------------------------------------------------------------------------------
-#----#----#----#----#----#----#----#----#----#----#----#----#----#----#----#----#----#----#----#---
-##---##---##---##---##---##---##---##---##---##---##---##---##---##---##---##---##---##---##---##--
-#----#----#----#----#----#----#----#----#----#----#----#----#----#----#----#----#----#----#----#---
---##---##---##---##---##---##---##---##---##---##---##---##---##---##---##---##---##---##---##---##
----------------------------------------------------------------------------------------------------
-#----#----#----#----#----#----#----#----#----#----#----#----#----#----#----#----#----#----#----#---
-##---##---##---##---##---##---##---##---##---##---##---##---##---##---##---##---##---##---##---##--
-#----#----#----#----#----#----#----#----#----#----#----#----#----#----#----#----#----#----#----#---
---##---##---##---##---##---##---##---##---##---##---##---##---##---##---##---##---##---##---##---##
----------------------------------------------------------------------------------------------------
-#----#----#----#----#----#----#----#----#----#----#----#----#----#----#----#----#----#----#----#---
-##---##---##---##---##---##---##---##---##---##---##---##---##---##---##---##---##---##---##---##--
-#----#----#----#----#----#----#----#----#----#----#----#----#----#----#----#----#----#----#----#---
---##---##---##---##---##---##---##---##---##---##---##---##---##---##---##---##---##---##---##---##
----------------------------------------------------------------------------------------------------
-#----#----#----#----#----#----#----#----#----#----#----#----#----#----#----#----#----#----#----#---
-##---##---##---##---##---##---##---##---##---##---##---##---##---##---##---##---##---##---##---##--
-#----#----#----#----#----#----#----#----#----#----#----#----#----#----#----#----#----#----#----#---
---##---##---##---##---##---##---##---##---##---##---##---##---##---##---##---##---##---##---##---##
----------------------------------------------------------------------------------------------------
-#----#----#----#----#----#----#----#----#----#----#----#----#----#----#----#----#----#----#----#---
-##---##---##---##---##---##---##---##---##---##---##---##---##---##---##---##---##---##---##---##--
-#----#----#----#----#----#----#----#----#----#----#----#----#----#----#----#----#----#----#----#---
---##---##---##---##---##---##---##---##---##---##---##---##---##---##---##---##---##---##---##---##
----------------------------------------------------------------------------------------------------
-#----#----#----#----#----#----#----#----#----#----#----#----#----#----#----#----#----#----#----#---
-##---##---##---##---##---##---##---##---##---##---##---##---##---##---##---##---##---##---##---##--
-#----#----#----#----#----#----#----#----#----#----#----#----#----#----#----#----#----#----#----#---
---##---##---##---##---##---##---##---##---##---##---##---##---##---##---##---##---##---##---##---##
----------------------------------------------------------------------------------------------------
-#----#----#----#----#----#----#----#----#----#----#----#----#----#----#----#----#----#----#----#---
-##---##---##---##---##---##---##---##---##---##---##---##---##---##---##---##---##---##---##---##--
-#----#----#----#----#----#----#----#----#----#----#----#----#----#----#----#----#----#----#----#---
---##---##---##---##---##---##---##---##---##---##---##---##---##---##---##---##---##---##---##---##
----------------------------------------------------------------------------------------------------
-#----#----#----#----#----#----#----#----#----#----#----#----#----#----#----#----#----#----#----#---
-##---##---##---##---##---##---##---##---##---##---##---##---##---##---##---##---##---##---##---##--
-#----#----#----#----#----#----#----#----#----#----#----#----#----#----#----#----#----#----#----#---
---##---##---##---##---##---##---##---##---##---##---##---##---##---##---##---##---##---##---##---##
----------------------------------------------------------------------------------------------------
-#----#----#----#----#----#----#----#----#----#----#----#----#----#----#----#----#----#----#----#---
-##---##---##---##---##---##---##---##---##---##---##---##---##---##---##---##---##---##---##---##--
-#----#----#----#----#----#----#----#----#----#----#----#----#----#----#----#----#----#----#----#---
---##---##---##---##---##---##--S##---##---##---##---##---##---##---##---##---##---##---##---##---##
----------------------------------------------------------------------------------------------------
-#----#----#----#----#----#----#----#----#----#----#----#----#----#----#----#----#----#----#----#---
-##---##---##---##---##---##---##---##---##---##---##---##---##---##---##---##---##---##---##---##--
-#----#----#----#----#----#----#----#----#----#----#----#----#----#----#----#----#----#----#----#---
---##---##---##---##---##---##---##---##---##---##---##---##---##---##---##---##---##---##---##---##
----------------------------------------------------------------------------------------------------
-#----#----#----#----#----#----#----#----#----#----#----#----#----#----#----#----#----#----#----#---
-##---##---##---##---##---##---##---##---##---##---##---##---##---##---##---##---##---##---##---##--
-#----#----#----#----#----#----#----#----#----#----#----#----#----#----#----#----#----#----#----#---
---##---##---##---##---##---##---##---##---##---##---##---##---##---##---##---##---##---##---##---##
----------------------------------------------------------------------------------------------------
-#----#----#----#----#----#----#----#----#----#----#----#----#----#----#----#----#----#----#----#---
-##---##---##---##---##---##---##---##---##---##---##---##---##---##---##---##---##---##---##---##--
-#----#----#----#----#----#----#----#----#----#----#----#----#----#----#----#----#----#----#----#---
---##---##---##---##---##---##---##---##---##---##---##---##---##---##---##---##---##---##---##---##
----------------------------------------------------------------------------------------------------
-#----#----#----#----#----#----#----#----#----#----#----#----#----#----#----#----#----#----#----#---
-##---##---##---##---##---##---##---##---##---##---##---##---##---##---##---##---##---##---##---##--
-#----#----#----#----#----#----#----#----#----#----#----#----#----#----#----#----#----#----#----#---
---##---##---##---##---##---##---##---##---##---##---##---##---##---##---##---##---##---##---##---##
----------------------------------------------------------------------------------------------------
-#----#----#----#----#----#----#----#----#----#----#----#----#----#----#----#----#----#----#----#---