?diagonal=OnlyWhenNoObstacles;
----------------------------------------------------------------------------------------------------
-#--#-#--#-#--#-#--#-#--#-#--#-#--#-#--#-#--#-#--#-#--#-#--#-#--#-#--#-#--#-#--#-#--#-#--#-#--#-#--#
---##---##---##---##---##---##---##---##---##---##---##---##---##---##---##---##---##---##---##---##
---##---##---##---##---##---##---##---##---##---##---##---##---##---##---##---##---##---##---##---##
--##---##---##---##---##---##---##---##---##---##---##---##---##---##---##---##---##---##---##---##-
----------------------------------------------------------------------------------------------------
-#--#-#--#-#--#-#--#-#--#-#--#-#--#-#--#-#--#-#--#-#--#-#--#-#--#-#--#-#--#-#--#-#--#-#--#-#--#-#--#
---##---##---##---##---##---##---##---##---##---##---##---##---##---##---##---##---##---##---##---##
---##---##---##---##---##---##---##---##---##---##---##---##---##---##---##---##---##---##---##---##
--##---##---##---##---##---##---##---##---##---##---##---##---##---##---##---##---##---##---##---##-
----------------------------------------------------------------------------------------------------
-#--#-#--#-#--#-#--#-#--#-#--#-#--#-#--#-#--#-#--#-#--#-#--#-#--#-#--#-#--#-#--#-#--#-#--#-#--#-#--#
---##---##---##---##---##---##---##---##---##---##---##---##---##---##---##---##---##---##---##---##
---##---##---##---##---##---##---##---##---##---##---##---##---##---##---##---##---##---##---##---##
--##---##---##---##---##---##---##---##---##---##---##---##---##---##---##---##---##---##---##---##-
----------------------------------------------------------------------------------------------------
-#--#-#--#-#--#-#--#-#--#-#--#-#--#-#--#-#--#-#--#-#--#-#--#-#--#-#--#-#--#-#--#-#--#-#--#-#--#-#--#
---##---##---##---##---##---##---##---##---##---##---##---##---##---##---##---##---##---##---##---##
---##---##---##---##---##---##---##---##---##---##---##---##---##---##---##---##---##---##---##---##
--##---##---##---##---##---##---##---##---##---##---##---##---##---##---##---##---##---##S--##---##-
----------------------------------------------------------------------------------------------------
-#--#-#--#-#--#-#--#-#--#-#--#-#--#-#--#-#--#-#--#-#--#-#--#-#--#-#--#-#--#-#--#-#--#-#--#-#--#-#--#
---##---##---##---##---##---##---##---##---##---##---##---##---##---##---##---##---##---##---##---##
---##---##---##---##---##---##---##---##---##---##---##---##---##---##---##---##---##---##---##---##
--##---##---##---##---##---##---##---##---##---##---##---##---##---##---##---##---##---##---##---##-
----------------------------------------------------------------------------------------------------
-#--#-#--#-#--#-#--#-#--#-#--#-#--#-#--#-#--#-#--#-#--#-#--#-#--#-#--#-#--#-#--#-#--#-#--#-#--#-#--#
---##---##---##---##---##---##---##---##---##---##---##---##---##---##---##---##---##---##---##---##
---##---##---##---##---##---##---##---##---##---##---##---##---##---##---##---##---##---##---##---##
--##---##---##---##---##---##---##---##---##---##---##---##---##---##---##---##---##---##---##---##-
----------------------------------------------------------------------------------------------------
-#--#-#--#-#--#-#--#-#--#-#--#-#--#-#--#-#--#-#--#-#--#-#--#-#--#-#--#-#--#-#--#-#--#-#--#-#--#-#--#
---##---##---##---##---##---##---##---##---##---##---##---##---##---##---##---##---##---##---##---##
---##---##---##---##---##---##---##---##---##---##---##---##---##---##---##---##---##---##---##---##
--##---##---##---##---##---##---##---##---##---##---##---##---##---##---##---##---##---##---##---##-
----------------------------------------------------------------------------------------------------
-#--#-#--#-#--#-#--#-#--#-#--#-#--#-#--#-#--#-#--#-#--#-#--#-#--#-#--#-#--#-#--#-#--#-#--#-#--#-#--#
---##---##---##---##---##---##---##---##---##---##---##---##---##---##---##---##---##---##---##---##
---##---##---##---##---##---##---##---##---##---##---##---##---##---##---##---##---##---##---##---##
--##---##---##---##---##---##---##---##---##---##---##---##---##---##---##---##---##---##---##---##-
----------------------------------------------------------------------------------------------------
-#--#-#--#-#--#-#--#-#--#-#--#-#--#-#--#-#--#-#--#-#--#-#--#-#--#-#--#-#--#-#--#-#--#-#--#-#--#-#--#
---##---##---##---##---##---##---##---##---##---##---##---##---##---##---##---##---##---##---##---##
---##---##---##---##---##---##---##---##---##---##---##---##---##---##---##---##---##---##---##---##
--##---##---##---##---##---##---##---##---##---##---##---##---##---##---##---##---##---##---##---##-
----------------------------------------------------------------------------------------------------
-#--#-#--#-#--#-#--#-#--#-#--#-#--#-#--#-#--#-#--#-#--#-#--#-#--#-#--#-#--#-#--#-#--#-#--#-#--#-#--#
---##---##---##---##---##---##---##---##---##---##---##---##---##---##---##---##---##---##---##---##
---##---##---##---##---##---##---##---##---##---##---##---##---##---##---##---##---##---##---##---##
--##---##---##---##---##---##---##---##---##---##---##---##---##---##---##---##---##---##---##---##-
----------------------------------------------------------------------------------------------------
-#--#-#--#-#--#-#--#-#--#-#--#-#--#-#--#-#--#-#--#-#--#-#--#-#--#-#--#-#--#-#--#-#--#-#--#-#--#-#--#
---##---##---##---##---##---##---##---##---##---##---##---##---##---##---##---##---##---##---##---##
---##---##---##---##---##---##---##---##---##---##---##---##---##---##---##---##---##---##---##---##
--##---##---##---##---##---##---##---##---##---##---##---##---##---##---##---##---##---##---##---##-
----------------------------------------------------------------------------------------------------
-#--#-#--#-#--#-#--#-#--#-#--#-#--#-#--#-#--#-#--#-#--#-#--#-#--#-#--#-#--#-#--#-#--#-#--#-#--#-#--#
---##---##---##---##---##---##---##---##---##---##---##---##---##---##---##---##---##---##---##---##
---##---##---##---##---##---##---##---##---##---##---##---##---##---##---##---##---##---##---##---##
--##---##---##---##---##---##---##---##---##---##---##---##---##---##---##---##---##---##---##---##-
----------------------------------------------------------------------------------------------------
-#--#-#--#-#--#-#--#-#--#-#--#-#--#-#--#-#--#-#--#-#--#-#--#-#--#-#--#-#--#-#--#-#--#-#--#-#--#-#--#
---##---##---##---##---##---##---##---##---##---##---##---##---##---##---##---##---##---##---##---##
---##---##---##---##---##---##---##---##---##---##---##---##---##---##---##---##---##---##---##---##
--##---##---##---##---##---##---##---##---##---##---##---##---##---##---##---##---##---##---##---##-
----------------------------------------------------------------------------------------------------
-#--#-#--#-#--#-#--#-#--#-#--#-#--#-#--#-#--#-#--#-#--#-#--#-#--#-#--#-#--#-#--#-#--#-#--#-#--#-#--#
---##---##---##---##---##---##---##---##---##---##---##---##---##---##---##---##---##---##---##---##
---##---##---##---##---##---##---##---##---##---##---##---##---##---##---##---##---##---##---##---##
--##---##---##---##---##---##---##---##---##---##---##---##---##---##---##---##---##---##---##---##-
----------------------------------------------------------------------------------------------------
-#--#-#--#-#--#-#--#-#--#-#--#-#--#-#--#-#--#-#--#-#--#-#--#-#--#-#--#-#--#-#--#-#--#-#--#-#--#-#--#
---##---##---##---##---##---##---##---##---##---##---##---##---##---##---##---##---##---##---##---##
---##---##---##---##---##---##---##---##---##---##---##---##---##---##---##---##---##---##---##---##
--##---##---##---##---##---##---##---##---##---##---##---##---##---##---##---##---##---##---##---##-
----------------------------------------------------------------------------------------------------
-#--#-#--#-#--#-#--#-#--#-#--#-#--#-#--#-#--#-#--#-#--#-#--#-#--#-#--#-#--#-#--#-#--#-#--#-#--#-#--#
---##---##---##---##---##---##---##---##---##---##---##---##---##---##---##---##---##---##---##---##
---##---##---##---##---##---##---##---##---##---##---##---##---##---##---##---##---##---##---##---##
--##---##---##---##---##---##---##---##---##---##---##---##---##---##---##---##---##---##---##---##-
----------------------------------------------------------------------------------------------------
-#--#-#--#-#--#-#--#-#--#-#--#-#--#-#--#-#--#-#--#-#--#-#--#-#--#-#--#-#--#-#--#-#--#-#--#-#--#-#--#
---##---##---##---##---##---##---##---##---##---##---##---##---##---##---##---##---##---##---##---##
---##---##---##---##---##---##---##---##---##---##---##---##---##---##---##---##---##---##---##---##
--##---##---##---##---##---##---##---##---##---##---##---##---##---##---##---##---##---##---##---##-
----------------------------------------------------------------------------------------------------
-#--#-#--#-#--#-#--#-#--#-#--#-#--#-#--#-#--#-#--#-#--#-#--#-#--#-#--#-#--#-#--#-#--#-#--#-#--#-#--#
---##---##---##---##---##---##---##---##---##---##---##---##---##---##---##---##---##---##---##---##
---##---##---##---##---##---##---##---##---##---##---##---##---##---##---##---##---##---##---##---##
--##---##---##---##---##---##---##---##---##---##---##---##---##---##---##---##---##---##---##---##-
----------------------------------------------------------------------------------------------------
-#--#-#--#-#--#-#--#-#--#-#--#-#--#-#--#-#--#-#--#-#--#-#--#-#--#-#--#-#--#-#--#-#--#-#--#-#--#-#--#
---##---##---##---##---##---##---##---##---##---##---##---##---##---##---##---##---##---##---##---##
---##---##---##---##---##---##---##---##---##---##---##---##---##---##---##---##---##---##---##---##
--##---##---##---##---##---##---##---##---##---##---##---##---##---##---##---##---##---##---##---##-
----------------------------------------------------------------------------------------------------
-#--#-#--#-#--#-#--#-#--#-#--#-#--#-#--#-#--#-#--#-#--#-#--#-#--#-#--#-#--#-#--#-#--#-#--#-#--#-#--#
---##---##---##---##---##---##---##---##---##---##---##---##---##---##---##---##---##---##---##---##
---##---##---##---##---##---##---##---##---##---##---##---##---##---##---##---##---##---##---##---##
--##---##E--##---##---##---##---##---##---##---##---##---##---##---##---##---##---##---##---##---##-