?diagonal=OnlyWhenNoObstacles;
#----#----#----#----#----#----#----#----#----#----#----#----#----#----#----#----#----#----#----#----
-#--#-#--#-#--#-#--#-#--#-#--#-#--#-#--#-#--#-#--#-#--#-#--#-#--#-#--#-#--#-#--#-#--#-#--#-#--#-#--#
---##---##---##---##---##---##---##---##---##---##---##---##---##---##---##---##---##---##---##---##
#----#----#----#----#----#----#----#----#----#----#----#----#----#----#----#----#----#----#----#----
--#----#----#----#----#----#----#----#----#----#----#----#----#----#----#----#----#----#----#----#--
#----#----#----#----#----#----#----#----#----#----#----#----#----#----#----#----#----#----#----#----
-#--#-#--#-#--#-#--#-#--#-#--#-#--#-#--#-#--#-#--#-#--#-#--#-#--#-#--#-#--#-#--#-#--#-#--#-#--#-#--#
---##---##---##---##---##---##---##---##---##---##---##---##---##---##---##---##---##---##---##---##
#----#----#----#----#----#----#----#----#----#----#----#----#----#----#----#----#----#----#----#----
--#----#----#----#----#----#----#----#----#----#----#----#----#----#----#----#----#----#----#----#--
#----#----#----#----#----#----#----#----#----#----#----#----#----#----#----#----#----#----#----#----
-#--#-#--#-#--#-#--#-#--#-#--#-#--#-#--#-#--#-#--#-#--#-#--#-#--#-#--#-#--#-#--#-#--#-#--#-#--#-#--#
---##---##---##---##---##---##---##---##---##---##---##---##---##---##---##---##---##---##---##---##
#----#----#----#----#----#----#----#----#----#----#----#----#----#----#----#----#----#----#----#----
--#----#----#----#----#----#--S-#----#----#----#----#----#----#----#----#----#----#----#----#----#--
#----#----#----#----#----#----#----#----#----#----#----#----#----#----#----#----#----#----#----#----
-#--#-#--#-#--#-#--#-#--#-#--#-#--#-#--#-#--#-#--#-#--#-#--#-#--#-#--#-#--#-#--#-#--#-#--#-#--#-#--#
---##---##---##---##---##---##---##---##---##---##---##---##---##---##---##---##---##---##---##---##
#----#----#----#----#----#----#----#----#----#----#----#----#----#----#----#----#----#----#----#----
--#----#----#----#----#----#----#----#----#----#----#----#----#----#----#----#----#----#----#----#--
#----#----#----#----#----#----#----#----#----#----#----#----#----#----#----#----#----#----#----#----
-#--#-#--#-#--#-#--#-#--#-#--#-#--#-#--#-#--#-#--#-#--#-#--#-#--#-#--#-#--#-#--#-#--#-#--#-#--#-#--#
---##---##---##---##---##---##---##---##---##---##---##---##---##---##---##---##---##---##---##---##
#----#----#----#----#----#----#----#----#----#----#----#----#----#----#----#----#----#----#----#----
--#----#----#----#----#----#----#----#----#----#----#----#----#----#----#----#----#----#----#----#--
#----#----#----#----#----#----#----#----#----#----#----#----#----#----#----#----#----#----#----#----
-#--#-#--#-#--#-#--#-#--#-#--#-#--#-#--#-#--#-#--#-#--#-#--#-#--#-#--#-#--#-#--#-#--#-#--#-#--#-#--#
---##---##---##---##---##---##---##---##---##---##---##---##---##---##---##---##---##---##---##---##
#----#----#----#----#----#----#----#----#----#----#----#----#----#----#----#----#----#----#----#----
--#----#----#----#----#----#----#----#----#----#----#----#----#----#----#----#----#----#----#----#--
#----#----#----#----#----#----#----#----#----#----#----#----#----#----#----#----#----#----#----#----
-#--#-#--#-#--#-#--#-#--#-#--#-#--#-#--#-#--#-#--#-#--#-#--#-#--#-#--#-#--#-#--#-#--#-#--#-#--#-#--#
---##---##---##---##---##---##---##---##---##---##---##---##---##---##---##---##---##---##---##---##
#----#----#----#----#----#----#----#----#----#----#----#----#----#----#----#----#----#----#----#----
--#----#----#----#----#----#----#----#----#----#----#----#----#----#----#----#----#----#----#----#--
#----#----#----#----#----#----#----#----#----#----#----#----#----#----#----#----#----#----#----#----
-#--#-#--#-#--#-#--#-#--#-#--#-#--#-#--#-#--#-#--#-#--#-#--#-#--#-#--#-#--#-#--#-#--#-#--#-#--#-#--#
---##---##---##---##---##---##---##---##---##---##---##---##---##---##---##---##---##---##---##---##
#----#----#----#----#----#----#----#----#----#----#----#----#----#----#----#----#----#----#----#----
--#----#----#----#----#----#----#----#----#----#----#----#----#----#----#----#----#----#----#----#--
#----#----#----#----#----#----#----#----#----#----#----#----#----#----#----#----#----#----#----#----
-#--#-#--#-#--#-#--#-#--#-#--#-#--#-#--#-#--#-#--#-#--#-#--#-#--#-#--#-#--#-#--#-#--#-#--#-#--#-#--#
---##---##---##---##---##---##---##---##---##---##---##---##---##---##---##---##---##---##---##---##
#----#----#----#----#----#----#----#----#----#----#----#----#----#----#----#----#----#----#----#----
--#----#----#----#----#----#----#----#----#----#----#----#----#----#----#----#----#----#----#----#--
#----#----#----#----#----#----#----#----#----#----#----#----#----#----#----#----#----#----#----#----
-#--#-#--#-#--#-#--#-#--#-#--#-#--#-#--#-#--#-#--#-#--#-#--#-#--#-#--#-#--#-#--#-#--#-#--#-#--#-#--#
---##---##---##---##---##---##---##---##---##---##---##---##---##---##---##---##---##---##---##---##
#----#----#----#----#----#----#----#----#----#----#----#----#----#----#----#----#----#----#----#----
--#----#----#----#----#----#----#----#----#----#----#----#----#----#----#----#----#----#----#----#--
#----#----#----#----#----#----#----#----#----#----#----#----#----#----#----#----#----#----#----#----
-#--#-#--#-#--#-#--#-#--#-#--#-#--#-#--#-#--#-#--#-#--#-#--#-#--#-#--#-#--#-#--#-#--#-#--#-#--#-#--#
---##---##---##---##---##---##---##---##---##---##---##---##---##---##---##---##---##E--##---##---##
#----#----#----#----#----#----#----#----#----#----#----#----#----#----#----#----#----#----#----#----
--#----#----#----#----#----#----#----#----#----#----#----#----#----#----#----#----#----#----#----#--
#----#----#----#----#----#----#----#----#----#----#----#----#----#----#----#----#----#----#----#----
-#--#-#--#-#--#-#--#-#--#-#--#-#--#-#--#-#--#-#--#-#--#-#--#-#--#-#--#-#--#-#--#-#--#-#--#-#--#-#--#
---##---##---##---##---##---##---##---##---##---##---##---##---##---##---##---##---##---##---##---##
#----#----#----#----#----#----#----#----#----#----#----#----#----#----#----#----#----#----#----#----
--#----#----#----#----#----#----#----#----#----#----#----#----#----#----#----#----#----#----#----#--
#----#----#----#----#----#----#----#----#----#----#----#----#----#----#----#----#----#----#----#----
-#--#-#--#-#--#-#--#-#--#-#--#-#--#-#--#-#--#-#--#-#--#-#--#-#--#-#--#-#--#-#--#-#--#-#--#-#--#-#--#
---##---##---##---##---##---##---##---##---##---##---##---##---##---##---##---##---##---##---##---##
#----#----#----#----#----#----#----#----#----#----#----#----#----#----#----#----#----#----#----#----
--#----#----#----#----#----#----#----#----#----#----#----#----#----#----#----#----#----#----#----#--
#----#----#----#----#----#----#----#----#----#----#----#----#----#----#----#----#----#----#----#----
-#--#-#--#-#--#-#--#-#--#-#--#-#--#-#--#-#--#-#--#-#--#-#--#-#--#-#--#-#--#-#--#-#--#-#--#-#--#-#--#
---##---##---##---##---##---##---##---##---##---##---##---##---##---##---##---##---##---##---##---##
#----#----#----#----#----#----#----#----#----#----#----#----#----#----#----#----#----#----#----#----
--#----#----#----#----#----#----#----#----#----#----#----#----#----#----#----#----#----#----#----#--
#----#----#----#----#----#----#----#----#----#----#----#----#----#----#----#----#----#----#----#----
-#--#-#--#-#--#-#--#-#--#-#--#-#--#-#--#-#--#-#--#-#--#-#--#-#--#-#--#-#--#-#--#-#--#-#--#-#--#-#--#
---##---##---##---##---##---##---##---##---##---##---##---##---##---##---##---##---##---##---##---##
#----#----#----#----#----#----#----#----#----#----#----#----#----#----#----#----#----#----#----#----
--#----#----#----#----#----#----#----#----#----#----#----#----#----#----#----#----#----#----#----#--
#----#----#----#----#----#----#----#----#----#----#----#----#----#----#----#----#----#----#----#----
-#--#-#--#-#--#-#--#-#--#-#--#-#--#-#--#-#--#-#--#-#--#-#--#-#--#-#--#-#--#-#--#-#--#-#--#-#--#-#--#
---##---##---##---##---##---##---##---##---##---##---##---##---##---##---##---##---##---##---##---##
#----#----#----#----#----#----#----#----#----#----#----#----#----#----#----#----#----#----#----#----
--#----#----#----#----#----#----#----#----#----#----#----#----#----#----#----#----#----#----#----#--
#----#----#----#----#----#----#----#----#----#----#----#----#----#----#----#----#----#----#----#----
-#--#-#--#-#--#-#--#-#--#-#--#-#--#-#--#-#--#-#--#-#--#-#--#-#--#-#--#-#--#-#--#-#--#-#--#-#--#-#--#
---##---##---##---##---##---##---##---##---##---##---##---##---##---##---##---##---##---##---##---##
#----#----#----#----#----#----#----#----#----#----#----#----#----#----#----#----#----#----#----#----
--#----#----#----#----#----#----#----#----#----#----#----#----#----#----#----#----#----#----#----#--
#----#----#----#----#----#----#----#----#----#----#----#----#----#----#----#----#----#----#----#----
-#--#-#--#-#--#-#--#-#--#-#--#-#--#-#--#-#--#-#--#-#--#-#--#-#--#-#--#-#--#-#--#-#--#-#--#-#--#-#--#
---##---##---##---##---##---##---##---##---##---##---##---##---##---##---##---##---##---##---##---##
#----#----#----#----#----#----#----#----#----#----#----#----#----#----#----#----#----#----#----#----
--#----#----#----#----#----#----#----#----#----#----#----#----#----#----#----#----#----#----#----#--
#----#----#----#----#----#----#----#----#----#----#----#----#----#----#----#----#----#----#----#----
-#--#-#--#-#--#-#--#-#--#-#--#-#--#-#--#-#--#-#--#-#--#-#--#-#--#-#--#-#--#-#--#-#--#-#--#-#--#-#--#
---##---##---##---##---##---##---##---##---##---##---##---##---##---##---##---##---##---##---##---##
#----#----#----#----#----#----#----#----#----#----#----#----#----#----#----#----#----#----#----#----
--#----#----#----#----#----#----#----#----#----#----#----#----#----#----#----#----#----#----#----#--
#----#----#----#----#----#----#----#----#----#----#----#----#----#----#----#----#----#----#----#----
-#--#-#--#-#--#-#--#-#--#-#--#-#--#-#--#-#--#-#--#-#--#-#--#-#--#-#--#-#--#-#--#-#--#-#--#-#--#-#--#
---##---##---##---##---##---##---##---##---##---##---##---##---##---##---##---##---##---##---##---##
#----#----#----#----#----#----#----#----#----#----#----#----#----#----#----#----#----#----#----#----
--#----#----#----#----#----#----#----#----#----#----#----#----#----#----#----#----#----#----#----#--