?diagonal=OnlyWhenNoObstacles;
--##---##---##---##---##---##---##---##---##---##---##---##---##---##---##---##---##---##---##---##-
---#----#----#----#----#----#----#----#----#----#----#----#----#----#----#----#----#----#----#----#-
--#----#----#----#----#----#----#----#----#----#----#----#----#----#----#----#----#----#----#----#--
#----#----#----#----#----#----#----#----#----#----#----#----#----#----#----#----#----#----#----#----
-#-#--#-#--#-#--#-#--#-#--#-#--#-#--#-#--#-#--#-#--#-#--#-#--#-#--#-#--#-#--#-#--#-#--#-#--#-#--#-#-
--##---##---##---##---##---##---##---##---##---##---##---##---##---##---##---##---##---##---##---##-
---#----#----#----#----#----#----#----#----#----#----#----#----#----#----#----#----#----#----#----#-
--#----#----#----#----#----#----#----#----#----#----#----#----#----#----#----#----#----#----#----#--
#----#----#----#----#----#----#----#----#----#----#----#----#----#----#----#----#----#----#----#----
-#-#--#-#--#-#--#-#--#-#--#-#--#-#--#-#--#-#--#-#--#-#--#-#--#-#--#-#--#-#--#-#--#-#--#-#--#-#--#-#-
--##---##---##---##---##---##---##---##---##---##---##---##---##---##---##---##---##---##---##---##-
---#----#----#----#----#----#----#----#----#----#----#----#----#----#----#----#----#----#----#----#-
--#----#----#----#----#----#----#----#----#----#----#----#----#----#----#----#----#----#----#----#--
#----#----#----#----#----#----#----#----#----#----#----#----#----#----#----#----#----#----#----#----
-#-#--#-#--#-#--#-#--#-#--#-#--#-#--#-#--#-#--#-#--#-#--#-#--#-#--#-#--#-#--#-#--#-#--#-#--#-#--#-#-
--##---##---##---##---##---##---##---##---##---##---##---##---##---##---##---##---##---##---##---##-
---#----#----#----#----#----#----#----#----#----#----#----#----#----#----#----#----#----#----#----#-
--#----#----#----#----#----#----#----#----#----#----#----#----#----#----#----#----#----#----#----#--
#----#----#----#----#----#----#----#----#----#----#----#----#----#----#----#----#----#----#----#----
-#-#--#-#--#-#--#-#--#-#--#-#--#-#--#-#--#-#--#-#--#-#--#-#--#-#--#-#--#-#--#-#--#-#--#-#--#-#--#-#-
--##---##---##---##---##---##---##---##---##---##---##---##---##---##---##---##---##---##---##---##-
---#----#----#----#----#----#----#----#----#----#----#----#----#----#----#----#----#----#----#----#-
--#----#----#----#----#----#----#----#----#----#----#----#----#----#----#----#----#----#----#----#--
#----#----#----#----#----#----#----#----#----#----#----#----#----#----#----#----#----#----#----#----
-#-#--#-#--#-#--#-#--#-#--#-#--#-#--#-#--#-#--#-#--#-#--#-#--#-#--#-#--#-#--#-#--#-#--#-#--#-#--#-#-
--##---##---##---##---##---##---##---##---##---##---##---##---##---##---##---##---##---##---##---##-
---#----#----#----#----#----#----#----#----#----#----#----#----#----#----#----#----#----#----#----#-
--#----#----#----#----#----#----#----#----#----#----#----#----#----#----#----#----#----#----#----#--
#----#----#----#----#----#----#----#----#----#----#----#----#----#----#----#----#----#----#----#----
-#-#--#-#--#-#--#-#--#-#--#-#--#-#--#-#--#-#--#-#--#-#--#-#--#-#--#-#--#-#--#-#--#-#--#-#--#-#--#-#-
--##---##---##---##---##---##---##---##---##---##---##---##---##---##---##---##---##---##---##---##-
---#----#----#----#----#----#----#----#----#----#----#----#----#----#----#----#----#----#----#----#-
--#----#----#----#----#----#----#----#----#----#----#----#----#----#----#----#----#----#----#----#--
#----#----#----#----#----#----#----#----#----#----#----#----#----#----#----#----#----#----#----#----
-#-#--#-#--#-#--#-#--#-#--#-#--#-#--#-#--#-#--#-#--#-#--#-#--#-#--#-#--#-#--#-#--#-#--#-#--#-#--#-#-
--##---##---##---##---##---##---##---##---##---##---##---##---##---##---##---##---##---##---##---##-
---#----#----#----#----#----#----#----#----#----#----#----#----#----#----#----#----#----#----#----#-
--#----#----#----#----#----#----#----#----#----#----#----#----#----#----#----#----#----#----#----#--
#----#----#----#----#----#----#----#----#----#----#----#----#----#----#----#----#----#----#----#----
-#-#--#-#--#-#--#-#--#-#--#-#--#-#--#-#--#-#--#-#--#-#--#-#--#-#--#-#--#-#--#-#--#-#--#-#--#-#--#-#-
--##---##---##---##---##---##---##---##---##---##---##---##---##---##---##---##---##---##---##---##-
---#----#----#----#----#----#----#----#----#----#----#----#----#----#----#----#----#----#----#----#-
--#----#----#----#----#----#----#----#----#----#----#----#----#----#----#----#----#----#----#----#--
#----#----#----#----#----#----#----#----#----#----#----#----#----#----#----#----#----#----#----#----
-#-#--#-#--#-#--#-#--#-#--#-#--#-#--#-#--#-#--#-#--#-#--#-#--#-#--#-#--#-#--#-#--#-#--#-#--#-#--#-#-
--##---##---##---##---##---##---##---##---##---##---##---##---##---##---##---##---##---##---##---##-
---#----#----#----#----#----#----#----#----#----#----#----#----#----#----#----#----#----#----#----#-
--#----#----#----#----#----#----#----#----#----#----#----#----#----#----#----#----#----#----#----#--
#----#----#----#----#----#----#----#----#----#----#----#----#----#----#----#----#----#----#----#----
-#-#--#-#--#-#--#-#--#-#--#-#--#-#--#-#--#-#--#-#--#-#--#-#--#-#--#-#--#-#--#-#--#-#--#-#--#-#--#-#-
--##---##---##---##---##---##---##---##---##---##---##---##---##---##---##---##---##---##---##---##-
---#----#----#----#----#----#----#----#----#----#----#----#----#----#----#----#----#----#----#----#-
--#----#----#----#----#----#----#----#----#----#----#----#----#----#----#----#----#----#----#----#--
#----#----#----#----#----#----#----#----#----#----#----#----#----#----#----#----#----#----#----#----
-#-#--#-#--#-#--#-#--#-#--#-#--#-#--#-#--#-#--#-#--#-#--#-#--#-#--#-#--#-#--#-#--#-#--#-#--#-#--#-#-
--##---##---##---##---##---##---##---##---##---##---##---##---##---##---##---##---##---##---##---##-
---#----#----#----#----#----#----#----#----#----#----#----#----#----#----#----#----#----#----#----#-
--#----#----#----#----#----#----#----#----#----#----#----#----#----#----#----#----#----#----#----#--
#----#----#----#----#----#----#----#----#----#----#----#----#----#----#----#----#----#----#----#----
-#-#--#-#--#-#--#-#--#-#--#-#--#-#--#-#--#-#--#-#--#-#--#-#--#-#--#-#--#-#--#-#--#-#--#-#--#-#--#-#-
--##---##---##---##---##---##---##---##---##---##---##---##---##---##---##---##---##---##---##---##-
---#----#----#----#----#----#----#----#----#----#----#----#----#----#----#----#----#----#----#----#-
--#----#----#----#----#----#----#----#----#----#----#----#----#----#----#----#----#----#----#----#--
#----#----#----#----#----#----#----#----#----#----#----#----#----#----#----#---S#----#----#----#----
-#-#--#-#--#-#--#-#--#-#--#-#--#-#--#-#--#-#--#-#--#-#--#-#--#-#--#-#--#-#--#-#--#-#--#-#--#-#--#-#-
--##---##---##---##---##---##---##---##---##---##---##---##---##---##---##---##---##---##---##---##-
---#----#----#----#----#----#----#----#----#----#----#----#----#----#----#----#----#----#----#----#-
--#----#----#----#----#----#----#----#----#----#----#----#----#----#----#----#----#----#----#----#--
#----#----#----#----#----#----#----#----#----#----#----#----#----#----#----#----#----#----#----#----
-#-#--#-#--#-#--#-#--#-#--#-#--#-#--#-#--#-#--#-#--#-#--#-#--#-#--#-#--#-#--#-#--#-#--#-#--#-#--#-#-
--##---##---##---##---##---##---##---##---##---##---##---##---##---##---##---##---##---##---##---##-
---#----#----#----#----#----#----#----#----#----#----#----#----#----#----#----#----#----#----#----#-
--#----#----#----#----#----#----#----#----#----#----#----#----#----#----#----#----#----#----#----#--
#----#----#----#----#----#----#----#----#----#----#----#----#----#----#----#----#----#----#----#----
-#-#--#-#--#-#--#-#--#-#--#-#--#-#--#-#--#-#--#-#--#-#--#-#--#-#--#-#--#-#--#-#--#-#--#-#--#-#--#-#-
--##---##---##---##---##---##---##---##---##---##---##---##---##---##---##---##---##---##---##---##-
---#----#----#----#----#----#----#----#----#----#----#----#----#----#----#----#----#----#----#----#-
--#----#----#----#----#----#----#----#----#----#----#----#----#----#----#----#----#----#----#----#--
#----#----#----#----#----#----#----#----#----#----#----#----#----#----#----#----#----#----#----#----
-#-#--#-#--#-#--#-#--#-#--#-#--#-#--#-#--#-#--#-#--#-#--#-#--#-#--#-#--#-#--#-#--#-#--#-#--#-#--#-#-
--##---##---##---##---##---##---##---##---##---##---##---##---##---##---##---##---##---##---##---##-
---#----#----#----#----#----#----#----#----#----#----#----#----#----#----#----#----#----#----#----#-
--#----#----#----#----#----#----#----#----#----#----#----#----#----#----#----#----#----#----#----#--
#----#----#----#----#----#----#----#----#----#----#----#----#----#----#----#----#----#----#----#----
-#-#--#-#--#-#--#-#--#-#--#-#--#-#--#-#--#-#--#-#--#-#--#-#--#-#--#-#--#-#--#-#--#-#--#-#--#-#--#-#-
--##---##---##---##---##---##---##---##---##---##---##---##---##---##---##---##---##---##---##---##-
---#----#----#----#----#----#----#----#----#----#----#----#----#----#----#----#----#----#----#----#-
--#----#----#----#----#----#----#----#----#----#----#----#----#----#----#----#----#----#----#----#--
#----#----#----#----#----#----#----#----#----#----#----#----#----#----#----#----#----#----#----#----
-#-#--#-#--#-#--#-#--#-#--#-#--#-#-E#-#--#-#--#-#--#-#--#-#--#-#--#-#--#-#--#-#--#-#--#-#--#-#--#-#-
--##---##---##---##---##---##---##---##---##---##---##---##---##---##---##---##---##---##---##---##-
---#----#----#----#----#----#----#----#----#----#----#----#----#----#----#----#----#----#----#----#-
--#----#----#----#----#----#----#----#----#----#----#----#----#----#----#----#----#----#----#----#--
#----#----#----#----#----#----#----#----#----#----#----#----#----#----#----#----#----#----#----#----
-#-#--#-#--#-#--#-#--#-#--#-#--#-#--#-#--#-#--#-#--#-#--#-#--#-#--#-#--#-#--#-#--#-#--#-#--#-#--#-#-
--##---##---##---##---##---##---##---##---##---##---##---##---##---##---##---##---##---##---##---##-
---#----#----#----#----#----#----#----#----#----#----#----#----#----#----#----#----#----#----#----#-
--#----#----#----#----#----#----#----#----#----#----#----#----#----#----#----#----#----#----#----#--
#----#----#----#----#----#----#----#----#----#----#----#----#----#----#----#----#----#----#----#----
-#-#--#-#--#-#--#-#--#-#--#-#--#-#--#-#--#-#--#-#--#-#--#-#--#-#--#-#--#-#--#-#--#-#--#-#--#-#--#-#-