?diagonal=OnlyWhenNoObstacles;
---#--#---#-#--#-----##--------#-----#--#-##-#-----#---###--#---------#--#--#-#--------##--#-##-#--#
-#-------#----#-##-#----####-#-###----#-------#--#----##-#-----#-#----------#-------##------------#-
-##-##-#-##-#--#--#----#-#-#--######--#--#-#-----####---###----###--------#-#-------##-#-----------#
-#--#--#--#-#--#---#---#---#--#------#-#-#-#------#-#---#-#------#---#------#-#-##--###---#-----#---
---#-##---#-##-##E-------##-------#-----#--#-------#---#------#-------#--#--#-----#--#--#-#--#-##---
#-#--###--###------##------------#----------##---#--####-#--#-------#--#-###--#-#--------#---#---#-#
---##----------#-#--###-#-###-##-##--#-----#----###-#-#------#-#--#-#-------##---##---##--#--#-##-#-
-#-#--#-#---#----#--#----#--#-#---##--#---#----------------#-----##-#--#--#---#-#---#---#--------#-#
#----##--#-##-#-#----#----#--#----##----#------#---#---####-###---#-#-------#-#--#-#----####--#----#
---#--##-#---#--##-##--------#-#---#----#---#-----------#-#----------##---#---##---#-#-#-#-#----#---
-##--------###---#-#-#-##---##---#-#---#-#-----##----#-----##--###-------#----------##-------#------
-#---#---#-----#-#####----#--#----#-#----#--#--#-------#-#----#----##---#-##----#-##-----##---#---##
--####-----#--###------#-#--#-----##-#-#-----#--------#------##----#------#--------#-#--#--####-#---
#-##----#-----#--#--#--#-----#-#--#-----#----#----#--#---#-#------#-----#---#----##--##--#-#--------
-----#--#--------#-######--#------#---#-----##-#----#--#-#---##------#-------------#-##-----#-------
#-----###---#-----#---------#-#-#-----#-----#---------##--#-#---#-----#--------------#----#-##-#--##
--#----#-------#---#####----#-####------##-#--#-#-##---#--#---#-#-----#-----#----#----------#-#----#
--####-#--##------------#-#######-#--#-#-----#-----#-#----##----##------#--#--####---#-###-#------#-
-------##-###--##-#--#-#-#-###--#----#----#-#---#-#---------#----#---##-----#--##-------#-##---##--#
-----##-#-#-----#-#--#-##--#------#-#--#--#----#--#-###-----#-----#-#----#------#####--#------#-----
---###-###-----#----#---#--#-----#--###-#-#--#-#------#---#----#---------##-----##-#----##-#-#------
-#--##-#-----#----#-------###------#-----#-#--###------#-##----#----##-#------#-------#-----#--#----
#-#-----#---#--#-##--##-#---#-#-#--#----#-#-##----#-#--------#---##-------#--####---#------#--#---##
------###-#-------#---##-#------##-##------####--#-----#--#-###-#---#--------#---#-#-###--#---------
-#-------#---###-#-#-----#-#-----#--#-#-----#-####-##---#---##----#-#-#---#--------#-#---##----#----
#--#--#--#--#---##-###----####-##---#---#--##-#-#----#-#--#----------#----###----#-#--#---#--#-#-##-
#-#--##-#--#---#-#----#-#-##---#----#-#----#----#-----##------##------#---####-#------#--#---###----
#---#---#-------#-###--##--#------###-#----#-####-#----#--#---#---###--#-#-##-----#---##--#----#--#-
##-#--#---#-#------#---#-----###-##--------#-------##-----##-#-#-#----#----#--##------#---------#--#
--##-##-##-##---#------#---#--##-####---#----##---#-----##-###-#--#--#---#----#-#-#---##---#-----#--
#-------##---#-#---#--------#---#----#---------##-----#-#----------##-#-##----##---##--#--#-##-###--
---##-----##-##----------###----#--#----#-#--#---#--####-##-###-#--##-------#--#--#-------#---------
#----#-#--##---#-##------#-----###-----##-#-------#--##--#---#--#-##-#-#------###-#--#--#-#-#--#----
---#----#-------##----#--------#-#--#-##---#----#-#-#----######---#--###-------#-#----#-####--##---#
---------#-#-------#------##----#-#---#-----##---#--##-###-------#----##--#-#-#-#---##--#---##-##--#
#--#-------##--#-##---#--#--#-----#-#------###-------#-#----#-#---------##--#-#--------#-##-####----
-#----#-----#--------#---##-----#-#--#---#----#------#--#-#-----##---#----#----#--##---##--#-------#
##-#--#-##-----###---##-##----#--#---#-#-#--------##-#--------###-----#--------#---#----##-#---#-###
----#------##---------#--#---###---------##----##---#-----#--#-#----#--#-#--##----#---##--##-#------
#-###-##--#------##-#-----#--#------#-#--#----#-#---#----#--#---##-##--#----##----###---#-----###---
--------#--#--###--##--#------#-------#--#---#-----##---#---#-----#-------#-#-##--------#-####--##--
#------#--#--------####-#--------------------####-#-#---#---###-##-###----#-----------#---------#-#-
--#--#-##-#---#---#-###---##----#---#---##-#---#----##--#-##-#-#---#-#----#--#--#---#---#------#----
---#--------#----------##---#--#-#-##------##---#----#----#-#-##-#----#--#-----#--#-#-##---------#--
#-#-#-#-#---------------##--##-----#--#---#--##---#------###--#----#------#---###---#--##----#---###
----#----##---------##---#----#---------####---#----------#####-#--#--#-#--##-#-#--#-##-#--##------#
-#------##--#--####--------------##-#-------#####---##-##-###-#------#-#--#-#----##-##---#----####--
-#--------#---#-#-#---##--------###--#--###------##-#-------#-------#------------------#-----#--#--#
###--#-------------#----#--#-----##-###---#--###-##--##-#-------------##-----#-#-----#---#-#--#-----
-----#--#-----#-#---#-#-##-----#-----------#--##-#---#----#--#--###---#---######---------------#-###
--#-#--#####-####----####--##-##---#--####-------#-#----#-##--##-#-#---##-----##----#-#------#------
--####---###-###-------#---#---###---#--#--##-###---#-#--#-----------##-#-#---#--#--#----##-#----#--
----#-##---#---###---#------#----###-##-#--#--#---#-#------#----#--##-#---##-----##---------#--#---#
#--#----######----#-------#-#-##--#--#####-##--##-##-#---------------####--------##--##-----------#-
----------#--#-------#---##-----##----###-----###-#---#------##-----#----#--#------#------#-#-##--#-
-##-###--#---#---##---##---##--##---#-#-#--###----##-#-##--#----###---#-#-#----#-------#---#--------
----#-#--#-----#--##-----#-----##--#--------#---##-#---#---#---##--##-#---###--##---#-----##-###---#
---##-###--#---#-#--##----##----###-----#-------#-#------------#--------#--#-#-------##-##--#-----##
-----------##-##--##-#--#---####--#-----#-----#--#-#--#------#--#-#----#--#--------#---#-###--#-----
#--#-#---##---#----------##-#--#------##-##--#-----#--##--------#--#--###-#------#--####----------#-
-#---##-#--#-------#---##--#-----------##------#-#-#---#--#-----#---#---#-#-#---#-#-#-#-#-----#-----
-#-##----##--##------#--#--------##--#--#----#-#-##--##--#---#---#------#---#----#----#-#---#--#---#
#----#------##-----#----##--####---#--##---#---------#-------##----#-#---------#--#--#-#-#----#---##
-#-##--#-------##----------#--##------##---------###---------##--#------#------#--#---##---#---#-#-#
#-##--#--#-#---#-#--#---#-#-----#--------#----#----------#-#-####-#-----#-#----#-----##-------#--#--
-#--######-----#----------##----#-----#----#----#---------###------#-#-####----#---#--#-#-##--#--#--
--------#------#-#-#----#--#-##--------#-####--#---##------#---##-#-##-##-#-------####----------##--
--#-#--#------##-#--------#----------##---##--#-------##-#---###------#-#---------#--###----#----##-
-#---##---##---#----#--#----#----#-#----#----#-----------#--#--##-#-#-##--#---------##-----##--#-##-
--#----#-##--#--#-#---#-#-#--#-###-#----###-#-----######-#-------##------#---###----#--#-----#-##--#
#---##----#-------#----#-------------#---#-##--#------#-------#------#-----#---#-#--##---#-#--------
#--#-------##-----#-#-----##-#-------#---------------------------#-##-##-##---#------#---#--##-#-#--
-#---##--##----#--#---#--#-#------##----#-------##---#--#-#--###-------##-----##---#---#-----#----#-
--#------#---------#---#---------#-#--------##---##-#----#----#----#------#---##-#-#---#-#------#-#-
###--##---------#-------#-----#----#--#-#----------#-----#-##---##------------#---#--#-##-#--#------
-#-#--#------#---#---#-----##-##---#-------##--##--#-------#----#-----#-----#-#---------#-----##---#
-##------#-####---#----#--#----#---#-----##---#-##--#--####-#----##-#-#------#---#-#-#---#---#-----#
-#-#-----#---#----#----##--##----#-----#-#-#--#-----------#----#-#---#------##-#-##--#--#-----#-----
--#--#---#-#--##----#---#-##--#--##------#-#----##-##--#---##-#-----#-----#---##-#-#------------###-
-#-#--#-----##------#---##-----#----###--#---##-#----#-#-#-#-#---####-#------###--------##--#-----#-
-#---##--##-##---#----#-###-###-#---#-#---##-####--##--###-###--#----#--#--#---#--##-#-----#--#----#
------#----#-#----#--#--#--#-#---#---#--##------#-#--#-##-##-#-#-----#---#----#---###-#-###----#---#
---#--#-####--#-#------------------#-----#--##----#--#-#-#--#--#------#--#---#------##------##------
--------#-#----------##--#-------#------###--#----#----##--#------####-###----##---#---#---#-#-##--#
-----##--#--------#####-----#----#-#---#--#-#-##-##-##---#---##----#-#--#-#----#-#-#--------###-#---
#----#--#----###----#-------------##-#-------------#---------#--#-----##--##-#---#--##---------#--#-
#---#--#--#-----#---#------#----##---#---#-#--###-#-#-#--###--#----#--###-#-##--#----#---###-#----##
#-###--##-------##--#-#-#--------##-#---#------#---#--#-------#--##-#-##-##---#--#-----#---------#--
---####-##-#-#-#-##-#--#---#---#--##----#--------##------#-#--#------------#-----#-#---#------#----#
-----##-------#-#---------------------#-####--##-------#--------#---#-----#---##----#--#--#----#--#-
--#----#--#------#---#-##-#-#-#--#--##-#-#---#--------##-##-#--#-#-#--##---#-#----#--#---#---#--####
---#--#---#-#-------#-##------#-#--##-#----#----#-#--------#--#----#---------#--###-----------------
-#---##--------------###-#-#--##-#--#-----#---------##-#----##------##-#-#----####----#-----------#-
-#--##--##-##---------#----#--#---------##---------#-##------#---###------#-------#-----#--#------#-
---##----#-#-##--#-##--##-##--------#--#-#---##---#---#--#-#--###-----#---##----#---##-#-##--#----#-
##---#-#--##----#--#---#------#-####-###--#----#----#---#----#---####----------#--------#--##-#-----
-#---##---S--##-------#---#-----------##--#-------#-------#---#---#----------#----#---#---#---#-##--
---#--#---#-###-#----#------#------##-##---#--##-#---#----------------##------#--#----#--##--##--#-#
##--#---#------#--#-#-##---##----#----#--#---------#--##-#-#-----#-#-##-#---------#--#-#---------#--
--#--------##--#----#-------####--#--#-#--#--#--#----#---#--#----------------#---#--#-----#-#------#