?diagonal=OnlyWhenNoObstacles;
#--#-#-##----#---#---###-##-##---#---#-##--#------#---##-#---#----#-#-##-#--#------#-#--#-#--#------
--##---#---#-##-##---#----#-------###----#------#---------#-----------##---#--#---##-#-#-------#--#-
----##--#-#-------#----#-------#--##--#--#-----#---#-#-#-#-#----#-----###-#---#------##-#--#-#---#-#
-##--#----##-##----#-#----##-#---#-#--#----#--------###---#-#-##-----#---##-##--#--#--##----#-#----#
---#------#---##-#-------#-------------#---------#-##------###---#-#-#-#--------##----#---#-#-#---#-
-#----------#--#-#-----#--##-#####--#----##-##-#-##-#---#--##-----#------------##--#-##-------#-----
------#------#----##----#-------#-#-#-##--------#--#-#-----#--#-#--#-#--#-#---#-#----#-----#-------#
#----#------###-----#----##-#-#-##--#-#--##----##------#-#-##---------#--#---#------#---#----##-#---
-##--#---#--#---##--#-----------------#-----#---#---##----##--#--#----#-#---#-#-##-#-#---##----##---
--#---#-##---###-----##---#----##--##--------#-##-------#-------#--#--#---#--#------#--#---#----#---
#-#-#---#--#---##-----#####---#-#----#-------##---#-----#----#--#-#--#---##--#----#--##---###--#----
--##-----###-#-#--#----#-#----#--------#----------#-##---#--#-------##-#------#---#-#----#-----##---
---#-#-#----------#---#--------#-#--##---#-#-------#------#--#-#-#-#-#---#-------------#-#-#-#S----#
----#----------#----##-#--#-#-----------#---#-#-----##-------------##--#--#-###----#-#-##-###-#-----
---####---#--#---#---#-#--##-#-------##-----#--##-------#-------##-###-----#--#----#-------#--#-#-#-
--#--------#-----#----######-#-----#------#--##---#--#--##-----#---#--------##-----#--##--------#---
--##------#--##-----#------##-#--####--#---#-#--#---#--##---#---------------##-##--##--#---##----##-
#-----------##------#-#--##-#-----------##-##-------#--#-#------#---------#--##--##---#----##-#-#--#
----#-##-##--#--####-#--#-##----#---------#----#----#----#-----#-#-#-####----#---#---------#-------#
-#----#--#----------#--#------#----#-#--#----#---#--##-----#---#-------#-#----##-----#-------#-#---#
--#-#-##-----#----#---##---#-----##---#--#-#-##--#-----##------#-###--#-##-#------#--#-#----#-#-----
-------#------#---##----##----#----#-#---#-------##-#-#-#-------------#-#-#----#------##------#---#-
---#---##--------------#----#-#----#------#-##---#---##---##----#-##-#---##-#-####-#-#--#-----#--#--
-#---##------##--##-##----#####----##-###-##-##-##-#---#--###----#----#-#-#-#--#-#--#-##-#----#-----
-#------##-----#--------#-#-###-##-#--##--#-##---------#---#-#---------------#------#--##--#----#---
---###---#--#------##--#------###-#-##-#-###-----#--#-#-----##-------#--##-#---##---#-----#-#-----##
#----##-####--#----#--#-###-#------##---------##----###-#---------#--------##-----#----#--##-#-#--##
#---###-#---#-##--##-#---##-#------#-#-----#-#-----#--#--#-##-----------#-###---#--##-#-----#--#--#-
----##-#--#---#-#---#-----##--#--#---#---#----#------####----#-#-##-##--#--#--##--#----##--#-#-##---
-----------#--#--------#-#------#--#--#----###-#----##-##--#---##-#---#-#---------------#-##--#-#---
-###---#--------##-##--##----##-----#-----------#-----#---#--###----##--#-----------#-#-##-----#--##
-#-------##-----####--#--#--#-#---------#-##-------#-#--####-------#---#---#-#------#---#--#---#-###
---###---#-#----##-----##--------#----#--#---##-#-#--#-----#-###-###---------##---#-#--##-------##--
-##-------#--#--#-#----#--###---#-------##--#-----#-#-----------#----#-------##-#####---#-###---#---
---#---------#----------##--#-----##------#--#---#---#-#----##---#--#----#-------#-----##--#------#-
-#------###----###--#--#--------#-#---#-###---#-------#-#----#-#--------#-##----#-#--##--#--#-#-----
-#-----##-###----#---###------##--#----#-----#-###----#-#-#-###-#-#-##----#---#----##--#-####--#---#
-----------#-------##---#-##---##-#-----#---##--#-----#-#-#----##-#---#---#-#-#-#--#-##--#--#-------
---##-#---#--###--------##--#-#-----#-#-#--#---#--#---------------#-----#--------##-#--#-#--#-------
#-#-----#---##---#-##---##-#---------##---##------###---#---#----#--#-##---#-------##-##---#--#-#--#
--#-#---#----#--#---##---#----#-#--------#-##-----#----###-#--##-------##-#-#----#-----#-#-#---##---
#-##---#---#--------------##-#--##-----###---#----#-----#----##---#----#---###--##--#-##--#------#--
--###--------##---#--##------##--#-#----------#-----#-#----#--#--------#-#-#----#----#-----#-##-#-##
--#---#---------#-#--#-#---------------------#-#-#-#--#-#------#---#-#---##---#------------#--------
------#-----#-#--##---#----####---##------#-----#-----#---#-#---#-#---#-##-----#-##---##---##----#--
-#--#-----#-#-----#-----------#-----##--#---#------#-###-#------##--------#---#-----#---------#-#-#-
-#------#-#-#--#------#--------##---#-##-##--#--#-#---###-##----##---#----##-#------#------#-#--##--
---##-------------------#---#--------#--#------##--###-------#---####-----###--#---#--#-##--#---#--#
----#----#--##--#-------#---#-#--------------------#-#--###-----##-#------#--##--------##-----#--#-#
---#--##-#-#--##----#----#------#--##-----#---##-#-----#-----##-#-##----##-#----#-----#---#------#--
---#-#------##------##---##-----#-###----####-##---#---#----###--###-#----##-#--###-----##---#-#-#--
----------#--------###-#------##----#--##------#-----------#--#--#-##-----#-----------#-#--#----###-
###---####-----------#-#--##-#--#-#-#------#-##--#--#-#-----------#-#-------#--#--#-------------#---
----#--#----#-##---------#--#-##-##-#----#----#-#---#-#--#-#---#-#----#----#-----#-#--#-#-#-----#-#-
-##-------------##--##-#------#-###---##--#---#--##-#-##--#---#--##-----#-----###--------#--#-#-----
--------#--#--###-#--#---#---###-#----------------#-#--#--##---#-##--#--#------##--#--#-----#-#-----
--#---###-#E#---##-------##-##----#-#-#---#-#----#-#--##----#--------#---------#-#-#--#--#-----#-##-
-#------#----###-#-###-#-#--##--###---##-##-------#----#-#---------#-##--#--#--#--#-##-----#---#----
-##-----####--##-##---##-------##---#----#--#-##-####---##---#-#-------#----#--#-#---##----------#--
#---#-##--##-#-#-##-------#------#--#------#--#---##--------#------#----#---#-#-----#----#------###-
##-#--#-------#-#--#---#-----#----#------##----#--#---#----##-----#--------#---------#--#-------#---
#---#--------#-##--#---#--##------#-#--###-#---#-###--####-----------------#-#--#--#------------#--#
-#--##-------#-##-##-##----#-#------#--##---#---##---##-#-#--##-#-----#--#---##-------------###--#--
--#--#---#------##-###--##--###--##--####-###----#-------#---#------#--#----#----#--------------#---
--#--##--------#--#------##--#------#--------##--##--##--#-------#------#--#-#-#-------#-#---#-##---
-#-#-#-----#--#-##---#--#---#--#----#--####--#---#-#-#---##-#-----#--#-#--#---#-#-----##----------#-
##--#--#--#-#-#-#-#####----#--##-#-#---------#---#-###---#-----#-##-##-----#--#----##----#-#---#--#-
---#--#-#-#-#-#------#-#--#----##------#------#---##---#-------###-----#-#-#-----#----#--##----#--#-
--##-##--------#-#-----##-----------#-#-#----------#-----##-#---#-##-----##---#--------##----#------
--###------------#----------#---#----#---#-------##-----#-#-#-#---##----#---#-----#--#---###---#--#-
----#----#-##-##----------#--#-#---##-##-#--#--#--#-----#-#---#--#-------#--#----###--#-#---##-#-#--
--#-#--####----#-#-#----#-----#-------------###----###-#-#-##----#---#--#--#-#-##------#--#-------#-
-----#--####---#-##--#--#-##----#---#-----#----###-#--###-###-#--------#-#-#----#----------------#--
-##-##-##----#-##-----#-----#-#--#----##-#------#----#------##------#-#-----#----#----##-------##-#-
#---#---------#-##---##----#-##-#---##-#--#--------###-##----##---#-###--#--#-##---#----##------##--
-##----##------#--#----------#---#---#-----------------#-----#----------#------#-#--#----#-----#----
#-#---##---#--#-##--#----------###-------#---###--#----#--##-#--#-#-#-----#-#-----####--#-#-###----#
#-#-#-#-##-#-##-#-#-#--####-#------###---#---#----#-####-----#----#-----------##--###-#---#-#--#----
------------##-----#-----##-##-##-##---#---------#####---#-----#--##---------#--#-#--#-----###-#---#
##--###-###--#------##-----##-----------#----#------#-##-#-##-----------###-------###-#-----#---##--
--#----#--##-----#----#---#--#--------#------#-#----#-#--#-####-------##-##---###-#------#------#--#
--------#-###-------####--##-#----##---#------#-------------#----##------##-##-###-----------#----#-
-##-#---#-------#-----##--##-##-#--##--#-----#---####--#-#-#--#----#---#---##-#---##-#--##----#-----
----#---##---#-#--#--#---#--##----##--#--#-#-#--#--##-#-#------------##--#--#----#----#--##--#-#####
###----#-#-#-#-#-##--##---#-----##----#-------#-#####------##--#-#--##-#-#-#-##-##---#--##----#---##
-#--------------#-##-----#-#-----#-------#--#--##-#----###----##--#------------#-#-------#-#----#-##
-#------#--#-#--#---------#---#-#---##--###-#-#---###---#-#-##---#------#-###---#----##----#-----#-#
#-#-----#----#----#---#---#---##-#####-#-##-----#-##-#-#-#---------##--##---#-###----#----#-----#---
--#-----#-##---#-#-#-##-------#------#-#--##-#-#----###------#-#--------#---##-#-#-#---#--#---#-#-#-
--#-#----#----##-##-#---#--###--#------##----#-#--####--#-#-#-#-#-#--#---#--#---#----#-------#-#---#
-#----#-----##-##-----#-----------##---#----#----#-##-#-###-#--#-#--#-#--#-----#--###--#--#-#----#-#
#-###---------#--------------------#---#--#-#---#--##----##--##--#---#-##-----#-#----###-##-#---#--#
#-----#-#-#--###----#-#-------###---#------#---#----#----#----#-----#---------#--##--#---##-##---###
-#----#-#-#---#----#--#---#-##--#---#-------#----#--#-------#------#----#-##-#######-------#--#-#---
#-#####-----##------------------------#-----#----####-#-----###---#---#--##--##-#----###-----##-----
-#-#####-#--#-#--##--##---#----------#--##-##--#-#####----###-##-#------#----#-#-#--#-#-#--#--#-##--
--#--#---#---#---##--#-##----------#-#--####---#----#--#--#---#----#------#--#--#----#--#------#----
--#---##---#--#-##------###--#-#-##-#-###-#----#-----#----#---------#--#---#-#--#-------#----#-##-##
#---#-##--###---#--#-#-#----#-------#---#--##-#--####--#--###-##------##----------#-----#-------#-#-
------#---#-#-#------####--------#-----#---##-###-###-------#--#-#--------#-#-#-#-##---#-------#----