?diagonal=OnlyWhenNoObstacles;
##--#--#-#---#--#--#-#---#--####---#-------#-#--#-------#--#-##---#-#--------#---------#--###--#-###
#---##-----#-----#---#-#-##-##----#---#--#----##----###---#---#---#-----##----#--##---#----#-#-----#
##--##---------#-----#-#--##---#---##-#--#---##---#-#------###-#-------#------##-#-#---#-#--#----###
----##---------#----##-#--#-#------#-##-###---------------##-#----##---#-##--------------#-#-------#
--#-##---#--------#--##--##--------##--#------#----#-##-#--#------#-#-------#-#-#----#--#--#-----#--
--#-#--####----##-#--#-----##-#-#--#--#-#-------#----#------#---#-##----#--------------#--#-#---#-##
#---##---##-#-#--#-----#--------#--#------##-##----#--#----###----#--#-#-###--#--#-----#----#-------
----#-----#----###---#-----#--##------#-#--#-##-#--#-#-##-###--##------#-----#---###-#---#--#----##-
-#-#---#----###-#-#--#-#--#----#------###--#-----#---#-#--#-#-#------#--#-#---------#-##-#----#-----
----#-#---#----#--#---#--#-----#-#-----#-#----#-##--#-##--------#-#--#--##-#---###--#---#--------#--
---##---#--------##---##--##-#-----#-----#----------#-#---#-------#------#----#----------------###--
---##--#-##--#---#-#------#-#-------#-#--------------#-----##--#--#---##-----#---##---#--#-#--######
-----#---##-----##----#---#-#-----##----------###------------------##-----------#-----#--#-----###--
##-##--###-##-#--#-##-----------#-#-#---#--#-------#-#----##----##----#----##----------#------#---#-
--#-#--#---------#-----#----#--##----##-####--#--#----#-#----#--#--#---#--#------#####--###-----##--
--#--------#--#--------------#---#-------------#-#---##-------#-##------------#--##-----##-###----#-
-#-#----#----#-----##-#--#-#---#-#-#--#--#--###---#--#-----------###-#------#-------##--#--##-----#-
---##-#------#----#-##--#--------#-----##-##--###---###-#-------#-##-------#--#-#-#----#--#---------
-##--#------#-#-#--##-#--#--##--#-------##--#---#---#-------#####-#-#------#--##----###------#---##-
----------###-##--#-#-#---#---##-####--#--###-####---#--#-##-##-----#----------#-#-#-####-----##----
#--#--##---#-------#---#--##-----###--#--####--#---###--##---####-#----##------#####--#----#-###-#-#
##----#-------------#--#---#--#-----#-----#-###-#-#----#----#--#----##-------------#-#-#---#--#---#-
-#---#-#------#---------##-#---#-----##-#----#---##---#-----#---#---###--##-#---#-###-#-#-#-#------#
#---#-###-###--#--#----##---###-----###--#--##--#--#-#--#--#-##--#----#------#---#-#------##---#--#-
#-#---#-#----#-##--#--#-#---##-------#---##------#-#--#----#---#-###--##-##-#---#--#-####--------#-#
----##------##-#-#####---------##---#-#-##--#-#-#--####---#-#----------#-#---------#-#---##----##-##
-#---#--------####------#-###------#---#-###----#----#--#---##----#----#------##------#---------####
--------------###-------#---#-#-----#-#--###-#--#-----#-------#-----#----#--#-##-------#---##-------
--#-#----------##---------#---#---#----#--##-#-#-------#----#####------#--###----#--#-#----##----#--
-##------#-#-----#--#-----###--#-##-#----##--##-#---#--##-#--------#---##-###---#-------##-#--#--#--
------#---#---#-----#---##-#--#-------#--#-###-###-----------#---#---#----##-----#---------#-###--#-
-#---##--##----##----#----#---#-#-#----#-----#-----#-#-#--#--##-##-##--#--------##-#--#-------#-##--
#-----#-##-----#---#-------#--------#--#-##-----#--##------###--#-####-----##---#-##-##---#-#--#----
##--#--#---#--#-##---#----#---##---------#--#-#--#--#-#--#----------#-----#--#--#--#----######-#----
#--##-#-##-----##--#--#-#-----#--##-----##--#----#----#-------#-###-#-##-#-----##-##-----#-#-----##-
--#---##----##----#----#--#---#-#--#--#------#--#-#------#-#---#-#-##-------##--#-###----#---#----#-
-#-#--##-----#---------#----#---##---#---###-#---#--#-----#-#---#-##-#-##-##-----------#-#-------#--
--#-###-----#---------#-#--#---##-##--#------#---##-#-----#----#####-#---#----------#------------#-#
-#---##-#-#-#---##--#----##-#--#-##-#------------##----#-##---#--##--##---#####-#--#-#----#-#--#----
-#--###-#---##-------##--##--#--#--#---#-----##-------------#----------#-----#--###---#----##--#--#-
---#-#-##--#--#---#-----#---------#--###--#-----#---------#---#--###-#----#--##-------#--##------#-#
----------#--##---#----#----##----#-##-#---#--#-#--#-#-###-------#-#-#-----##-------##-##-#-#-----##
-----#-#-#----#-#--#-###-------##----#-#----#--#--------#-#-----#--#------##-----##S-----##--###-#--
---#---#--#-#####--##-###-#-#-##----###-##-#--#-#-#--------#------------#-----##----------##------#-
----###--#---###--#--#------#-#-###--#-#----#---#-------#-##---#--##-##--#-#---##-----##---#--#----#
-----##--##-#-#---#-#-#-##-----#------#---#----#-#-------#---##-##-----#--#------#--#---#-#-----#---
---#-#---#-##---##---#------#-##--#--#---###--#--#----#-#-------#-------#--###--#--#-#----#------#--
-#--##-#-##----#-#--#--#-#-##------#-#-------####-----#--#--####-----##---##-#--#-#---#-##------#---
---##---#--#---#---#--#--#-----###--#-##--###-#-#---#-##-#----------#--#-#---------##-##----#----#-#
----------------#----#---#-#-##--------#---#-------#----####--#-------##----##-#-----------#---#---#
------#-##---##-#-------#--------##----------##---##-------#--#-#----------#--#---##--##-###-------#
----##---#--------#-#---#----------#------##-----#----#--#----####---###-----##------#-##--##--#-#--
##-------#---###----#--##-#--------#-#-----------#-----#--------##-#--#-#--##----##--#--##-#---#-###
#-##-#---#--#---#---#---##-##---#---#--------#--##---##---###-##--#-----#---#--###-----#-#---#---##-
#-#-#--#---####------#---#--##--------#-----#-#-#####--#----##-####-#--#--#--##---------#--##--#----
--#--------#--------####--#-#-#--------#-#---###-##--##----#--####--##----#---#-----#-###--#-----#--
----------#----#-#-#-##-#-#---#-----##-------------#--###-------E-------#--##----#--#-#-#-----------
#-###--#--#-#-#----#-----##---###--#---------#-##--#--#--#-##-----####------#--##---####-#------#-#-
#-#--#--###-------#---##-#----#-----#--##----##-----------#--#--##---#--##-##--#----#--##-#---###-#-
#-##-#----#-#--------#--#-#---#-##-#-#---#---##-#--##---##------------##--#-#---#--#--#-##---#--#-#-
--##-#--##-#---####--#-------#----####-##----#----##---#-#----#-#---#------##----#----##-#------##--
--#--##-------#-----#-#-#----#----##-----#----#-##-#-----#-----#--#-#--------##--###-#-----##---#---
-####------#-------#--#---#--------#-------#----#-------##--#---####--##-----#---#-##--#-####---#-#-
-#--#-#--------#---##--#-###------#---#--##--#--------------#---------####---------#-------#--#----#
--#-#----------#-##-###------#####--##-#--#-##--#--------#--#----#-#---#-#-##-#--#------#-----------
------#-------#-------------------#---#------#------------#-###----##------#-----#--##-----##---#--#
----------#-------####-------------#------##-##-#--###-#-#-----#--#--##--------##---#-##----##-----#
---##-#---#--###-#-#-#--#-#------#--#-####--------------###-#--#-##-#-------##-#---#--------#--#-##-
-#---#---#-#####--##-##-#-##------------#---#---###---#--------------#--------#-#####---#-#-------#-
-----#----##----#-#-#-----##-#--#---#-#--#--#-##------#-#--#-##--#-#-#----------#-#----#--##-#-##---
-####----#--##---##-#-----###-#--#-#--#-#-#----#-----------###--##-##--##---#--#----#--#---------##-
--#---------#--#---##-------------------#--#---#--##-----##---#---#####-----#-#----#-###------#-###-
-#------##---##-#--------##-------#-#--#-#----#----##-#---###-#---#----#--###--------#---#---#-----#
------#-#---#----#-##----------#--------#---##----#--##------#--#---#---#-#-#----#-------##------#--
---##-##---#-------#--#-##-----#-----#-----#-##------#---#-#-----##--#--#-------##-#--#----#--#---##
------###---#----------#---#--#---#--##---#----#-------#----##-##--##---------#-#-#-#-##-###-----###
------------##----##--#------####----#---#---##--#-#------#----##----#----#--#--##--##-----#--##-#-#
---##------##-#-#--#----#----------##-##-###--#---#-------##---#--------###-##--###--#-#----#-#-----
-#-------#-----------------#--#-##-------#-#-------#-#-##------#-#-----##--#--#---#--###-#-#-----##-
#-----#----##--------##--#--#---------#--#-----#----#-##----------#----#--##----#-#--#------#---##--
---#---------#----#-#-#####---###---###-###-#-#--#-#----#---#-#---#--##--------#--#------#---#-##---
-##------#---#------#----##-#-#--##-#--#-#-##----#---------#--#--#-----#-----#-#-#---#---###-#-#----
#-#--###-#---##-#--###----#######-##-----#------#--##--#--#-#------##--------#--#----###----#-------
--#---##--#-----#-#----##---#--#--#-#--------#-#--------#--##-##-#----#---------#---#-------##---#--
----#---#-##---#--#-#-#--#--#-----##----------------#------#-----#--#------------##----#-#------##-#
--#-------##------#----#-##------#----#-----#---#--###----#-#--------#---####---###-----###-#--#-##-
-----#----#---##--#-#---------#---##---##-##---#-#-####-#-#--##--###---#-----------#--#-#------#----
---#-#---------#---##-###--##-----#-----#-#--#--#---------#-##----#-#-----#--###---------------#---#
----#####----#--#----##--#-#-#--#---------##-#--#--------#-#--##-----#---#-#-##-##------##-----#--#-
-#-#---##---#---#--##-#--#-----##--#-------#-##--#-###-----#----------#-------##---##--###--#--##-#-
#--------#----#-#---#-#-----#--#----##---#####------#-#----##-----#---------------------#---------#-
--#----#--------#--------------#----#---#-#---#-#--#-##--------#-#---##-###--##-----#---#------#-##-
----###--#----#----#--##----#---#-#-----#-----------##-#---#----#-##-#---#-----#--------#--#---#----
------#-##-##-#-#-#----###-----------#-------#-##-#-----#-------#---#---#-------#--###--#-----#----#
---#--#------------#--###-------#---#--------------##----##--#---##-----------###-----###-----#----#
#-----#-#--#---#-#--##--####-----#-##------------#--#---#--##--##----#---###---#-#-#-#-#---#------#-
----#-#-#-#--##---#--#---##-###----------#--#-#---##-#--#----##------#-##-#-----#--#---#-#--###---#-
---##------##-#-#----##-#-----#-#-------#-#------###--#-----#--#---------#-#-----#----##-##--#------
-#---#---##----#-----#---#--#---#-----#---#------#-#-#-#-#-###-----#--#--##--#---#--------#-###----#
---#----#-#----#---#--##--#--#----#--#----##---###-#-#-#--#-#---#-#---#--#-----#-#---##-------------