?diagonal=OnlyWhenNoObstacles;
---------#----#--#-#-####-##--#-##--#--#--#-#-#--------##--------#-#-------##----------#----##--#---
----#----#-##----###-#-#------#-#-------###--------------##-#--#---#--#--#-####-#-##-##---#---------
----#---##--##-##----#-#-##-----#--#----#--#-#--#------##----------##-----------#--##----##-#---#-##
----#--##---#--###-----#--##-##--##----#----------##--##------#--#---------#---#-######---#--#-----#
---#-#-----#------#-#-------#------#--#-----#---#-----##----#-##------#-##---##----#-------####-#---
-#----------#--#--###-##-#----######-#-#-###-#-#---#--#-------#-###-----#----###-----#-####----##---
----------#--#--##----------------##------------###------#--##-#-###--##-##----------#-#-##--------#
-#-------#-#-##----#--#-----#-------#------#----#------#--#-##-#-#------###-#---##----------------#-
#-##-----#--#---#-----#-#-##-#---#----#-###----#----##-----#---#--#--##---#-#---##--#------##--##---
--E-#--------#-#--------#----###---##--###-------#--#-#----####---####------------#-##---#-------##-
-##--##----#-----##---#---#----#-##-#--#-#-#------#----#----#-------#--#---#-----#--------------#---
-----#-#-##--#-##---------##--------#--##--##-----#-#####-###---#--##-##--###------#------##-#------
-#---#--------#-#------#---#-#-----#--##-------###-#-#----##-#-###-##---#-#-#-#----#----#--##-#-----
-#---#-##----#--#--------####-#-----#---#-#------#--#----#-#-#----------#---#--#--#---#--#---#-----#
--#--#-#-##-####-##-#-#--------#-#---#----#---#---#-----#--##-#------------#-##-#-##------#-----##--
#-#-#--#--##---#----#--#-----#----##----##--#----#-#-####-#-#-#-#--#-#-#-#--##----#-##---#--#----#--
-#--#---#---------#------------------###---#--#-------##--#---#---#-#-----#-------#--##--##-#-#----#
--------#----####-#------#-##-#-#-#-#----#-------#-#-#-----#--#----##--------##--#-#--#---#--#--#---
--#-##-#----#----#-------#-#-#----#-#-#------##--#--#--------#----#--###---------#-------##-#-----#-
#-------##--#-##---#---#-##--#----#--#-#----#-----------##---#----#-----#-----------#--#--------##-#
-#--#--##-----##--##-#---##-#----------------#-##---#--##-#--##-----##----------#--###----#--####---
----#--#---#---#--#--#---###----#--#-#-##-#-#----#----------##--#--#--#-#-##------##-###---#--#---#-
-#-#--#----#-##----##--#----#--------#--###---#--#---#---#-##-#----------##-#---####-----##----##---
##-##-----#--#--#-#-----#---##--#---#--##------#--------#--#-#---------#--##---#-#-----##-----###---
#--##--###-----------#-#-------##-#----#---#-##--##-#----#---#----####-#-----#--#-------##-#--------
#--##-#-------#-#--------#-#-##---#-----##---#----####------------#--##---#------#-----#--#---#-#--#
#-------##-----#-------#-#----#-#-##--#-#--#--##--#--#-------##----#--##-##-----###---##----###-----
#-------#----#--##--------#----#----#---------###--#------------####-##-----#--#-###-----##--####--#
-#--#-#--#-##---#-#---##---#------##-##--#-#---##--###---##---##----##--------#-#----------#--##-#--
-####-#-#-#--#--#---------------###-#---#--------#-----##-----#-#-#---#----#-----#--------##---##-#-
-#--#-#----##-#-----#----#-------#-#--#--#-#--#-#--##--#-----#-###----#-#-----------#---#---#-#---##
#--##---------#--#--#-------#---#---#--------------#--------#-#---------#-------#----#-#------#-##--
----#-#----#-#------#-#-#--#-#--#---#-##-#-#--#----#------#-#-----#-#--##-#-#--#---##-#--#-#---#-###
--###----##--####-#----#-###-----------------#-------##--#---------#-##-##---##-##-----#--#-#-#-----
---#-----#-#-##-##----##--#-----#----#-#----#---##--#--#-----##-#----##-#-#----#---#---#-##-#-------
-----#-##--###--#--#----#---#-#----##------#-##--#------#---#--###---#------##----#------#----#--#--
---#--#--#-------#------#----#----#--##----#--#-#-#-#---##------------#-------#-#--#-----###-#---#--
-#-#---#---#--#----##------#--#----#-#----#---###--#--------#--#-#----------#--#-##--#-###----##---#
-##-#--##-------##--#-#--###-#---#-###--#---#--#---------#---#--##----##--#----#---#---------##---##
-#-#-###----#-#-#-------#-##--#---#---------#-###---#-----#----##-#-------#---#-#----##-#---####-##-
-----#---#--###-#---#--##---#--#-#------------##-#---#---#-------#-#-----###-#----##--#-#-#--##--#--
--#--##---------#--#-#--#-----###-------#-#-###-----#--##-###---#---#--#--###-#---------#-----#---#-
--#-----##-#-#-----#-----#-#---#-#----#-#--#-#---##----#------#--#------#---#-#--#----#-----#--#-#-#
-#-------####-#-----#----#------##-#---###--##---#-#---#---##-#----####----#-#-----#-#--#--#---###--
#-#--#----#-#------###--#-----#-----##--#-#-----###--------#--------#-#-#--#--####-###---#----------
-##-#-------------#--#---#-----#------#-------#-----#--#--###----------------#--#-#-#------------#--
#-##----##--##--#-#---#---#-------#------#-#----#---#-----#-##-#-------------#---#---#-#-#-#--#--#--
--#----#---#----####--#-#----------##--#------#####----#-------#----#------#---#-------##--##-##-#--
#--##---#-##----------##----#--#-#-#----#--#####-#--##--#--#-------#-#-##---##-##---#--#-###-----#--
-----------##--#--#-----#-#-#-#---#-####-#-#--#--------#-#---#--------#---------##-#--#---#--------#
-##-#---#-#------##---##-##--#----------#------##----#-----#-##-##--###---##---#---##-----#--#-##-##
#-----##-----#---#---------##---#-##--##--##----#--##-#-#---##----#-##----#------#----##-#-#-##-#---
#---------#----##---#-----#-####-####-#----######---#--#--#---#-#--#-#-#---#---------#---#-#-#-----#
----##-##-##--##--#-----#--###--#-------------#-#--#-##-#------##----#-#----####--#-#---##---#------
----#-###-#----#---#--#------#---#--##-#-----#--#-#-#-#--##-----##--#--#---#-#---#-------#---#-##---
---#--###---#---#----------------##-#----------###-#---------#---#-#---#-----#-##----------S---#---#
--#-##--##-#-#----#-----#----#-----#---#--##--####--------#----#-##-#-#-#-#------#---#--------#--#--
--#---#--##--#-------#-#------#-----#--#-#-#-#---#---#--##-----##--#-----#-#-#-----#---#--#-----#---
--#####--#---##-------#-----------------#-#-#-#-----##--#----#-#--#--------------##-------#----#---#
#--#--#-#-----#-#-#----#-#----#------------##-#--#-#--------#--##---##-#-------#-#----#---#####----#
-----#----#---#-##-----------##--#-#-#--#-#--##--##-#--#------##-#-###-#---#-##--##--------#--------
-#---##--#---###---#--#--#-#-##------#---##-#-#----#--#----#----####---#--#-##------#--#-#--#-##---#
----#---#---#----#---##----#------#-#-------#--------#-###----#-###-#----#----#--#----#-----#-------
----#-##--#---##--#----#------#-----###--#-##---#-###-----##-#-#------###-###----#-###--------#-#---
#-#--#--#--##---##--##---#-----##-#-----#----#--#-------#-----#-##---#--####-#--#-##----#--#-#--#---
#-###-#---###-#-#-------------------#-##-----###-#--#---#------##-##----#--##--------------#--#-----
-----##----##-##----#------#-#-##-#-----###-#-#--#-#---#-##-#--#--##-#----##-----##-#-#--#-####-----
#---#-##----#-------#-#-#---#--#--------#----------##-#--##-----#--#-#-#--####--#---#-#-#-#----#----
--#--------#-----------#--#-----#---------------------##-#------#---------##-#--#-#------##-----#---
##--#-------##--##---##---#-----#-##----#---#--------##-#-#-#---#--###-##-#-----#---#-#-#----#--#-#-
---#---#----#-#----#--#-----------#-#-##-----#-------##-##---#----###-#--#-##-#-##-#-#-----#-##-#---
-----#-###------#-#--#-##-#--------#---#----#####---#-------##-###-#----#-#-###-#-####----##--###-##
#--#-#---#-------##-#--#-##-##----#-----#-------#---##---#---#-----#--###--------------#--##--###---
----#----#----#-##----------#------------#----------#----##-####-------#---##-#----#-----------#-#--
-#--####-#------#-#-#------#--###-----#---#-#-----#-#-#--#----#---##-----#-#--#--#-##-------##------
--#--###------------##-#-#------------##--##----------#-#-------#---#-###---#-#--#--#---#-----#-----
---#-#-#---####--##--##----#--##---##-#---##----#--##--#--#-----##---------#--#------#-##-#-----#-#-
#-------#------#-####------#-#-##------###----#--#----##----#--#----##--#-##-##-#-###----##-#--#---#
-----#--#--------#----#----#---------#-------#--#-##----##-#-----------#---#-#--##---###---##--#-#--
----#---#-#--#-------#--#-####----#-#---#-#--###-#-#--#-#--#----#----#---#----#--#-----#-------#----
-#-#---#-----#------------#--##-----#-#-------#----#---#----#------#--##-#-----#-##----##-#-#---#---
-----#-----#----#----##-#------#-##-#---#-----------##--##-#-#-----###-##----#-#-------#-#--#--#---#
##---#----#------#---##--###--#---#--#-------#-#---#-##---#----#------##-#-------#-#--#------#---#--
-#------##---#-#--#---#-#--##---#-#--#--##-###--#-#-###--#-#--#------##----#----#-#--#-##---#---#-#-
-----#----##------##-#--#--#-#----#---------#-------#-##-#-#----#-#-----##-#-------##-##---#-------#
-----#-----#-#-------#-#-------#-----##-------#--#--###-----------#--#-#---#---#--#-#-------##-##---
----#--------#-#-----#-#--#--------#-#-#--#--#-------#-#--#-##------#-##-#--#--#-###---##-#-#-------
--#-#-##-----#--#---#-----##---###--#--#-------#----#---#-#----#----------##----#-----#------##-##--
-#---###-##---#---#-----#--##-##-----------#-#-#-#-------#-##--##----##----####-#--##---#--###---#-#
###---##---#-#-##-##-###-#---------#--#-#--##--#####-------------#-----##----#--#--#-----------##-##
----##-------#-##--##-----#--#----##-##---#-#---##------#------###-----#----#--------#----#----#-#--
##-###--#--#----#---#--#----#-------#-----#--------#---###---------##---#-#-----##----#-----##------
##--#-#----###-----###--###--#-#-#--#--#-----##-#---#--#---#####--##-#--#-------##-#-----#--#-#-----
##------#---#--##-#-#---------#----#-##--##--#-#------##----##----#--#---#---#---#-------#-----##-#-
---#--------#-#----#-#---#-##-#--#-#---##-#----#------#---###----##---##--##------#------#-#-----#-#
------###---#---#--#-#------#----#------#---------##--------##-####-#---#-----#-##-----#--#-#-##--#-
---#--#---#--###-----##-#--#----#------#--#---#----##--######-------#---#---###-##---#-##------#--#-
-------##-#---#--#---#----##-###--##--#####-##---#--#-##-#------#---#--##-#-#-----------#--------#--
----##----###----#-#---------#---#-------#--##---------------------###-----#-#----#---#-#--#-#---#--
-##-###-#-----#--##--#-#-#-#-#---#--#--#--#---#-#-#------#---------####---#------#----#-#-##--#-###-