?diagonal=OnlyWhenNoObstacles;
-##---#-#--------------------------#####--#-##----#-#----##-#---#----#-----#-##-----##---#---##-###-
---##--#-----#--#--------#--------#--#--#----#---#--------#---###--###-#----#----#---####--#----#-#-
-##---#--#-----#-----#----#--#-##-#----#----#-##-#-------##---#--#----#---#-##-#----#-#-##---#-#----
-#---#------#-#----#---#--#-----#--#---#--#-----#---#--#-#---##-#-#------##-#-##-#----#--###---##---
---#---##--##-#-----##--##---####-----------#----##------#---#----##---#-----#--##--#-#-#--#-##-#-#-
--#-#-------#----##--------#-##----##---##-#-#------####-##---#--#--###--#---#-##---#-----#---##--#-
##-##-#-##------###--###---#-#-------##--#---#----####--#---#---#-#-#------#-#-#-----#---#--#-------
#---##---###----#---#-----#------#---#-##-----####-#--#-#---#-#--------#-----------#---##-#-#-#---##
--#---#---------#---###--#--##-#-------#-##---##------#---#-----##----#-#-###------#----------##----
#-#-#-------------###---#--###----#------#----#-------------#-#---##----##---##---#--##-#---#-#-----
---##----##-#-----#----#--#-#-###-#----#-#--------#---###----##-##--##-##----------#---##--------#--
-----#-----#-----####---#-#------##-#-----###-##-##-#-##-#-----###--#--##-----#-#-------##---#---#-#
-#-#-##----#----------##------##---####---------#-----##--#-##-------####-###-#------#-#--#-------#-
-----#--#---#------##---###-#-#-#-#--------#-##-##-#--##--##----------#-##----##---#-----#------##--
##-#-##--#----------#--#--#----#-----##-#-----#-----#----#-#-#-#-#----#--#---##-#-#--#--------##-#-#
-#--#---#-----###-----##-------#----#----#-#----#----#-#-----#-#---------#--#-#----##--#----##-####-
----------#---#--------#----#-#-------##-##--#-####-#-#--#---###-##--------##-----#-----------#-----
#-#---#------#----#-#--#----#--#---#-------#-----#-##----#----####-#--####--#-#-----#--##-----#----#
----###--#-#-----#----#----###-#----###-#-------##--#---#----#----##-#-#-#####-----#----#---------#-
#----##--#----#-#----------#----#-##-----#-#-#--##------#--#---#--#----------#--#---#--######------#
#----##--#---#--#-----##-#---#-#--#---#---###-#--#--#-----#-#-####---#-#---#-------#--#-----##--#---
-#-------#-------#---#--###-#-#-------#-#-#----#---#-#---------------#----#-#--#-###---------#---#--
-----#-#----#----#---#-#---#--#--#--------------#-##-#-###----#--#---#---#--#-----#-----#---#----#-#
#-#--#---##--###---#---#-#-----#-#----#----#--#----#------------#--#------------##-----------#-##---
-------#--###---##--#--#-------#---------####--##-#-##-#--##----#--#-#--#---#-##---##---#-#-#--#-##-
----##----#-#-#------------#-#-###---##-#-----#-#--#-#--#-#-##--------#--#---#-------#-----#-#----#-
-###-#-----#--#----#--#-----#--#--#-###-#-##-##---##-------#---#--#-#------#-##-----##---#--#-#-#---
--#-#-----##--#---#---#------#---#-------#---#-##--#---#--#-#-------###---#--#-----##-----#-----#---
----#--##-##--#--#------###--#-#-#-----##--##------##----#-----#----#-#-----#--#-#-#--#--------#-#--
-#-##---##---#----#-----#----##------------------##--#---##----------#---##--#------#-#----#-##--##-
##-#---#-----#--###-#---##------#--#----------#----------#--#--#-#-----##-#--##-#-#--#--------###--#
---####------#----##--#-#-----#----###-#----##-#-#--###----##----#--##-#-------#---##--##----#-----#
---#-#-##-----#----#-##-----##-#-#-#-#----#------------------#####--#------#---#----#--##----#--#---
#-#---#--#-#-##---#---##---#----#-##-##-#---#-#----##-#--#-#-#----------#-------------#---###----#--
--##-----------#--##-----#-------##--#-----#-##----##--#----#--------#-##----#----#-------------#---
#--------------####--##---#----##-----#----#--#-#----####-#-#-##-----------#----#---##------#------#
-----#------#---#--#-#---#-----------------##----#--##--#----##-#---#--#-------##-###--#--#--#-#--#-
#-#---#---------##-#------------##--#--#-##---##---##-#--#---##---#-##-#------#--#-#-#----#--#--#---
-#-#--#-#----#-#-#-#----##----#----##---#-##-#-#------#-##-###---##----#-----#-------##-##--------#-
#--##-------##----#--#-##-#--#--#----#-#---####---#------#---------#--#--#---#-----#-#--#-#---#----#
---#---##---##-#--#----------#--#-#######-#-#------##--------#####--#----#-##-#--#----#----#--#---##
--##---#--#---#-###-----#---------S-----#----#--##----##----##------#---#------#--#-------##-#--#--#
-##-#-------------#-##-#-##----###---#-##---#---#-----#-###--#--#--##-#--###--#----#------#----#--##
#--#------#---##-------##-----#---##------#-###-----#-------#--#--#-###----#------#----#-###---#--#-
###--------#-#---------##-#--#--##-----------#---#-#-#-------#-#-#-##--#----#-#--#--------#-##--#--#
----#-------------------#---#---#-------#-#---###--#------##-####-------##-##------------##---#---#-
---##-#-----#-#--#----##--##-#---#--#-----#-#--#----##--#-#####-##-#-#---###----#-#---------#-#---#-
-----##----#----#--##-#-#--#--#-#----#-#--------##-#------#------------#--#-#---#--##-#---#----#-##-
-##--##--#--###---#----#---#--#--##---##-#------##-----#-#---------#-#-------#-###---##-###---#----#
--#--##-----##-###-------#-#----##------##--#--------#---#-#-#-----#-##-###---#------------#------##
-#-#-#-#-----#---#-----#-----------##-##----#------###--#-#-------##---##---#--#-#-#---#-#---#-#----
##-#-----###---###---#-------#---#-#---#-##-----------#-----#--#---#--#---##-#--#---#--#-----#---#-#
----#---#-----#----##--#-##--------##-#----#-------#-----#---#-#------#-#-#-#-#-#-#------###-----#-#
----#-----#-------###--#---##--#------#-----##------##--#------#---#----####----#----#-#---#----##-#
------#-#--------#----------#----##-----#--#-#-----------###--#--#---#------#-#----#--#-----#---#-##
--#----------##------#--#-#--------####-#------#--#----###-#---#------#-----------##--#---####-##--#
-###--#--#--#-#--------#----#---#-##---###--###----#-#-#--------##--##------##-#--#-----#---#-------
---------#---#-#---###-#----#---#-#-#---#-------#-##--#-----#------##----##--###-###-----------#---#
--#-------#-#-------##-#-#----#-###--####-----------#-----##---#-###--#-#------#-####---#----##---#-
-#-##-------##-#-#-#-###------#----#-#---#--##--##-##-----#-#-----------#-#---#-#---###-#--#---#----
###-#--#--#-##------#-##-#--##-#--#------#-#------##----#----#----#-##-----------#----#-----##-##--#
---------------###-#-----------#--#----#--#-#-#-#-#----#-##-----#--#-#--#----##-##--#-#-#---##---##-
##------#-#--###---#---#-----#-####---------####--###--#-----##--##--###-----###--#--#----#-#---###-
-----##---#-#-####--------#-----#---#-#-----------#------#-##--#--##-----####--#-----#---#--------#-
#---###--###----------------#-##--#----------#------#-----#---#-#------#------#-####-#-###-#-------#
------#------#-#-#---#----#--###----##---------#-----####---------#-#-#----###---#--#--###---##----#
-#-#-----#----#-#-#--#--#--#-----#-#----#--#-----##-#####----##-###-##---#-##-##-#-#--###--#-#--#---
---#--#--#----##-#--#-#-#----#-----###--##-#-----#-##-#----#----#---------------##--------#----####-
#-----###-------##----#---#--#-----#-#---##---#--------#---##-##-####---------#-------#----------#-#
#-##---##-------#----####----##---#---###-#-------#--#--##-----#-----#-##---#--#--#-#--#------------
#---------#------#------#--##--#--#-#----------#-#--#--#-#--#------#----##---#-#---#-#--##-----####-
#-----#-#-#-------#---#--##-#--#----##---####-#-##--##---#--#--#----#--------#--#----------#-#-----#
---#---#-----#--#-#--#----#---#-#---#---#-###--#-#----#-#--##-#-#------#--------#-##---#-#-#-#---#--
---#-#####------#----#-#---#------#------##---#-#-#------------##-----#-##--##-----#----#----------#
----#--#-#--#---#-#--####-##-----#----#-#-------#-------###--##-#--#--------#-----#-######---#-#--#-
-#-------###--#-#---------------#---------###-#-#--####--------#-###--###----##------------#-#------
-#--#----#-#-#-#--------#--------#-#---#---##-#----###-----#---#-##---------#--#-#-----#---#--##-#--
---#-#-------##-----#----##-------------#-#-#---#--------------#----#--##------#-#-#--#----#---#-###
---###--#-##---#-#------####-------##-#----##-#---------#-##----#--------------#-#----##-#---##---#-
#-#-----#---#--##-#-#------#-#------#---------###-##--##---##-##---#---#-#------#----#----##-###--##
-#--##------------#----#------#--#------#--#-#------#--###--#-#--------#--#---#-----#-----##-#-##--#
----#--#-##-----#-#---#-#-#-#--#-###-##----#-##------#-----##------#--#----#-----#----#--#-###-#----
-#--#--##--#--###----------#-##-----##----#---#-----------##----#-#--#--##--------###-#-#---#---####
--#----#----------#-#----##----#-#---##--#-##-##------##--##---#-----#-------###---#--#-#-#-----##--
#-##---##---#--#-#---#---###---##-----------------#-#--#----#---#--------##--#-#---#-##-#-###-#-#---
-#---#--#--#-----#------##--#---#-------##-------#---#--#-#--E----##-#--#-#-#----#---#----###----#-#
-##--#--#-----##----#-#-##-##--####--#--#---#--#---##-#-#----#--#--##-#-#---------#-----##--#------#
#----------#--##---------##--------#------##----#-#-------#--------#---#---#-#---#---#----#--###-###
-----#---###--#-#--#--#-----#-#---#--#---#--#-----##-------#--##-----#-#--###-#---###---##-#--##----
-----###-----#--#----------##--##------##-#--#-##---------#-##-----##---##--#---##-###----------##--
--------#--#-#-##--------##---------##--#---##----#--###-#------##-----#-------#--#---------##------
----##--#-----#-#--------##-###-#-----#--#--##---#-#--#--#-------#----##---#-----#-#----#---#-#-#-#-
--#-#----###-------#---###----#-#----------#-##-------#--#----#-##----#---------#-##-#-----#--#-----
-#--##---#-#-------##-#-#-----#--##----------###--#------#--------#------##---#---##---#####-##-----
-----##-#--#------#-###---#--#-----#----#---#-#-#--#----#----#-#--##-----#---#--#---#-#-----#-#--#--
---#-------#-----#------#-##---##-#--#-#-###-###---#------#------#--------#-##--#----#-----------###
-###---####--#---##--#-##-###--#--#-#-#-###-----##------###--#-###-##-----------#-----#-#--#----#---
------##-#-##-##--#----#-#-#-#-------#-------#-##---#-----###----#-#-##----------####---#-#----#---#
---#--#---#--##--##------##---#--#----#--##-#-#--###----------#-####---#----##---#-#-----#--##---##-
--##-------#-----#------##-----#--###-#---#-----#----#--#------#--##-#-#----------#-##-##-#--#-#---#