?diagonal=OnlyWhenNoObstacles;
------#-------#-#--#-##-#----#--#---###---##---#-----#--#----------#--#-#----#--#-##--#-##-###--#-#-
-----#-----#-----#------#---#---#----#-----#-#--###--##-----#----------#--------##-#-##-##----#---#-
--#-----------#-------#-#----#-#-----#-------###-----------#---#-#---#--#----------#------#--#----##
---#--#--#--------#-#-------###---#-#-##-----------#--###-#------#--#--#---##-#--##----###-#---##--#
##--#-#----#--#--##-#-###-#---##-##-#--#-----###-#-#--#-##--#---------#---#-#---#---####--#--#-#--#-
---#--#----##--#----#-#-------##----#-#-##----##-#--#---#----#-###---#-#----#----##-#---#--#-#--##--
##--#---------#-##----------------#--##---------#---#--#--##------#-#---#--##---------#-#-#----#--#-
-#---#--------#-##----##-#--#-######--#------#-#------##-#-##--#-###--##----##--#--#----##--##-----#
###-#------#--#-##----##---#----#---#-##-##---#--------##--#----##-----#---#------#-##--#-----------
-#-#-###--#-#---#---#---#---##-#-----#-#--#------#----##-----#-#---#-#-##-##------##-#-------------#
-#---#----#-##-###-#-##-#------#----#-#-------##----#--#-#--#---##--###----#-##----#-#-#--#-#-#-----
-#--------#----###-#--#-----####---##--#----##----#-##-#--------#-####-#-##-##---#---##---###-----#-
----#-#-#----#---#--#---#-------#------#---#--#-#--##-#--------#---##-#----#-#-#--#---#--####-#--#--
-#--#------###-----#-#----#----##-#----#-----#-#-----------#--#--#-----#----##---#--#--#--#--#-#----
---#----#--#-##-#--#-#------##-##--------#----##-####-#-------#-#--#-###-#---##-#-#-####-####---##--
---------#-#-#-----#---#--###-#------#------##------###---------------#---------#-#---#-----#---##--
-------------####---#--#--#-----#--#####------##-----------###----#---#-----#-#--------#-----#--###-
##-#---#-##--#-#-#--#---##-------##-----#--##-#------##-#--------#-##-----##-#-#--#------###---#-#--
-------##-#---#-####------#--#-##--#----#--##-####-##----#-#-----#---#----#----#-####-#----#---#----
##-#--#---#--#####-----#-----#----#-----#----#---#--#--#---#----#--##--##--#--#-------------##--#---
---###-#---##-#---#-----------#--#----------#----##---------#---------#---#--#--#-#--#-#--#--##--#--
##-#-#----#-#-#---#------#-----#--#----#-----####----##-------#---##-----###---#------#----#-#------
#-#---#-#-#------#---#-----#----#-#---##--#--##-###-#----###------#----#-#----#--#----#-#--#----#-##
##---##---#-----#-----###----#----#--------#----#-----#--#-----#--#-##-----------------##-##-#-#-##-
--##-#-#--------------#------#-#-----------#--#----#---#--#-----#-#--#--##------#----------#----#-#-
-##----##-##----------#---#-------#----------#-----##---##--###--#---#-#---#---#--#-----#----###--##
#----------#-#-----------#-#-#----------#--####------#--#-#--#----#----#---------#-----##------#--#-
-----###---#--#--###--##-----#----#-#-#-#-------------###--###---#-#---#-----##--#-#-#--#-#-#-#---#-
----#--#-#-#---#--####-#--###-##--#-----#-##--------#---##-----#-------------#-#------#------#-#-#--
--##----#--##-#--------#--#--##-###-#---#----##---###---##-#-#----#-#-#####---#-#---##-----#-------#
#----##----#------------#-----#---#--#-----#------#---###--####----#-----#-----------------#-##-#--#
---#-#-###--#-###-##---#--##--#-#-#----####----##--#---#-##----#----#-#-#-##----#-#-#-###----#-#-#--
#---#-----###-#----###-##----------#-----###---#----###-#---#-##---#--##--#####-#-##-#---##-#--##-#-
---###-#-##-#------##---------------#---#------------#------#---##---#--##-###--#------#-#-##------#
-------##--##-#--##----##--#------#---#----------##----####-----#-#---#-#-#--#--#-#-#-----#--##--#--
#------##-#-#-#--#--#-#--------#--##------##----#-#-------###-#------##-#----------#-#--##-#-#-#-##-
----------##-####-#####--##-------##--##-###----#-------#---#-#---#-----#-##------####-#------#----#
-----#---------#---##-#---#--##-#--##----##-#--#----#-----#---##------#-#----##----#--##-#------#---
------------#-------------#-#---##-#-##-----#-#-#--#---#-#-------#-#-#---##--##-#-#-##-#-#---#-#----
#------#-#--#----##---#---#-#-#------#-----#---#-----##-----##-#---##--##------####---#--------#-##-
-#------#--#------#-----#-#---------#-----------------##-----###---------#-#-----##-#-#---###--##---
-#-----------#-#--#-----#---#--#-----#----#-#-#--####-#-#--#--#-##----###-------#-##--#---##-#-#--#-
-#--------#-##-#--S--#--#---##---#-------##-----##----#-##---#------#-##---#-#------------#--#--#---
--###--#-#------#-#####---#---#-#--#-------##----#-------#---###-#----#------####--#-----#----##---#
--#-#--#####-----##-----##---#####--##---#--##-----#-#----#----##-------####-##-#-#-#-#--------###--
-----#-------#--#--------###---##----##-#--###------#---#--##-#-----#----#--#-#---#---#-----#--#-#-#
#-----##--#---##--#---#-#-#--####----#------##---#-###-#-####--##-##--##--##------#-#--#--#---#---##
#---#------#---#---------###-------##--#---#-##---#--------##-#------##---#--#-------###-#--##--#---
--#---#----#----#------##---------#---####----#-##-------------#--------###---##---#--------###-----
----#-#---#----#---#-----#-#----#--#--#----###------#---------------##-#-##---#---#---##-----##-#--#
--##-#-#-#--##-----#---####-#-#-#------#--#----------#-----#--------##-----------#####----#-----#-#-
--#---------------###--#--##-#-#----#--##----#-#-#---#-#-##-#-#-##-##----#-#----#----#---#--#--#----
#-#-#--#--------#-####---#####-#-#-#---#------####-#--#--------##-#--#--##----#-###--#----#--#-#--#-
-##-#--#----#-#----------##--####---#--##-#--------#-#-#--------##------#-#-#----#---#--#-----#----#
--#--####-#--------###--##-----#----#-#--###--#----------------#-#-##-----##--#--------####-##-----#
--#----#--#---#-#-#-##-#--------------#--#--#--#-#----###---##-####---####---#-#-------------#--#---
---#-#-----#--#------------#---#-#---#----#-----###---##--##-#----###-----#-------#--#-#---------#--
---#----#--#-----#------#--#-#-#--###---##-##-----#-#--#----##-###-#-#--##------##-#---------#--#---
-###-----#-#------#---#-######----#-#-#----##-----#----#-##------------------#-----####-#----####-#-
--#-#---#-#--#----------#--------------#-###-##--#------#-#-##---###-----#----#------#--##-----#---#
--##---#----##--------#-#---#-#----#-----#-#-#---------------##-#------#---#--##----------##--------
-#-#---##-##-##-#-------#-#--###--##-##-----#-#-#--------#-#----#-----------#---------#------#--#---
#---###-#--#-----##---#---#----#----##-------##-###----#----#-#---#----#------#---#---##--#---#---#-
-#-------#--###---#-----------##--#--#-##------##--#-#--#-##-------#---------#-##----#---#---#--#---
##----#-##-##---#---#-#####-#--#---##----#----#---#--#-----#---#-----##-#-#----#--#-------#-------#-
#----#-----#-##-#---#---------#------------#-----##---#--#---###------#---#----------##---##-#-#---#
-----#--#----#-#-#-#----#--###---##-#---##-#-#----#-----##-##--#-----#-##-------##-----#-----#-#----
----#-#---#-###--#--##-#------#-----#--#--------##----#--------------#----#----##--#--#----##-#-----
#-----#----#---#---##-----#----#-#--------#----#--####--#--##-##--#----####-##----##--##-#--#--#----
---#-#-----#--#-----#--#-#-------#----#----#-###--------#------#-#-#--#-------------####--#-#-------
--#---##----#-------#---#---------#--##-#------#-----#----------#-#----##---#-##---#-#---#-#------#-
--#------#--##-#-------#-#-----#-###--#------#------#--#---#-----#----#----#----##----#-#-#--#--#---
-#---#---------#------#--------#---#----#--####-----#-#-###------#---#-------------#---#-###--------
----------#---###----------#------#-----##-#------##--------------#-#-##----#------#-#-#----#--#---#
-#----#------##--#-------#-----#-###---#-#---------##-----#-----###------##---#--#----#-#-#--####--#
---#---#-#--#-#------------#-##-##----------##-##----------###----#----#---#----------##-##-##-##-##
-#----##--#--#--#-#--#---#-#-######----#-##--##-#--##----##--#--##----#-----#--------##-#--#-#-#--##
-------------#--#---#-##-#--------#---#--------#----###-##---#--##---#--##---#-----#-----#--###-#---
----#-------#-#--###--#---------###---#--#----#--#---#-----#--#-#---#-----#--#--##-#--#------#--##--
------#-------#----------#---##-#-#-#-------------#----#------#---##----##-#-##--#------#--#---##-#-
---##----#-##----#-------#-------------#-##-----#------#------###----##----#--#--#------#-#--#-#-##-
#####--------#--#-#--------#--#--------#-#--------#------#-#-#-#-#-##---#--#-#-#--#----#-----#------
-#-#-##--#--#--#----##----##---#---#-#--#-##----##---#-----#---#-#-#---##-###--###--#---#-#---#-#-##
--------#-------###--####---#---#-##--##--##---####--#-----#------#-#-------####-----##--#---#----#-
-----#----#-#----#-##---##--#-----##------#---##--#---#-#-----#--#---##--#----##------##---#--------
#-#---------------#--------#---##-##--#----------#------#--------#####----##----------##------##-#--
---#--#-----##-#---#-#------#-##-----#---#-####--#-----#-#--###-------##-----#---#---##--##-#-#-----
#-----------####---#-#------#----#-#---#-----#----#----#--#-------#-#--------#------#--------#-##---
--#-----#-#--##--###--------------##--#---####---#----##-----#-##------###---#-####--#------#---#---
-----##---#------#-#-#---#--####-#-####------#-##--------#---#-#-------#---#---##-#--#----##--#-#-#-
--#----#-##-#--------##-#----###-#------###------#---#-##-#-#-#--#--##-#-##-##-------#----#-#---#-#-
----#--------#---##-###-----#----##-----#--#-#-##------#-------##-#-##---#-----#---#---#-#------#---
#-----##-#----#----#--#-######---#-----#---#-#----#--#---#--#------##---#--#-##----#---#-#--#-#--#--
-#-#------#--#-#------------#-####---##-#------#-----------##-##---#---#-#-----#-##------#-#---#---#
---###------#-----###----------------#--#---------#--#---#-#-#####----###---####--#-#-#---------#---
##---#--#-#--#-#-##-#-#-#-########--#--#-#-#-----#------#--##-##----#------#----#--#E#-####-----##-#
-#-----#----#-----#-#--##-##-------#-#-------##----#--##---##--#-#-##---#----####---------#-#---#-#-
----#-#-#---###--##--###--##-##-#-#--#--#-----#--------##-------------#----##--#-------##-##--------
-###-----###----#-#--#--#-#-#-----#---#-------##---#---#--#----------#-#--#-----#--#-#-----####-###-
------#-#-#----#####---#--#-------#--####------#-##----#-#--#----##-#------###--#-##-----#--#-------