?diagonal=OnlyWhenNoObstacles;
--#--------#-###---#-###--##-----#--#------------#----#------##-#--#--#######-#-----###-#--#---#----
-#-#-#-----E-----#----#---##-#---###-#-#####-#---##--##--#---#---#-##-#----#-#--#----##-#----#-#--##
#-#--#-#--#-----#---##------##-####-----##-#----------###---#-#-#-#---#----#------#----###-#------##
---#-#-##----#--##---##-----#-------##-#--###-----------------##------####------#-#-#---##--#-##----
##---##--#----#----#---##-----#-###-##-----------------###------#----#-####-#-#---#--#-#---##---###-
-#-#-##---#------#--#----------------####---##--#-#--###-#---##----#---#----#----#--#-#---#-------#-
###---#---#--#------#----#----##--###----#-#-----##---#----#-#--#------#------##--------##-------##-
---#-------#--###--------###-###---#--#-##-##-----#----##-#-##-##----#-----------#--#-#-------#--##-
##-#--#---##-#--##-##---#------#-------#--#--#--#########---#---#--#-#--#----#-#-##--------#----##--
----------#-##--------#-#--------#-###----------##--#-----#------##-----#--#------####-#---#----#---
-#---#---##--#-##---#---------#--#---##----#-------#----#----#-#----##-----#-#----#--#-----------###
------#-----------------#-#--#-------#----###--#-#----#---###---#-##--#------------#-#-#-#------###-
-#-##--#--#-----###---#-----###---##-#--------##-----#-#------#----#--#---------#------##--------#-#
---#-----------##--#####----##----#--------#--#-----#------#--#--#------#---------#-#----#-----##---
#----##---#-#-#-#--#-----#-#---------#--####-#----#--#-----#---#--#--#----#-#-#-#---####------#-#-##
--#------#----##--##------#------------#-#-----##--#--#----#-#-----#--#-#--#---##--##--#-#--##----#-
#---#-#-----#----#-##------##-#---#--##---#----#---------#-#--#-#---#---------##--#-------#--------#
-----#-#--##-----------##-##------#--#--#------------#---#--#----#--#-#---#--###--#------#-#--#--###
-##-#---#------###-#-#-#---#--#----##-##--------#-#----#----#-##-----#-##-##---#-#----#-#--##-#--#--
-#-##--------#-#------#--#-#-##--#---#-###-#-#-#-#--------##---##-#-##----#-#----#------###-##---##-
-#-##---#-###--------#----##--#----#-----#---##----##--#---###-------#-----#-#------##-------#---#-#
#--#------#-----#----#--#---#--------##---#---#-###---##-#----------#-#-##-----#-#--#----###-#------
#-#--#--#--#----#-------#-#----##------#-----#--#-----#--##--#-##---##----##-----##---##--#----#----
-##---#####----#------##--#---##---###---------#-----##----------##-#--#--------------#-###-----#-##
------#-#-----##------------#--#-------#-#------------##--#-------###---#-###---###--#--##---#-----#
--------#---#####-----#-#----------####--#-------#--#-----#-------------------#----#---####---#--#--
---#-##--------#-----------##------#---#--#----#-##---#-#-#---#-----##--------#------##-#----#--##--
----#-#-#----#---------#---#-##---#-#-----#------#---#-#--#-####-##---#-#----##-#-#-#---#--#-#-----#
#---#------##-------#-#-#------####-#-##-#--##--------##-----------#--#-----##--#---------#-#--#----
-----#--##-#-###--#----#--#--------#-----####-----#----------#-------#---#------#---#-###-------##--
#----#--#-----#--#--#-----#-#-#-----##-###---#-#--#-#-------##---#-#--#-##---------#---------##-----
--##-#----##----#---#--#-----#-#--##--#-------###-#--#---#---##----###------#-#-#-####--#-##-#------
---#--#--#-#---#--#######--------##----##-###------------#------#-#-#--#----#----###----------------
-##-####-----#---#-#--------#-----##---##-##----##-#---#-###--#-----####-##--#----#---##---------#--
#----#---#--##-#-----#-#----###----####--##-----#--#--#-----##----##----#---#------#---##----###--##
-#--###-#-##--#-#---#-----#---------#-#-------#--###------##---#--##-##----#-#-----#-#--##--#-#--##-
-#------#---####-#-#-#-#-#----#-##-----------#-#-----#---#-#--#-------##---##--#---##-#-#-#------#-#
-#----#--------###-###-#----###----#--##--##-------------#----#-----##----###-###--#--#-------#-----
-#-------####--#-##----#-------##---#--##-----##----#-------------#-#----#----#--##-#---#---#-------
-----#---#-----###----#----------#--#--##-##----##------#-###-----#---##--#-##-----##------#-----##-
-#----#---------#-##-------#--##---#-#----#-#--#--####-###---------#-#-----#--#-#--####---------##--
-------#-#--#---#------#-#---#--#-#-#---------#-####------------##---#--#----##--#-------#-#-##-#-#-
#---#-----##-#-#--#----#-##------##-#--##-#--##---#---##-#---#---#--#----#-----#####---#----#-------
----##---------#####-#--##-#--#--#--#-----------##-#--#-#-#---#####-##-###-##-#--#-#---#-#-##-------
-#---###--##-#----#----##--#--------#--#-#----#---####---##---------#--#--------#-#---##-----------#
###S-------##----#---#--#-----------------#------#-##--#--#-###-####--#--------#----#--#--#-#--#----
-#----#------####-##--#--###--#--#-#-#--#-##-#----##-------#-##---------#-#---------#-#-#-###---#-#-
-#-#-#-#---##---#--#-----##---#--##-#-#------#-#------#--#---##-----------#-##-----#--##---#-#--#--#
--###--#---##--#-----##---------------##---##-#------###---##----##---------#--##-#----#--#-####----
------##-####--###--#------##----#--#-#---#-----##-#-#-----#--###----#-##---##-------#-##-##--##----
----#-----#--##-#--#--#--#-##-#---#--##-----------##----------------#--#-----#----##--#---#-----##-#
-#---#--#----#--#-#-----#-------#---#---#--#--#----------#--###-------#----------#--#-#----#---##---
-###-----#-##-#-#-##-#-#--#--#-##-#-#----------###-#--##---#-##-#---#--#-#---#--#------#---##---#-##
------##-#-------#-##---#----#-#-#---#-##-----#--#------#----#-------#----#-----###-##----#--#--#---
###-----#-#--#-#--#--#----#----#-###--#-##-#-#-#-------#--####-#-----#--#---#--##---##--#--#--##-#-#
---#--#---##---#---#----##-#-##-#------#------#-----#-------#-#-##--##------------####--------#-----
##--#--#-#---------#----###-------##-#--##----------------#-####-#-#---#----#-------#---##--------#-
-#-#-##---------#----#---------#-#-----------#--###-#-#-###-#----#---##----#-#-#---#--#-----------#-
-#-----#--#####-----##---------#-##---#-##---##-#-------##--##-#-#---#-----###--##--#---------#--###
--##--#--------#-------#-----#-#------###--##-#--#--##----#---#---#-#----#-#----#---#---##------#-#-
#--------#---#---#---#--######-#----#------------------#-----##-#--#----##---##-------#--#----------
----#------#--#-#----#--#---------#---#--#---#-#-##-##---#-------##-##--##----##------##----------#-
--####-##---##------#--------##--#-----###---#-----#---#---#-#--###------------###--##--##--#---##--
--#-#--#--#----##---##-#--#---#---##--#---#--------#-#-#----#--#---##------#--#--#-#--------#####---
##----------#---------##------##---#--#-----#------#--#----#-##---#---##--#-----##----###-##--------
---#--#---#--###--#--##--------######----#-#----#--#--#--#-#--#--##------##-#---#--------##-#--###--
#-##-#-#####--####--##---##-#------#--#-#-#----#--#--------#------#---#-##---------#----#-#-#--#-#--
---##-----#-#----#---#-#-#-##----#-#-#-----#-----##-##-#-----------#-----#--#----#---#---#--#-##----
--#-#-#--#--##-----##--#-##-----#-#--#-#---###----#--#--##----------###-#--##-------#-----#----#---#
#------##-###--#-#-####-###------------##----------#-----#--#--#------------------#----#--#-##-##---
#-#---#--##-#-##---#-#-#-----##----#---#------#-----#----#--------###-------###--#---##---------#-##
#---------#---#-#-##--###--#-#----##--##----#-#----#------##-#--#----------#---#---#---#-#----###---
#--#------#---#-#--#-------##-----##----##--#--#--------#-#-#-#---#--##-#--#--#-----##---#-#-#--#--#
#-#--#----#-------#-#-#--#-##-#-#---#-#-#-#--#----#--#------##---------#--##---#--#---#--##-#--##--#
#--##---------#---##-#----##--#-#------#--------#-#-##------#--#--------#----##-##------###-##------
#-#--#-##-##--#----##---#-#-----#-##--------##------------#---####--##-------#---##---##--####-#----
-##-#--#-----####--#-----#--------##-#--#-#---#---#----#--####-------#--#-#--#----#---###--#----#-#-
#-------###-#-##-##-------#----#--###---#--#-#---#---#----#------##-#-#------#---#----#-#-----#---##
--##-##--#--###-----------###--#---#-------#-#----#-#--#-------#----#-##--#-#------#----#-#-------#-
-#----###---#------#---#-----#----------#---#-#---##---###---##-#---#---#---#---#-#-##-##---#--#-##-
--#------#----#----------#-###--#-##-##-----#---#------#-----#-----#--#--------#--------##---#-#-#-#
#---#----##------#--##----#---#-------#####--#----#-----#-----#-----#---#----#----------------#-#-#-
---#---###--------#-#-####----##--------#-#--------#-#-#-#-##---#-#-----#-----#----#----##-#-#----#-
###-#----#--#------#--#----#--#----#--#-#-#--#-##-----#-----#-----##-#----#-##------#-#----###---#-#
#--#-##----#--#---------##-#-##--#--#-#-#---#----#-##--#--------##-----##--#-##----##----#--#---#---
------#-##-------##----------###--#-#--------#----#-----####-----#--##--#-----#-#-#------#------#-#-
--###--##--#-#-#--#-##--#-#---#-##--##----------#---#---##-#------------#-----#---#-#--##-#--------#
----#-#-#--##----#---------##----#------##---#---##-----#-#--------#-----#--#-#--#------#-#------#--
-----#-----------#-#--#-#--#--##-----------####--#----------#--#-#-##------#--#---#--#--#-#-#----##-
--------#---------#----#-------##-####----------#-#--#----#-----#-###--#--##------##-#--#-----#-----
--####--#----#----#--------------#-----#---#-----#-#---#------#------#-#-#--#-#----#---#--#--#---#--
#------##---##-#--#---#-##----#--#--#-##----#----##-#-----#-#-------##--###-#----##--##-----##-##-#-
-#---#--#----####---#-#----##-#--#-#-##--#---#--------####----#----##----####-##--#---###----------#
------##--#--##-#-#-#-#---##-#---#-###-#-#----#---##------#-----#-#-#---#-#-##-####------#-##-##----
----#-#-##--#------###---#---##-------#-#--#-#--###---#---#--------------#--##--#-#-#-#-------###---
#------#-#-##--#--##---####-#--#------#-#-#-----#-#---#---------#--#-#--#-----------#-----#---#-#---
--#-----#--#---------------#--#----#--#-#--####----------#---#-----#--##---#--#-#-#-#-----#---------
--#--#---##--#--#-----##---#-----------#--##-##-#--#--###----#-#--#---#---#---##------#-----#-----#-
-----#-----#-##----##---##--#--#-#-#------------#--#--#-#--#----#-##---#----##------#-###--###-#--#-
##--##--#-###--#---##-------#---#-#---###--#--#-------------#-#-#------#-#----#--#-#---#---#-------#