?diagonal=OnlyWhenNoObstacles;
#--#----#---#------#--#-##----#------#-#---#--###--#-#--#------##----#-#---#-##-#---#--##----------#
--#--#--###--##------#------###--------#-#-------------#--####---##----#-#--#-#--#---##-#---------#-
-##-#----##----#-#------##-----#---#--###----#---#----#---##------#---##----#--#---#-#--#-----------
--#-#-------##---##-###-#-#-##---##--#--#-#---#-----#-#-##---#--###-------------###---##--#---#---#-
####--------######-----#----#-----#-#---#--##-----#-#--#--#-##----#------#----#---##-#-----#--##--#-
--#----#-----##-#--#--#---------#----#---#-#------#-#-###-------#--##-----#--#-##-----#--##--#------
##-------#-###--#--#-###--#--##--#---#-##--#-#--##-----------------#-----#--##-##-#----###---#-#--#-
-#-##---##----##-##-###-#--------##--#-#--##-----#---##--##--#--#-#--#-#----#----#----#--##-##------
--#---#--#-----#---###--------#----#----------##---###-##-##-------#-#----#----#-##--#----------#---
##-#-------##------#--#-#---##--#--------##--#-#-#---#------#-#-#---------#--##----#-#---#####------
##-#-#--#--#----##------##---#-----#----#-#-----------#-##-----#--###----##-#-##-#------#--#-#-#-#-#
---##----#-#----#------#---#-##-#-----#------##-###-#----------#---#--#--#--------##---#------------
-#---#--#----#--------##-----#-#-#---#--------#------##-------------#----#--#-#--##---#-----#-#--#--
--------#-#----#-#-#-#-----#-----##-#-##---#--#---##----#-#------##--#---#--#-----##-----##----##---
###------#--#--#--###--------#---##----##----#----#----------------#-#-##-##-##-----###-----##-###--
----#--#---#--#----#--#----##--##-#---#---#--#---##------#-#-----------#----##-#-#--##--#--#----#-##
####--#-##--#-----#---#---#--#----------#----------#--#---###---#--#------#-----#-----#-#-----------
--#-----#---#-####-#-#---#------##-#-----#--#-###--#----##-------------#--#---#---#-##-#---#-#---#--
#-#-#---#----###----#----##-----------###-----#---#---#--##-###--#-------#--------#-##-####-##------
-#--#-----##-----#--#------------#-#----#-#-#--#---#----#------#--#-----#----#--#-----#--##-##-##-#-
--#-##-------#---#-#----#####--##--------#-#---#-#-##---##---S------#---------#-#-----#-----#--#----
---#-#---######----------#-------#--#-#-----####-#-#-#---------#----##-----#--#-#----##---#--#------
------#-##-#--#------------##--#----#-#-----#-#--###-###----#-#--#-------#-#-#----------#-#--##---##
------#-#------##-#--#------#-#--------#----#-----##-----#----#--##---#----#-------##------##----#--
-#---#--#------#---#----#--####--#--#---#---#---######---##-#----#-----------------#--#------##-----
-----------#-#-----#-##------#-##-----###--#-#---#----#----#--##-###--##---#-#------#-------#-#-----
--#----#---#-##-#-#------#-#------#--#---###----##-#------###-#---###-----#--#-##-----##------------
------#-----#-#-##------###--#--#--------#-#----#-----#---#--#-#-#--##---#-##--##---#---##--#-------
-#--#--#-----------#---#--###--##---###---#--#--####----#-#-#-------##-##---#-#---#-----#------#---#
--#-###----#-##------#------#---------#--###--#--####---##-#---#-#----------#--#-##---#-#--#--------
-----#-#--#-#----#-#---#-#-#-----#------#--#-#----#-----######--###---#-#--###-#----#--#-------#--#-
-#----#--#--#--##-#--#---------#------------#-#---#---#--#--#---------#---#----------#---------###-#
---#-#-#--#--#-##-#--#----------##-##-----#-##--#--#------#---###-#-----##-#-##----------##-------#-
#-##--#-#---#-#-#-------#--###--#---##---#---#---#-#--##---#---#---#---#----#--------##-------#-####
#---------###---#--#--#--#----######-#-##-##-------#---#-#####-#--#-#----#----#--#--#------##---#--#
--#------##--#--#-#--#--#--#---#--###-#-#----#--##------###-----#------#---#------#---#--#------#---
----#---#--------#------#--#---------#--#-#----#---#-#-#---##-----#----##--------##---#--#--##---##-
#-#---##-#--#---#-##-------##----#-##----#--#----#####-#--------#-#-##---#----#---#-----#---#-#--#-#
---#-----#----##-#--###-------#----#---#--#-#-#----#----##--------##-#---#-#---#--#--#-----#---#----
------#--#---#---#----#--#----#---------#-#--#-------#-----#-#--#-#---------###-----##-###-#-####-##
#---#-##---#-------------#--##----#-##--#---#---#----#----#------#-#--#-#-#-#---#-----#-------------
----##------#------#--#--#-----#-#---#---#-#--#----#-###-----#--#--##---####-#--#----##------##-----
---##---##----##-------##--##--###-#--###-#-#---#-------#--#----#-##-----###----#----#-##--####-##--
#----#---#--##--------#--#-#-#---#--#--#----#-#-#-##----#-#--##---------#------#-##-#-#-#---##----#-
--#-##-#---#-#-----------------###----#--#--##----##-------------#-----#---##-#----#---#-#-------#--
#---#-----#--##-#---#---###-#-#--#-##-###---#-#----#--#-----#------#--####-------#----#-----##-#----
---#-#---#-#--##---#--------###--#---------####--##--#-#-###-##--------#--###--#--#-#-#----##----#--
-###-###---#-#--#---#-###-----------#####--#----##-#----#----###-----###--##-#--####---#---#-#-#-#--
--------####-##---------#---#--#-#-#-----#-##-#-----##-#---#-#-#--###----#--#---##-##-#-#------#--#-
---------##--#####------#-----------#-------#---##-#----#---#-#--##---##--#---#-##-#--#-#-------#--#
---#----#---#-#-#--#-#----##-#----##-#-#--#---#-----#-----#------#--------#----#-#-#-#--##---------#
#-#-#-#----#----#---#-#-#---#-###-#-#--##-#-##-#--#--#--------###------#-#---####---------#-#-##----
---##-#-------#--#---#----#-----------#-------#----#------------##-##-#---------##-----#---------#--
--#--#--#---##-##----##--#-------##--#-#-#----###--------#-----##------#-----#----##--#-----#-----##
#-##--##----##-------#-----##----#------#-#-#--#---------#---#--#---#-#-#----#--#--#-#------###-#-##
---#--------##---#--------------#-###-##--##----#-##--------##-###-#-####-#----#--###---#--#--#-#--#
-##-#-##------#-####-----###--------#-#---##-#----#-----###--------#--#---#---#----#-#-----#-##-----
----#---##---#---#----#-----##------#---#-------#---##---#------#-#--#-##----#----------###---#--##-
###---------#--#--#------#--#-----#-##-#---#--------####--#----##---#---#-------------------------##
##---#-#--------------###---#---#---#-#----#----######----#------------#-----------#--#-#--#--------
---#-----#---##------#-#--#-#-#---------###-###------##--##--#-##--#---#---#---#-----------#--#---#-
-#---#-#--#-#-##---------E----#-##---#--##----##-#--##-#-----#---#-#--#-------#----##-#----##------#
-----#--#-----#-#-#-----##----#---##----#-##-#-#-------#-#-##--------##---#----#-#---#----#--#------
-###--##----#---#----#-#-----#--------#-##--------#-##--##-###--------#-#-#---#--#-----#####-#------
#--######---##----##-----#-#---##----#######---#-#-#----#--#--------##-##--#------#---#---------#---
##--#--#-#--#--#-#-#---#-#--#-----#-----------#-#-#----##-----##----#---##--#---#------#------#--#-#
------#-#----#------#---#---#--------#--#-####----#---#--#-#--##--------#--#--#----#-###-#----#-##--
-##--###--#-#--#-###-#-#---#-#---------#########--------#------#------###-----#---##---#-#---#---#--
-----#--------#-##-##------#-----------#--##-##-##---#----###--------#---#--###----#------#------#--
------#---#-#-#-#------------------------#---#--#-#----#--------#-#-----#-##--#----#-#----#-##--#-#-
-----------#--####------#-----##-#-------------##---------#---###----#---#---------#-##-#----#-##---
###------#-----####-#--#-#-#-----##----##-##--#-#------------#-###--#---##---##----#-#---#-#-#-#--##
------------#--#--##---------#-----##-#-#-####-#-#--#--#----#-----##--##---#-#-#-----#--#--#--------
#---#---#---------#-##---###------#-------------#--#----#---###-#--#-#---#-#---##--##---##-----#-#-#
--#-#--#-#--#---#------#----#--###-----###----#----#-----#----##-##-#---#--#--#--#--#-###-----#--#--
#-------##-#----------#-#--#------#-----#--#----##----#-----###-------#--##-##-#---###-#--#--##-----
--#---##-----#----------##-----#--#-##--#---#---###-##-#------#-------------------#-#---##---#-#----
--#-------#--#-----##---##-#----##-----#----#------#--#-#---#----#-#---------------#-##-###-----#---
-----#--------#----##--#-#---##--###---#---#---------#-##--#-##-#--#-----#-#--#----###-----##---##--
---#-#---#--#---------#-#####---#--###-------#--#--##--#-#-#--#-#------##--#-#---#-----#-----###----
###-------------#----#--#---#-------------###------#--##-----#-#---###-##--##--#-#-#----#---#--#----
-##-####----#--#--#---#-#-----###--#--------#--#-#--#----#--------##-#-#--##-##--#-------------##---
#--#---#---#-###----##---#---#----#------###--#--#---##-#-#-#-#--##-----##--###-#-#-###-----#-------
-#####--##-------##-##------##--#-#--#---#--#-##----#--##---##-##--##--####-#-----#--------------#-#
#--------#----#---#---------#----#--#----#---#--#---##-----###-##--#-##---#------##----#-#----#-#---
--#-#-#-#--#----#----#------#-------#-#----#----###--###---#------#-#-##------#-#---#--##-###-------
-#--#---###---##-#---#---------#-##-##---#-####--#-----#-----##-----#----##------#-###--#-##-###-#--
----#--------#---####--##----#--#####----####-------##---#--#-#-----#-------#------#-----##-#-----#-
-##-------#----#-#---##----#--##-###-##----------#---------#-------##-#-#-#-----#--#----------#----#
#--##-##--#--#--#-#--####-##-------#-#---#-#---##---#--#--#-#---##--#-##--#------#-###--####--###---
--#--#---#----#-#####-----##----------#----#---##--#------####------#-----#--###-#-----#---##-------
-#-----#--------#----##---#---#-#-#-#-#-#---------##--#----#------#--###-#--###--#-##--###--##-#-##-
-##--#-#-#-#-#-#-----#-#------#-#--------------#--------#---#---##--#-#--#-#--#------##---#-#------#
-##-##-----#--##--#---#-----##------#--#-##-##--#-###------#---#--#-------###---###---##--#-#---##--
-##------#----#-#-##-------#----#-#---#--#--##--#-----------####---------#-#---##--#--#-------#---#-
##-----##-----###-#----#----##-#-#---#-#-#---##-----##--##-#---#-----#--------#-------##-#--------#-
#--###---#------##-##--------#-##-#--#--###------#--#-#-----#----------#-#-#--#-#-#--###------#---#-
#--#--#-##--#-#--##--#-#-#----#-##--#--##---#----------#-#-#--#--#-##-#--------------#--#---###-----
-##---#-##-----#-##-----#-#-----------##----------#--##-----#-##--#---##-------#---#-------#---#----
--#------#----#-#--#-#---#-##-##-##-#-#------#---##-##--####--#----##---#---------#---#-##-#----#---