?diagonal=OnlyWhenNoObstacles;
######----##------#---#-#-##--##-#-----#-#-#---------##-#-#--##-#----#--#-##--##-----#---##-##------
#-#-#----#-#-------#--#-#-#----#---#--#-#---#----#---#-#--#-#------#---#------#-----#-##---------#--
#---##-#--#--###-###-#--#-######-#--#--##------#---#-----#-##--------#---###--#-#--------#-#--#--##-
-#-#-----#----#--#--#--#-#--#--#---#---#--#-#-#-#--#---#-#--------------#--#--##---##---#---##--#---
#-#--#---##---#----##--#---#------###--------#-----#----###-----------#-##-#--#---#--##---#-#---#-#-
#------###--#-#-#-##--#-------##-#-#-----------##--------##-####--#------###--###-#------------#-#--
-#----#----#-----###----#-----#------------#----#--#---------###--#-##---#-------##-#-#---#-----#--#
-----##---#--##-#-##----##---#-------##-##-------#-#####-----#-##---##--#---#----#--##------#---#-#-
----#---##---#-#-##-----#------------------------##-##---###---#-#-##----##----#--#-#-###--#--#----#
-#-#--#-##---#-##--#------#----#--#-#-#-##-#-----#----#-#---#-------#-#---##---#-#---###--#--#-----#
---#--------#---#---######-----###-#----#----------#-#-##---#-#--##-#----#--------#-#----#----#-#---
--##-##-------#--#--#---####-#-##-------#-#----#---#--#--###--#---#---####---#--#---#-----------#---
------#-#-##-##-#---------#####---##-------#--#---#--##-###---#--#---#----#----#-#-##-----#--##---#-
#----------#---#--#---#-#---##-#------#-#-#--------##---##---------##-#--##---#-#--------#---#----##
----#---##---#-----##------##--#---#--####---#--#-----##-------#--#---------#-#--#--###----#----#-#-
---#---#--#-####-#-----#-----#---##-#-----##-###-------#---##-----#-#-------------#--##---#-#---#-#-
##--#-#---#-###-#----#--#-#--------#-#-###-#--#--###-----##---##-----##-#--##--##------#--#----#---#
-#---#--#--#---------#--#--###-#---#-#--##---#--#---###-#--##--##-#-----#--------#----------##-#--##
#-----#---##-##----#-----#---------#---#-###--#-#----###---#----#---##------##-#-#-#-##-#-----#-##--
--#-#--##----#----##-#-#-#----###-----###------#-#------#---#--##-----####-----------#--#--#----#---
-#-----#--#---#---##-##-#-----#--------------##--#----##-#-#---#---#---#--#-#--#---#------##--------
#--####----#--#--------#------###-#-----------##------#----#---#-#-##------#---####---#----#--#-#-##
###-----#-#-----#----##-#---#--#-###---#--#---#----####-###-#----#--#-----#-------------#--#-##-----
-#-------##---------#-----#-----#---#----#---------#--#-#--#--##--#---##--#-----------#--------##---
#-#--#--##-#---#-----#---#----##-----#--#--###------##---------#------#-#------##-#----#-----#---#--
#---#-----#-----#-#---#--#-#----#----#------#---#-##---#---#-##-----#-#---##-------#-#----##---#-##-
----###-#-#--#--#--#---##--#----#----#---------#-##--#---##--#-----###---#-------#--#--##-#-#----#--
#-----###---#--##-###-------##---#-----##----##-#---###-#-#--##-#--#--####----#--##-#----#-#-#----#-
----#-####-----#---##--#-#----###-###------#---###-#-#---#-#---#-#----------#----#----#-#-#---#-----
-#--#-----------#----#---##---##-----####--------#-#--#--#-##---#------#-#-##--###-------#-#--##-###
---#---##---##-----#--##-#-------#-#---------###--##-------#--###-#-#--#---#----------#-#----------#
-##--###---#---#-#-------#------#---##-#-#---------#---#-##-##-#-#------#-----#---#-----------------
--#---#-----##-##--#---#--##-#--#-#-##--#----###-#-#-#-#---#-##--#-------##-----#---#---#--##---#--#
#--#--#--#--#---##-----#---#----#-----#-#----#-##-####-#-#---#-##----#----#----#---#---##-----------
----------#-#---#--#-#-##-####----#-----------#-#--##----#---#-#-#---#------#-##-#--#---------#---#-
-##---#--#-#-#-#-------#---#-##--#---####--#--#-#-#----#-#---#----##------------#--#-----##--#---#--
-#---------#-#---------#--#-#------#-##--##-#--#------#--##--##--#-----#--------------#--#-----#----
#--#-#--####--#--------------#----------###-------#------#-----#---#--#-------#------##----#-#--#--#
-----#--#--#--##-----##----#-----#---##----#-#-#--#----#--##-####-------#-#---#---#-##--#----#--####
------###---###---#---#--------#-#--##-----##----##----#-----##------#--#-----#--#-#-#-----##------#
#-------#-------------#----##-##-------#-#------##--#--##-#-#----#-##--#---#-#-##-#----##-#-------#-
--#-#--#-----#------#--#-#-----###--#-#-###---###-#-#--#---------#--#-#-#-##-#------##-##----#------
#--###-------#----##----#-##---#-#----------#----###---##-##-##-#------#----#----##----#----#--#-###
#-##---------#--##----###---#-#------#-#-#-#-#-#--#-##--#-#-#-#-----#-----#--#----#---------#----#--
#--#-#----###-----#--#-#-##-#--#-----##---##--##--#-##--#------#--#-#-#-#-##-#-#---###--#####-------
--###---#--##---#-----#-##--#-#-#----------##--###--#--##-----#------------------#--#-#--##-#-----##
----#----#####-------#---#---------#-#-------##-#-#--#------#-#-#-#----#-#-##---#-#----#--###-#--#-#
###--##---#-------#----------#-#---##--#--#-#-#-----###--##----###--#----##-#-##--------#-#--####---
-###--#--#----##-#--#-##----------#---#-#-----##------####-------#--#---##------#-#------##-#-#--#--
#----#-#----#-#---###--#-#-------##-#---##------##--#--#---#-----#--------##--#---#----#-##----#----
-###-##--------#-#------#-##----#---##-#-#----#--##--#-##-#---#--#--#---#-##--------#-##-----#-#-#-#
-------##----#-#-#------####--#----------#----#-----##-#-#--------#----#--#---#-#-#--#------#--#----
#--#-----##-----#--#-#------##-##-#--------------##-###-#------##----#------#---#-#--#-#---#--#-#--#
###--#--#----##---#--#------##------##-#-----#----##--##------###------------#-#-#-#---#--#####---#-
#---###----------------#-----------###----#-#-#--##--#-#--------#------###-#------------##---------#
--#---#-#--#-##-#---------###--##---#------####----#-##--#---##--#-##-#---#--###----#-#-#-----#-----
--#---###-#----##--##------------#-#---#------------#-###-----##-----#---#----#-#---#----#--------#-
-#---------#-###--###-----#-#-##-----#--#-#----------#---------#-------#-#---#--#-----###-----#-----
-##--#---##--#-#---##--------#---###----#------###-----#--#-------#-----------#-###-#--#-####--#----
----#---#------#####-#--##--#---#-------#-#--#-#-##--#---#-----#-#-#----#-#--##-##-#-##------#--#-#-
---##-###---#-----#-----#-#-#---#--#---------#-###-----#--#--#-----#----#--#--#---#-#--#----#--##-##
-----#----#---#--#-#--#---#--#--##-#-#--#-------------#----##-#---##--#-##--#---#-#------#----------
---#-#-----##-##-####--#--#----#---##-#--#--###-#-------#-#----##-----#--#---#-----#---##---#--#---#
-------#--#--#--#--#--#-----##-----##--#-#----------#--##-#---#--##-#----##---#-#----#-#--#-#-##-#--
---#-#---------------##----#--#----#---##----#----#-#---##-#-#--#--#-#--#---------#------#------#---
----#--#-#-------##-##-#####-#------#---#-----##----------#-----#-#-#--#--#--------#####--##-------#
--#---###-#---#-###---#-#--------------#----#--#--####---#--#--#-----#------##-#---##--##--##----#--
----#-------#--####-#-----------#-------##--------#----#-##-#####----------------###-#-#-#----------
#---#---------#----------##-#---#-#---#---------#-###-----#-#--#-------#-----##---##--#-#-##--##----
-----#--#-------###-------##--------###--#----#-#-#-----##--##----#---------#---#----#---#----#----#
-##-#--#---#---#-##---##-###-----------------##----#---##-S----##-------#--#---------#----#-#-----##
-#-------#------------#####-------##---#-##-----------------###-----#-#--#--##-##-##---#-#----#-###-
#---#----##-##--#---##----#-#--------###-##-##--#------#-#--#---#----#---#--###-#-##---------#-##---
##---#---#------#--#-----------##--#--------##---##--#---#-#----------------#---#---------#-#---#-#-
#--#-------##-##---#----##-------###-------#-#--##-#---------#--###--#-##---##--#---##---#---#----#-
---#----#--###--#-#--------#-##---#----###--#--####----##-#-----#-#----#---##--#----#--#-----##-#---
-##--#-------------##-#--------#--##-#-#-#------#---#-#-#--#-#----#---#--##----------#-----#--#-#---
-#------#----##---#-#-#-#---####------------------#-------#-----#-#----##-#--#-##-------#--##-E--##-
###-----#---#----------##-----#--#-----------------##-----#--#-----##-##----##---#-----#---#--#---##
--##--#----#-#----##--#--#####--#------#--#-##-#------#--#---##--------#------#-####-------#-##--##-
-----##-#-#####-#------#---#---##-#---####-###-----##-#--#-#-#-##--#---#-----##---#--##--###---#---#
#---#---#-#-#--------#-----##--#-----##---##--#-#---#--##-##--#-#---#-##-##--#--#-#-#--#-----#####--
---##----#--#-##-#-#--------#--#---#--#-#--##---#-#--------#-------#-#-##--------#-#--#-----###-#---
#-##---#--#----#-------#--------------#-#---##-----#----#-------#--##----#-------##--#--#---#---#-#-
---#--#-#---#--------#--#--#------##-#----------#---##-----#-#--#--######--#---#----#-#----##-#-#---
#-#-----#---#-##--#---#-#-#--#----#-###-#----------#----###-----#-#--##-------#-#------##------#----
---#-##----#------#-----#------#---#--#--#--------#--------#####-#-##-----##-#-----###---##-----#--#
--#----#---------####-#####--#--#---------#--#-----#----#--##--------#--------##--#--#-----------##-
--#----#-##---###--#-----##-----#-#------##-#---##-#---#-####--#-----#--#----#-##---#-#--##-----#-##
---#-----#--#-#--#----------#-----#--#-#-#--#-----###-------#----#--#-##--------#--------------##--#
--#-#-----##---#---#-#------#--#-#-#-##--###--##---------#-#--------##--###-----#-#--------------#--
##-#-#-#--#------##--#-------###-##-#------#--#---#-#-#--##----#-----------#-#--#------##---####---#
---#-------#-----##--#-##-----#--------##-#-------#-##-----#----#---#-#-##---##---#--#-----#---#---#
-#---#---#-------------#---#-#-##-##--##---##-----##-#-----####--#-#-#-##-#--###----###-------#-#-#-
--###----#---#--#---------#-----#-#--#------##----------##----#--#----#-#---------##------#------##-
-#-------##-#-#--#-#-------#--#------------#---------##-#---#---------------##-----#---##-----#-#---
-----##---###----###-#--#--#---#-##----#----#--##--#-#-#-#------#---#-#----------#--##--##-##----#--
-#--##---##-#-#----##---------#-#---###--#------------##------#---#--##-----#----####--------#----#-
-#-##----#---##-##-#-----#----------#-#--#--#---#----#-##-----#-#-#-----#-#---#----##-##--###-##-#--
-----##---#---#-------#-------#--------#------###-#-#------#-#--##------#-#-----#---#---------#-##-#