?diagonal=OnlyWhenNoObstacles;
-#------#-----------#--#-##---#--##-#---##----#-#-#-#--#------###-#-------##--#-----#-#-#----------#
-##-##----#-#-#-#---#---#---##---#-#--#-#-------##-#----------------###-#--------##----#-#-#-##--#-#
#----##------#--##---#---#-------#-##-----###-#-#--#------#----#-#--------#-#---------#--###--#-##-#
---##-##------------#-----##-------#--##-##---##------------##-------#---##---#-###--#-#-----#------
#--##--#-----#--#----##-#-#-----#--#-----#-#---##--#-------#---#--#--##--#-------#-#--#------#---#-#
-#----##---#----##-----#-#----##-#---#---#---#---#-----#--#-----#---#----------##-#----------##-#---
-----#---------#----#--##-#--##----###--###-#-#---E-#-##--#--#------##--#---#-#--#-#--#-#-----##----
----#----#-#---------###-#---#-#-#---#-#-----------#-#-#---#--###--------#--#--#--#--#---#---#----#-
------------#-#-#-##----#----------####--#-#-#-##-#-#-##-----##---#-----#--#---##--###-###----##-#-#
##---#--#-#-#-#---#----#---##--##----#--#--#-#----------#---#--#---#-----##-#-#----#--###-#----#--##
##-----------------#--#---#----#----##----#--#---#--#-#-##----##------#---#--##--#-#---#----#-#-----
####--------------##-###--#-------#------##-------#-----##----#---#-----#--###-#---------#-#---##-#-
--#---#-#--------##-----------#--##-----###-#-------##----#--------#---#---#----#--#--#--------#----
--#-#--#-#-----##-#-#---##---#-#-#---###--#---###----##-##-#--##--#-#--#----#----####-------#--#-#--
#-#-#--#-----------#-----#-##------##-##--#----#--#--#----#-##-------------##-#####----#--------#--#
-----#----#-#-#--#--#---#-----#--#----#-##-#-#----#-#-------#----------#--#----#-----#-##---#-#-#-#-
##---#-#---#--#----##-##----#----#---#-#----##-------####--#--#--###--###-----#------#-##----------#
--#--#-----#----#--------#-#---#--#-----#---##---##--#-----#--#----------#----##---##----##-#-#--#--
---#-#-#-#-#-#--------#----##--#------#----#--#---#---##-#-#-###---------#--#----###--#-----#----##-
----#-##-----------#--#----#--##-------##-----#-##-###----#----#----#--------##--#--#-------#---#---
#-##-#-#--##-##-#----#--##--------#-----#--#-#---#-#--#-#-##----#-#----##-----#-####----#-##-#---#-#
---##-------#-----#---#-#----#-#--##-#------##-#-#--------#---#----##-----##-#--##--#-#----#--##----
---###-#-###-----#----#----#-#--#--##--#--#------###-----#----------##---#-----#---#------##--#-----
-#--####-----####-----#---#-----##-##------##-#-#---#-----##-#---#-##-#--#---#-###----#-------#####-
#--####--#----#-#----##--##------#---------#------#-#-----###-##-#-#------------#---#------#---###--
-----##--#---#-#--##-----#---#-#--#-####--#-----##------##--------#-----#---##---#---------#-#--#---
-#--#----#--##-#-#-------------#--#-#--#-#--##--#--#--#----#-##-----#-------#-------#-------###-#---
--##--#----------#------#------#--##-#-##-----#----#-----##--#----#--#---#--###---#-##--#-#-###----#
#---#-##-------#-#----#---#----#---------------#--------#----##-#--#-----#-#-#--#---------#-#-------
----#----#----##---#--#-----#----#--#-#---###-#--#--###----------#-#-------#-----------#----##------
--#---#-#-----##-#---#--#-----#-##----------#---------#-------#----#--###----##-------##-###--------
------------##---------##-#-#-------#-#--##--##-----------#--#-#-----#---#---#---#--##-----#-#---#--
-#---#---#----##-----#--#-------#-------#---#------##-----#--------###--##--##------#-##-###-#-----#
-###----#-----#-####------#--#--#--#---#-###------#--------#-#-#----#--##------------#--------------
##-#-#-#--#-----------#--#---#--#--#----#--#---###---##-##------#--#---#--#--#----#-##---#--#--#-#--
---------#-#--#-------#---###--#----#-####-##------#-----#--------#-----##---#------##-#----#-------
----#-###---##---##-##---#--#--##-####-----##-#-#-#-#-#--#-#--##------#--#------------#-#---#----#--
#-##-#---#--#-#---##---###---#-#---#-##------#----#---#-###------#-#--------------#---#-#---###----#
-------#--#---------#-#-####----##-#-##------#-##----------#--#-##---#-####-#--#--#----####-#-------
----#-##------#--#-#-------###------#--#-#--##--####---#---#--#--#---#--------#-----##---#-----#----
--#--####--##--##-##------#-##-#-#-----#-----#-#--------#-#-##----#--##----#-#--##--#---###-#---#---
#---###---#-#----#-----#---#-#--#-#--#--#-##------------##--#-----#-#-#-#---##-#--###-#-###-----###-
##-#---#--#-##----####-#-------#-#---#--#-#---#---#--#----#--------##----#---#--#-#---##--###-----#-
-----###---###--#--#------#-####-----##------###--##-#---#-#----#--##-----#-#-#-----#-#-#-##--#---#-
-#-##--###-#-#----#--#-#---------#---------#--##-------#------##-##-------##--#----##-----##-#--#---
-#--#--#--------##---#----------#---###-#-###---#-#-##--######-####---##---#--#-##----#-#--#-----#--
-------#---#-###--#----#----#-#---#-#-----------#-----#----##---------------------#--##--------#----
##----#----##----#-----#-------#--#-#--#------#----##------#--#-#-------#----#-#######-----#----#---
-#-#------#------#--#------#---#-#------###---###--#--#-------#---#--#---------#-#-#----#---##------
-#--##-###--#--###-#-##-#--##-##-------##-##-----###--#---#-#-#-----#-##---##----##----#-----#-#-#-#
#---##-#--####-#---------###------###-##--------#------#---##-#-#-#--#-------#-----#------------#-##
---#--##---##--##-------##--#---------#----#---##---#------#-------#--####----###--------#---#-##---
---#----#----###------###----#-------#-#--------##---##--#-----######---#-#-#-------#-------------#-
-#--#-#-----#---#-##------------------#--#--#--#----#---#-#-----##-#----#--#--#-#-#--------#-##-#--#
#---#----##-----#-#-#-#####-###----#---#----------##--#----#--##--###-----#-#--##-#---#-#---#---#-#-
------#-----#-#-##-##-#-#------#---#---#----#-#-#-#--#-#-----##---#-####-#-------##------#--#-------
##-#-#-----#------###-#-----#---##----#-#--#--#-----#---#---###---#--#----#-----#----#-----#----##-#
#----#--#--##------#-#---##----------##-------#---##-##--##-#----------#-#-#-##------#----##-#----#-
##----#----#-#--#-----###------#----#-##--##-#--#----#----##---###----#--####-#--#-###--#-##-##--#--
-----#-##----##---#-#-#----#-#-----#---#-#--###-----#--#-------#-----###-#----##-------#-----#-#--#-
-#---##------#--#-#---#-------#-##--#----#---#--##--#---#-#--#-----#--#--#--#---##------#-#---#-#---
##------###--#-#--##----#------#---#-#------#-##--##-----#-#-####-#----#---#---#--##-#-##-#----#----
#-------------#---#-##---#----#---------#----#-#-#--------#-##-----#-#-#---#----#-----#--##----#-#--
-#--------##-----#--#-#-##-#-#----#----------#---#-----#-####-----##---#----------#----#---#-----#--
#-###----#--#--#-#-#---#---#----#-#--#----#-#--#---#--#--##--###S--#--#---#----#--#-#-----#--##-#-##
-#-####----#---###-#---#-#---##------#--------#-----#--#---#---#---##----#-----##--#-##-#----##-#-#-
###--#-###-----##---####-------#---##--#--###----#--#-###--##-------#---#-#-##----#-#-----##----#-#-
-#--##-#----##--#---#-#--#-#----------##--##------##---####-----##----------#---#------------#-#-##-
###-#-------#------#---#-#-----#-#-#-#-##-#-#-#-#--------#----##----#--##---#-###---#----##---#--###
---#---#---#--#---------##-#---#-------------------#------#-#-#----##---#-#-------##-----#------##--
-#-##-#--#-----#-#----#--##--------#-#--##--#----#-#----#-###-#---#---#-----------#--------##-#-##--
-#---#-#-###-#--#--#------#---#------#---##-------##---#---#-####-#---##--------#---##--#----#--#-#-
-#-------##--##----#-------##---#--#-------#---#--------##-#--#-#-#-----##--#-------------#----#----
-##--##--#--------##--#-#----#--------#--#--#---#-----#-----#-#-#--##-#-##---#-#--#-#####---#---#-#-
---#-----#---#----##---#--##--------#---------##----##--###-------#-#----###----#---##--#---#--#---#
---#--#---#-#-#--##-##-#---#-----#----------#--##--#-#---#--------#--#----#-#----#-###--#---#--#----
-#-----##--------#-#-##---#--#--#-#-#--#-------#----#-#--##----#------##-###--##---##-###-#----#--#-
#--#-------#----#-#---------------###---#-----#-----###---#--##-#-#---------#--#--#-#---##---#------
--#------#-----#-#---------#----#--##---#--#------------#-----#--#######-##------#--#--##--#---#----
-----#--------#-#---##-------#-#----#-#--##----#-#----###--#----#---###---#--#-#--#--#------#----#--
-#-----#---##---##-#--#----#---#--------##-##--##--#-------#--#---#-------#---#-#----#-#---------#--
----#-##-##-#-------###-----#-##-#--##----#-----#-#--------#--##----#---##-#--#--##-###-#-#-#-##--#-
-#----#-----#--#------####---#--#-##----#---#-##-#-----#----#-##---------##---------###-##-#---#--#-
------#-#----#---------#-#----#----#--#----------#----------#--#-#-#--#-#-------#----#-#-##---#--#--
--#---###--------#-##----#--###-----##-#---#----#--------###------#--#----##---#-----##-----#-#-##-#
--#-#----#-----#--------###--#-#----#--#-----------##---#---#--####--#-----##---#-#-#---#-#------#-#
#--##-#-----#-#------##--###-#-#-------##--#--------#-#-----------#---#-###---#-#-----#-###---#----#
-----#-###-----##-------#---##-#-#-##------#-###-----###------#-----#--####-#-------##--#---#---#-##
-------#--------#---#-##--------#--###-----#-#--##---#####--#--------#--#--------#--#-----#--#--#-##
-#---##----#--#-#-----#--#-#----#------##----#-#----#----#----#--#---#-----#--#-----#--#--##------##
---##-#-##-#--##--#----#-#--#-#--##-#-#-#--##---#--#---##-------#-----##-#----#-#--###-----------#-#
---#------#--##--#-----#-#-##--####-----------#-#-##------##--#------#----##--###-#-------#---#-#-#-
-----#-#-#----##-------#------#-####--#---#---#---#-------#-#-----##---#####--##-----##--#--#-#--#-#
----#-#--##-#-------#-#------------#-#--##------#--#----#---##---#--##--#---------#-#--###-#----#--#
#---#-----------#---#----#---#-#-##------#----#-#-#----##-#--#--------#---###-#-##----##--##--#---#-
##-----#-----##--#--#--#-----######-#-#-#-###-#--#-##-----------#-------------#-#----##-#--###------
-#-##--#---#-----##-##-#-#--#---##-##-#-#--####-#----#-------------#-#--#-#----#-#--#-##--#---------
#-##--#---#--##-----#--#-#-#--#--#-#----#--#--#----#--#-#--###---##--#--#---###-#--#----##--#--#--#-
-##---#-#---#-#----------#-#-#-------#-#---#----#-----#--#--#-#---#--#-#----###-#---#-#-##----#-----
-----#-###-#-#-------##-#------#----#-------###--#------#----#--#----#----#-#--#-##-#-##----##----##