?diagonal=OnlyWhenNoObstacles;
-----##----#-------####--#-#-##---#-#--------------###--##-#-#-#--#--#--#-#-#---#--#-------#-#----##
---#-#---#---#-#-----#------###----##------------#--##-#-#----#-#-#-#---#-#--##------##----#-#-##-##
---#--#-----#----#------#-#--#---##--###---##---#---###-------#--###---------#-#--#--#---#----------
---#-#-#-##-#--#---##--##---#-#---#--#--#-----##-----#--##--###--#---#----------####--------#-##---#
----------##--#-----------------####---#--#-#-##---------#-----#--#-##------#-#-##-----------#------
###------#------------#-##-#-----------#-#--#--#--#------###-#----#--------------#---#---#-------#-#
#--#-##-#-#--#------#-##----##-#--##--##----#--#----#-----##--#-----#--##------#-#---##---#---####--
-----------#-#---##--##-#-###--#-#------#--#-#--#-##-----------#-##--------#-#---#-#########-#-###--
#--#--##-#-------#-#-#---#-##-----#-------#-#-----#-##-#-#---#----#-#####-##----#---#---#-#-------##
-#-##------------###-#--##-#--#--#--#--##--###--#--#------#-#---####-#-#------#---------##-###----#-
-----#----##------#--#----#-----------#-##-##--#--------#---#--#-#-##--#---##--#-#-#---##-------#-##
#----#--#--#-#-#---#-#--#---#-#--###-#-##-#-#--#-----#-#--#-#--------------#-----#-------#-#-#----#-
------#-#-----#----#####--------#--#---#-##---#--------###--##---#--###--##--##---#-##-#------------
-####----######----#------#--##----------#--#--####---##--##---#--###-----#--#-#-------------##--#--
------##-#------#-##---#-----#-##-------#---------#-#------#---###---#--###--#--#---#--#------#-----
##---##-----#-##-#-#--###--###--#----##-#-#------##-#---##------------#-#--##-#----------#---#-----#
-----#-#----#-----#--##-#---#-##-##------##------#--###---------#---#--#-###-#--#-##-#-#--------##-#
#-#-####-#-#--##---#-#---#-------###--#-##---##---##----------#-##--#--#-##---#--##-#--###-#-#-##-#-
--------###-#-##--######---#-#---###---##-#-#----------#--##-------#----#-##-###-----###---####----#
-##---#----##-#-#-##---#--#----#-#-#--#---##-#----------#--#------##---------##----##----#--#----#-#
#--#----#-##-#--##---##---#-----#--------#-#-----#-#---#--#------------#-#-##--##---#----#-#--##----
----#--#---#--##--#---#-##-#---#--#-###-#-#----#----###--#--#---#-##---##--#-#-#####-#--#---#------#
#----#-------#-------####--##-----#------#------#---###-###--#-#---#--#----#------#----##-#------#--
-#--#------#------#-#-#----#-#-------#-#---#-#--###-----------##-#------#--#---###-##-------#---##--
#---#-----#-#---------#-#---#---#-#-#-----##-#---#---#-#---#------#-#--##----#--#-#-#-#------##-----
---###---#--##---#------#-#--#--#--#--#-----#-----#---##-#-------###--#-#---#------#-##---#----#----
---#-#---#-------#-#---#-##------#-##-#-#------#---##-------#----#--------#---#---#------#--------##
-#------#----#-----------##---###--#----#-##---#-#--#-#--###-###----#-#---##--#-------#-##--#-#-----
#------#---#-----#------#--#--#--#---#--#---#---#-##--------------#----#-#-----#-#--#----#---#----##
------#--------##-----#-#--#------#-#--###----##---###-----#----#--#-------##-#--------##-----#----#
#-#-#---#---------#--#-##--##-##--#----####--#-----##--#---##-#-#----#------#-#--#-##----#---##-----
------#####--##-#----#------#--#-#####--##----###---#-#--##--#----#-----#--##----#----#-#-----#-#-#-
---------#-----#-##---#----###------#--#-----------#------###-##-#-#--#--#----------#---------------
---------------#-####----#--#---##-------##-#--#---#---#-#-##----##------#----------#-#---#---##-#-#
---#-###-----#-#--#-###---#-----##-##-##--------#--#--#--#------#---#---------##-#-#---##-#-#--#---#
--##------#--#---------#-----#-----#-----#--#------#-------#----###-------#-------#---#--#---#-###--
#--##--##-#---------##--##-#-#---###-#-#-#----#-##------###---##-#-----##--#----#-###----##----#----
-E---#---#----#--#-----#-----#-#--##--#--#-##-#---#--##--#----#----#-##-#---#---#-##--------#-------
-##-------#--#-----##--##--#---#--##-#---##-#----#-----------#-#------------#---------##--##-#-----#
--#------##-##-#--------##---#-#-#--#---------#------#---#----#-#-##-#-#---#----#-----#-##---#---#--
--#-#-##-#-#-----#-#--##---#-#######-#--###--#-#-------#---#----------#-##---#-#------#-#-#------#--
###--#----#---#####--#--#-##---##--#-----#---####-#-----#------------#-----#-##---#-----#--#--------
-----#---##--#--#--#-------#--#-##----##--#------##--#--#-#--#---#--#--####------###---#--#-#-##-###
-#----#-#--###---#----#--#--#-#--##-------------#-------#-##-#-----------------#------#--#--#-#-#---
#-##--###------#------#--#####----##-##------#--##---#-----#-------#----------##---###---##---#---#-
-##----#----#--##-#--------##-###-------------------#-#--#-#----###--#-#---#-#-#---#----#-##--#-----
-####-#--##--#----#--#--------#-------------#-------------##-----#-----#-----#--------------#-#----#
----#--#-----#-#-#-#-#----#----#---##--#-------#---##---#--##-##--#-##--###------##----------#-----#
-----##----##-----#-#----#-#-#-#----##--#--------#----------------------#--#-#-----###--##--#-#-##-#
----#####-#-------#---##--##--#-#------#---#------#-#---#-----#---#-#----#--------##-----#-------#--
#----#---#----#--#-#--##---#--##-----#-----#--#-#-##--#-#-------#-##--------#-#-#-#-------#--------#
-------#--#-##---------###-#---#-##-----#---#-##---#--------------##-##-#----#-##-##-#------##------
-#--#-#--#------------#---------##---------##--#-------------####-##-----#--##----##-##-----#--#--#-
----------#---#---#-#-###----#--#---##--#-#----#-------##-----#--#-####-#-#-#--#--##---------#-#--#-
---#-----------#-----###---#-#----###--#--------#--##------##------#--------#--------#----#----#-#-#
-##-#--##-#-------#---#--#-----------#----#---#---#----###---#----#-##-#-#--------##-----#-------#-#
-------#--------##---#-----#---#------#--#--###-#-#---##--#----#---#--##----------#-------#----#----
--##----#------##---##-#-----------#---#-#-----#--------####----------##------------###----###---#--
-####----#----#---#--#-----------#-#-#-#---##--#---##------#-#-------##------#------#--#---#--#-----
-#------------##-##-#-####---#----#----#----##---------#-#--#----###-#-##----#-----#--#---#------#--
#--#-#----#-#--###--#--#-----#-#-###-#---##-----##-----##--##---#--#-#-------#----#-#------#----#---
-###-#-##---------#--#-#--------#---####--#--##-#---##--#--##--#-----#--##-###---#----##-#-##----###
--#---#--#--#-----#--#--------#---#----#-##---#---#-##-#-#-#--###------------#--#---#--#--###-------
---#----#--------#---##----#-#----#-#-----------##---###---------#--###----#---##--#--###-----#--#--
#----#-#-#--##--------##---------------#---#------#--#----#-----###---------#-----#---#---##----####
---#-#----#--##-#----#-----#-#-#-----#-#-----##--###------#---#---#-#-------#----#--#------##---#---
#-#----#-----------#----#----#-##--#---##-##---##-#---#-#-#-#--#------##-#-----##-#-----#----#-##---
-----------#-##-#-------#------##--#-#--#-#-------#######-#---##-##---#-##--#-----------#-----------
----#-#---#--#----#---##--###--##----##---#------##---##-#--##--##--#---###-#-----#-#-#----###--##--
---##-----#-----#-#---#------#--####--##----#-------##--#-#---#---#----------#---#-------#--###-----
--##---#-#-#-#------#-##-#-------------#----###-----------##-##--#---------#-#--##-----#---#---##---
--###------#####-#--#------------#---#---##----#-----#-##--#---#-----##---###--------S-----#------#-
----#----#-#-----##------###-#---#-##-##-#-#--##-#--------------#----#------##-----##------------#-#
#---##-#---#-----##-#-#---------#-#-##-----#------#-#-------------#-###--####---##-----####--##-#---
----##------##-##--#-------#--------------#####---#----##---#---###------#-##--##--#-#---####---#---
-##--#---#---#---#--#-##---##--#-----#--#-------#-#---#----#---#-#-###--#----#----#--#--#---#--#----
-##-##------#--------------------------###----##--#-------#---#-###-#-----#---#--#---##--#-#-------#
---------#-####------###--#----##-##-###-----------##--#--#-#--#--##--#--#-----#--------#---#-#--#-#
--#--------##----#--#---#----#----###-#-#--#---#-----#-----##-----#-#--#-#-#---##--#------------#---
-##--####--#-#-------#-#-#-#--#-----#--#--#---#-#-#---#---#---###--#---###---#----#-------##------#-
#---#---#-----#--#-----#--------#--#----#-##------#---#-------#---#-#--#------###-#---#--#-#---#---#
--#---##--##------##-#----------#--##--#-#-----#---#--#-----#---#-#-#----####--#--#-#--------#-#---#
-#-#--#--------#-#--#--##--#-#------#-------##-###-#--------------------#-#-#---####----#-#####-----
##--##------#--#-------#-##-##----#-##--#---#-#-#--###-####--##--##--#-----#-#--------#-#-#---------
#--------#-----#----#####---#---#----###-#-#-#-##-####---##--#---###----##-------##---#--#-#-#-----#
----#-###-------#-#---#-----####--#-#-----#-#----#--#------#-##-##-#--#--##----#---#--#---#-####----
-------#--#-------#-##--------#-##-#-----#-#-#-##-------#---#--#---#---##---#--#--------####----###-
-##----#-----#-##-##-----#------#-#---#--#-##-----#-#-#-------###---#-#--#---##-#-##--------------#-
-----#--#---#-------#-##-#----#---##-#--------#-----##--#---#-#--##--##--------##------##-#----####-
----------#-#-#---###-----#-#----##--#-#--#------#####--#----##---#-#------##---##-----#----##------
#---#-#--##---#--##----#-------#--#---#-#---------#-#---##-#---#-###---#-----#-#-#-#--#----------###
------------#---##--#--#--#--#--#---#----##-##--###-#-#----#---#-----#--#--###---#-#---------------#
#-#-#-----#--------####--#-#-----#-----###--#-----#--#--------#-#--#---------###-#-#-#---#####-##-##
--#------#-----#-#-###-#--######--#--##----------######------#-#-#--#-#-#-----#-#--#-#-#--#------#--
----#---##--------###-#------##----#------------#--##---#-------###----------##--##----#--#--##-##-#
------#----#---#-##--#-##---#-#--#-#------#---#-##------##-#-----##---###-#--##-------####------#--#
--#--#--#--#--#----#--####-##----###--#-----###-#------###-#-#####-------------###-###-#-#-#-----#-#
-#--###----#--#-#-##-#------#-#-##-#-------###----#-#-----#-----#----##-----#-#-#-#--#-#-###-----#--
----####-##--##-------#--#--#-#--#-#--#-#----#--#-#-#-----#--#-#----###-------#-##--##-#-#---------#
--#-------------##-#-#-#------#------#--#-#-#-----#---#--#---#---#-----------##-#-##---------#----#-