?diagonal=OnlyWhenNoObstacles;
------##-#------#-----#---#--#--##---#----#-#------------------##-#---#--##--#--#---#---------------
#--#-#-#--#-##--##---#-----#-#---#-#-#-#------#----#---#---##--#-----#-##-#-###--#-#-###-##--#----#-
-###-##--------#----##---#---#---------#-#####------------###-------##----##-##--###-#-----###---#--
##------#--##--------#-#---------##--#---#---#-#-#----#-#--#---#--##--#---#----#----##---####----##-
#---------#------#-----#---#-#------##---#####-#---#--#---#-#---#------###-----#-#--#-##--#----#----
--------#------#----------##---##---##---------#-#-------###--##-#-----#####-###---#----###---#-####
#-#--##--#---#--#-------------#--##---##--#--#-#---#----#-----#----#-##-#---####----#-#----#----#---
##--###----#---------##---#-#-------###-#---#-####----#------#------#-##--#---#---####-#---#-##--###
--#-#---------------#--------#-#-----#--#------#--##-#--#--------#-#-----#------#--#-#------####--##
#----##-#-----#-##-##----#-#-#------#----#--##-##---#-##-#--##---#--#-###---#-#---##---###---#----##
-----#------###---#-###---##-#------------#-----###--#-----#-#--#---###-##-#-#----##-----#------##--
#-------------#---#-#--#-#-#--#-------#-#----#--------#--#----#---#-#--#---####-##--#-#------#------
#----##--#-----#####---###----##-####----#--#-#----##-#--#-#---#----#-#--##--#---#--#---------------
#------#---#-#-#--------##----##--##--#-------#-##---#-#---##----#--#--#----##--#--###-#--#---#-----
----#--#--#-----#---##----#---------##-----#------#-#-##---#-#-#-##-##-------#----###---#--#-##--##-
--##--##-#----###-#-##--##-#-----####------#--#-#--#-#--##--#--##----#--##---####-----------#-------
-----#-----####------#-------#----------##-#----#--------##-##----#---#####-#-------##---#-#---##--#
--###-#-##---##-----#-#--#-#####---#-#---#--##--#----#-----#--#-----##----##-#-#--##-----##----#####
--##-#--#----------#-#-#-#--##---#-------####--#------##-------#--#-#-#-#------#-#-----#------#---#-
##--#--##----##--#----#-###---#--#--------#--#--##--#----###------#-##-------#--------#--#-##------#
----#----#-###---#---##---#-------##-#--#--#--##--#-----#--###-----#-#---###-------#---#------#-----
-#--#----#--#---##--#-#--##--#------#------##-------#----#-#-####---#-#--#-#-#-------------#-#-#----
-##-#---#-###----#-##---##--#-#---#--###-##--#-#-#--#---#----##----##---#-----##--#------##-----#-##
--#----##------##--#----------#-###----#-##-#--####-##-----##--#-#-------#----##-#---#----#----#-#--
#-#----##-----#-#-#---##---##--------------#------#--#-----#--####-###-#---#---------------##----##-
-#--#------#-#--##---------#---------###------#------#---#-#-#--#----##--#-----#--##-#-#---###-#--#-
---##-##--#-#-#--#----#-#----#-#----###---#-#--#---#---##------------#-----#--#-##----##----##--###-
--#---#--#--#-----#---#--#----#----#-####-####---#-----#-#-##-------#--##-----#---#--#-##-#-----#--#
--#--##------#-#-----#-----#-----##-#--#-#---##---####-----#----#-#--------#---#---------#---##-#-#-
---#--#--#-----------#------###-#---------#--#-#######--#--##-##-#--------#--#---#-#--##----#-##----
-#-#-------##-#--#--#---##---#------###-----##-#--------------#--#-#--#------------#----##--#----#-#
-##-#---#-#--------------##-#---#-#--##---#-#-#------#-----#-#-##-#--------#-###--#---#-#----#------
--#-----#-----------------#--##-------#---#----#---#----#-----#-#---#----#--#----##-#-#--####-------
--#--#--#---##---#-----##--#---#-------#--------##-#---------------#---#---#-#-----#---#-#--##-#--#-
--#----#-###-##--#---#--#------##-#---#-##--#-----#---###---#-#-----###------#-----##---#-----#-#---
---#-#--#--#----#--------------####--#--##--#----------#-#--#-#-#---#--##-#---------##---###-#---##-
##---##-------#--##-#---##----------------#---------#--------#---##-#---##----#----------##--##-----
##---#--#----------#--#-#----#--#-###-------##--###--##-#-##----#------#--#-------###--##-#----##-##
---#-----#---#-----------#--##----#-----##---##-#--#-#---#--##--##---####-#--#-#--#--#-------#------
-----#----#-#--------#----#---#--#---##-#---------##---#----###--------####--#---#--#-##---##---###-
-----------#--#--#----#-##-##----#----###-##-#-###-#-----##-##--#----------#------#-----#-#---##-##-
---#--##-#-#-#--#---#----#-#----#-#-----#-#----##--#-#--#-------#-#-#--#-##-----#-------##-#----##-#
----------#---#---##-#-#-##------##---##--#----#----##--#-#--------#--#----#--##-#--#------------#-#
----##-#----------#---#-#-------####---#--#--##--##-------#---##-----#-------#--#-#-#--------#------
-#------#---##---#--#---#--##-----#-----##-----###--#-#-#-----#--##--#---#----##--##---##--------#--
#-----###---##-#-###---#-----###-#-----#--##--#--------##--#--#---------#----#-----#-##--#--#------#
#--##----##-#---#--##-###-#-----#----##-#-#--#--#-#-#---------####---##-#-----------#--#--#------#--
---#-#---#-#----#----#-#---#------#-##-----##-#------#--##-#---#----####-#------#-##-#-#-----##-#--#
------####------------#---#---#-----------#--#--##---#--#---#-#--##-#-##--##---##-#---#-##-#--#--#--
#---##------##------------#-#--##------#-#--#-#------##-#--##-#-----------------#-#---#----###--#---
----#------#------#----###-#--##---###-##----#-----#--##-#-------#---###-----###------#-##--#-#--#--
--###--#-#---#----##--#-#----------#--###-#-----##-#-----#--#--###--#-#--#-#---#-----#---#---#-#----
--##---------#-------#-----------#-#-#------------##-----#---#--#---#---#---#----#-----#----#-#-----
-#---##-#-#-##--#------#---#-#-#-----#--###--##---#------#---#-#---#-#-----#-#----#-#--#-##--#-#--#-
--#-------##--#-#-#----#-##---#---------------#-##---#--#-#-#-#---#-------##------#-----#--#---#-#--
##--#---#--#--------#---###------##----------#------#-----#-##--#-##--#--#-#---#---#-----##-###-#-#-
#-----#----#--##---#-#--#-#----------------#--##---#-#-----#-----#-------#---------#-#----#---------
###-------##--#-##----#---#--###------###---#--#--#-#----#-#-------##-----#-----#---###-#---#-#-----
-------#-------#-------#------##--##-----#--##------#-##-#--#--##----------#-------#------------#---
-#-----##--#-#----#-----#----#-#-#--#-------###----#-----##---#------##-----##--##-----#--#---#--#--
----------------#-#--##--#--#-----#-------#-#--#-#--#-----#--#------#-#---#-----###--------#-##-#---
------##-##---------#---#------#--#------###-###---------#---#--#-#----#-###--###--#-#------##-----#
-----#---#--#---#---##-#-#---------#-#----------##-------#--##---#-----#-#-##--#-##---------#----#-#
-------#-##------#--###-------#-#---#-#--###-###-------#-----------##-----#-------------##---#-###--
-----------------#-##----#--##-##-#---------------#------#--#--##-#--#-------#-------#-#-#--#---#---
-#---###---#---#-------###--#---------#-##---#--##----#--#-##---#------##-#--#-----#---#-##-#-#----#
--#------#--#-----##-#---#-#-#--##---#-------#-------------##---#---##-###-----#-----#-##--##---#---
-#--#--#-#-#-#-#-##-##-#-------##-#-#--#--###-#--#-#-----##-#--#-#-------#-#-----##---#--#--#-##-#-#
---#---#---#---#--#--#-#-###-------##-----##------#---##---------#-------#-------#----#---#-###-###-
-----#-#--#-------#----###-----#----#------#-##-#-#--##-----------#-#--##-#-#-----#---##-#---#--#---
-##-------#-#-#----##------#-----##-#---##-#-----------#--###-#-----#-----##-#------#-#---#----##-#-
------##-##-#-#-#-#---#--#--##----##--#---#--####-#----#-#-----##----#-----##----#----##---##--#--#-
--##--#----##-#----#----------#---#---#-##-------------#-##----#--#-#-#-#------##----#--#-------#---
-------#----#-###--#----------------###-#----#-#-##-------##-#-#------#------------##---#----##--#--
------#---#----#--#-##---#--###-#-##------#--------#-----#-##------##-#--##----#--#-#-#-#--##-##---#
#--##----#-##--------#-##--#---#--#-#--#--#-----##--------#--#-###--#-#--#--#--#--------#----------#
-#--#----#-#-#-------#---#-##------#---#-----###-#------#--######--#----#-#--#-------#--##-#-#------
#-----#-#-#--#-------#---#-#-###-#----####-#--#-#-----##-####-S---#--##--#--#-----#---#---#-##------
---#-----##-####--##-##--##------#---------#--###----#---#-----#-#-#---#----##-#---##--#------------
#---##----#-----------##--#-----##--#--##--##----#-#---#-#-------###--------##--####-#-#-##---#-#-##
-#-##---##--##--##-#---##--###--#---###-------##-##-##--###---##-#---#-----#--#--#-###-##--------##-
---------#--#-#-----#-#--####-----#-##--------#---##-#-#----#----#------##----#---#-#-------#-#---##
--#-#---#-----#--###-#-##------##------#----##--#-------#--#--#--###----#------------#-#-#---#-#-##-
#-------#-#-##-----##------#---#--#------#--#------#-#-----#--------##-----#####--##---------###----
#------##-#-------#------#-------#---#-#--#--##--####-------#-#-------#----#--#-----##------#---##--
-###-------#--#-#--#-#-#---#--#-#---#---#-#--####---#----#-------#-#--#-#-##------------###-#--#-#--
-#----#--#--#------###-##-------##------#--#----#-----#---##-#--#---###--###---#------#-#-##-#-----#
#-#--------#-------##----###-##---#----------##-#-#--#--#-------#--#-#----#-#---##-#----##-##-#---##
#--##-#--#-----#---##--#-#--####---#-#-#--##-#----#-#---#-###----#--#---#-#-#-###---#--###--#------#
###-----##---#---#-###-#---#---------#----#--#--#-#--#----#-#--##--#-----##-#-#-----#--#-###-#------
----#----#-#-#-##----#---#-#-----#--#-----#------###---#-#--####--#----#-#-##----##-#-------##--#---
---###--------#---#---##----#-##-----#------#--##-------------#---------#--##---#-#-----#-#-#-------
--##-------##---#-##--------#---##-----###-#-#----#--------------##-##-#-#-#-#-##-#----------#-----#
-----#----#---#--#-#---##-#---#-#-###---###------------#--#-#--#---##----##------#--#--#---#--#-----
#-#------#-#--#--#---------#-----#--###--#-#--#------#----E##--##-#-----###--#---#------#-------#---
-------#-#-#--#--##---------##--#-###-#---------#--###-#----#------#-#-#--#--#------#---------#-----
-----------------#-#--##----#-#--#-#--#--#---###--#-##----#--#-#-##-----#-----------##----------#-##
#-----#------###------#-#-#-##-#---#--##--##-----------##-#----#-###--#--#------#--#---#------#-#-#-
##-----#--#--#--#--#-#-#-##-----#-#-------#-#-----####-----#-#--#--------#--#-----##---------###--#-
#-##--#-#----###------#--#--#--###--###-#-#-#---------##-------#---#-#---------##--#-----##-##--#---