?diagonal=OnlyWhenNoObstacles;
--#-###--#--#-----#--------#---#-----#---#---------#------###--#----#---####------------#--#--##----
-#--#-----------#-##------#----#-#-----------------##-----##--##---#---#------#---#--###-#----#-----
-------#--###-#--######-#----#----#-#-----#----#----#--#-##-##---#---#-##--#-------#---------##-----
##-##-##--#----##------#---#-#--#--#####---#-#-----#-#-#-----###--##---##-##--------#--#---#-----###
#-#----#-#--#--#---#----####--#-#-------###----#--##-------##-#------#--####-#-------#-#--------#---
-#------#---#--##--#----##--#--#--#---#-------#---#---------##---#--#-#----#-##-----##------##-----#
#----------#----#-#-------#--------#-###---------#-----###-#--------#--##----#-##---#-----------#--#
-###-----#-#--#------##-##-##-#-----##--##--#-###-##-###---##--##----#-#-#-#---------#-------#---#--
---##-----##-#-#--#--#---####---#----##--#-----#-#--#--#-#--#-------#---#---------#---##-------#----
--#-##-#-----##-#-----#-###---------#-----#----#--#-#------------#--#-##-#--#----##--#--#####---####
#--###---#--##---##---#-#--------#----#-#-----#----###----#-#-##-----###-#-#---#--###--#------#---##
#-###-#-#-#----#--#-#--###--------#---##-----#----##--#------#-------#--###-###-----##-#-----#---##-
#-#-----#-#--#----#---#--#-###--####--#-#--#---#-#--#--#----------#-#---------#-----#-##------#-----
-------##----#-#-##-##-#---#-#--##--#---#---###--#--#----#----#---##-#-##----------#---------#------
---#----#-----#-#---#--#--------#-------#-#-------#--#-#---#-##----####-#-#--###---#------#-------##
##-##-#--#--#----#-##------#--#-------#-#-----------#---#-#-#-##-----##-----------##--###-#-------#-
-----#---#-------#--#-#----##------#-#--##------#-#-----#-###-##-#-#------#-------##------#-#---#--#
#-####---###-------#----#---#-#--#-----#------#---#------##-#---##---#-#-----##-#----#-#--###-#--#--
-#--#-#---##----##-#-----##---#----#-##------#-----###---#-#---------#-###---#-##-#-----------##----
-------##--#-#-#---#------##-##-#--#----#--#--#----------#--##---------#-#----#-####--------------##
----#-----#-----#-------#--###--##---#---#-----####-#-#-#------#-#-###----##---#-####------#-###-#--
---#-#-####-------------#--#-#---##------#--#---#---#-----#------##--#-#-------#-------#--#--##-#-#-
-----#-#--------#-----------------#--------#-#-#---#---#-#-#-----##------###-#---##--------#-#-###--
-#-#----#-----#-##--#-------#-##-------#-----#-#---#------#-#---#--#-----#----#-##--##------#-------
#--##----#-------##-#-###--#--##--##--#--#----##-#--#----------#-#--#-#-#----------#-##------###--##
----#-#-----##-----#--#-----##----#--------#-----------#-#-##--#------#----#--##-#-#---------#---#--
----#-##---####-----#-----##----#-----#-###----##----#--#---##------##---#-#--#--##-#---#---#-------
----#--#-------#--#---##--##-#-##-------#---#-----#---#-##---#--#--------------#--#--#-#--#---#--#--
----##--#-#--#-###--#-#------#--------##--#-#--#--#--##----#-##--#-#-#--#-----#---#---###-----------
------#------#------##---##----#--##-#-#--#-----#--#-#-------#------#------#-#--##------#-------#---
-----##-###----#---#--#--#----#--#--##-#----###--#---------#-----#--#-#---#-#--------#---------#-##-
---#--#--#--##------####----#--#--------#-#---------------##------#-#---#--###-#--#####-----------#-
#--##-------#--##--##-------#-#-##-#-----------##----##--###-------------##--#-------##-----##--###-
--------#--#-----------##---#---##---##--##-##-----##-----------#-#-----#------#-----###---#-#--##--
--#---#-###---##-#----#--#--#-####-#---------------------##--#-#-##---------#--------#--#------#----
-##---#-##--##--##--#---#-------#---#---##--####----#--#-#-#---##----#---#------#-#---##----#---#---
--##-#-#------#---##---------#---#---#----#---#----#---------#--#-#---##--#--##--------##-------#---
----#---#---#--#---------#-##---#--#---#--------------###---##---#-##---#---#-##--##--###----##-----
---####---######---#------#----##--##-#----##-----#-#-##----#-#-#---#-----#--#----##-##---#-----#--#
#-----#----------------#--#-----#-##-----#-#-#-----#----##---#-#--#---##--#-#--##-#-------#-----#---
---###-##---##--##--#-#---#--#----###-------####------#-#-##--##--#---##---#-#----#-#----#-##-#---#-
###-------#----###------#-----##--#--##-#--#---#--#---###--#-#--#-----#--##-#----------#-----#---#-#
##-#----------#-###---###--#---##----#----###-##--#---#-##---#-##-----#-#--#---#---##------------#--
-#-----##--------#--##--##----#-##------#-###-###-#---#--#----#--------##---#----------#-##----#-#-#
-###----##-##-###----#---##-#---#------#-##-#--#--#---##-----------##-----#-----------###-##----#---
-##-##--###----#-##--##--------#-----###---#------##--#----------#-----#---##--#-#-----###-#--#--#-#
----#-#---#----#----###-#-----##----#------#--#-##-------##-##-#---#--###--------#---#---#--#----#-#
-#-#--#-##-#----###---------#-#---------#-----#--##-#--#-#-----#-#------#--#------#----------#-#----
---##----#-------#--###--#-##-#-##----##--#----#---##----###--------###---##-#----###------#--#-###-
---#----#------#---#------#--##------#---####-#---#------#---#---##-----#--##-#-#--###--------------
#------#------#----#---##---#-#-------#-#---#-##-#---#----##--#----###-#-#-#-####--#-#--##---##-----
--##----#---###--#---------#---#--#####-##----#-------#---#--#-------##-#-##---------#----##-#---#--
#------#-----------#---#--#-###---#-##--###----------##--##---###--#--#---##----#-#-####----#----#-#
#-####-----#---##----#-#-#----###-#-----##----#-##----##---##---#--------##-#-###-#------#-#---#----
-#--#--###-------#-----##-#--#--#-#--#---#-##---#---###---#-#------#-#-#------#-##--#-----##----#---
#-##-##--#---##-#-#--#-----#-#------###---------------##-##---------#--------##-------------##------
----#------#-##-###----#--##---#--#----------##---#------##--#--#-#--###----###----##-----------#--#
----#---------#-#--##---#---##------##----#----##--##---##------#-#-#-##----------##-#-----#-#-----#
-##--#---#--#-#--#---#--#-##--#---#--#------#---##------------##-#---#---#----#-##--#--###-----#-#--
-#------#-#-##-#-#--##--##-#--##-#-#-----##-##--#---#----##--#-###--#-------#----#--##-#-###--#-----
-#--#-#--#--#-------#-----#--##---#----###-#-----#-#--##-#-#------##-------#-#----##-##---#-##--#--#
##-#-----#--##--#---##-----#-#-#--#----###---##-##-#-#--#--#-##---#-------#-#--#--#-----#-#--###-#--
---#---#--#-----#------#--#--##-----##---##-#---#-#--##-#--------##-#----##--#--##--#----------#---#
---------###-#--##-##----#--##---------#----#----#---#--##---------####---------#----#-----------#-#
-#-----#---#-#------#----##--##-----#---#--####-#-------#--------##-#----##--#-#----#---------###---
-----#--#-----#---#-#--#-#----#--##------#-#---#--#----#-#---#--#--##--###-##------#-#-###--##-#-#--
###---------#-#-#----####---#-####-#--#-#-----##-#--##-###---#--#-#-----#----#--------###----#####-#
----##--##------#--#---#-##-------#####--##----#---##-----##--##--#----#--#-##--#---#-------#------#
#-#---#--------#-----#-##-----##--#--#----#---#---#-#-#-------#----#---#-#-#---#-#-#----------####--
---#-##-#--##----#-#-------#--------###------------##--#----#---#--##------#--##--------##-##-###--#
--#-####-###------#####-####----#---####--#--##--#---------------#----##-----##-----##--------------
--#-----#----#--##--#-#--##--##-#-#-#-##--##----#-##-#-##--------#--#-#----#--#--#-#-#----#----#-#-#
##--#------#-----#-###-------------##-------#---------#---#--#---#---###-#-#----#---------#------##-
#---##-#-##--##-#-----###----##-#-----#--------------#-###--##-#------#-#---###-----#---#-----------
------#####-##---#----###-###---#---#---------------#--------#-###-##---------#-##-#----#-------#---
-------##-#-##----#---##---#--#--------#-#--#-##-----#---------------------##-------#----#--#-------
-----------#----------#-#-#--#-------#-----##----------##--#---#--#--##---#-##-#-#-----#------#-#---
--------#-#---#--#---#--#----#----#---------#-#---##---##-----#-----#--------#-#####-#-##--#-----##-
----#-----##-#-#---------#--------#-#-#-----#--------#--#-#---#-----#---##--#------##-#-#--###--#---
#---#----#----------##-##-#--###---#---####-----#---#-----#---#-----#---#---#-----#-#-#-----#---#--#
-#-#---#-####---#--#----#-#--#-#--##-####-#--------#-###-#-----------------#-----#---#-#--------##-#
---##-#---##-####-----#--#------#---#---#---#---####----##------#-------#-#--#-#--#----#---#-#--##--
-#----#-#--S---##--#-#----#----------#--#-#-#--#----##---#--#------##-----#-#------#---#---#--------
---#----#--#---#------#---###----###--------#----#------###-----####-#-#----------##---###---#-#-#-#
##-----#-#--#---#---##---#----##-#-#---##---#--#--##---#-##-----#-----#--#--#-----#-#--###-##----#--
-#---###---#-##---#-#---#------##--#---#----#--##--------#----##----###----#------#-##-##---#-#-#-#-
#-###---##-###-##---#-----------#--------#-------#------#----#----#-##-----##-#--#-#-##-------#---#-
-#----#-##---#-#---#-###------#----#-##--#---#---#--#-#------#-#####--------------#-###-----#---##--
-####----##--#-#--##--##----##-#-#-#---#---#-#-----------#--#-#--#-#-----#-#---#------##-#-#--#-----
#---#---#--#-----#-##--#---#-###-#--#----#---#---#----###--#--###-----------#-##-----#--#-------#---
---#------##--##-----###-##-##---#-#----#----#-##---------###-##-E#------##-----------##---------###
#----#--#-----##---#-###-----#--#-#-#----#------#------#-----#--#---##---------#----#-------------#-
##-------##-##----#------#--##--#-------#--####--##---#--#---#---------##-------#------------#-#---#
---#####-------###-#---#--##----#---------#---#--#--#-##--#--#--##-----##-----##----#--#--#-#---##-#
----##--#-##-#-----#---#-#------------###-#---------#---#-#-##-----#--#-#-#---###---#--###-------###
---------#-----##-#-#------#----#---------------------#-----#--#-#-------###--#-#------#--#---#--#--
--------##-#-#----##---#--#--#--#--#-#----##---------##----###---#----#-------#---##--###-#-#-------
--#-----##--#-#-#--#####--##-#--------#-----##-#----#--#--##----##-#-----#--#--#-#-#-#-----#----##--
#-#-#-##--#-#--##--##--###-##----#####----------#---#----#---##-###---#---###----###---#-----##-##--
----#--#--#--#---#-#---##--#-#--#-#-##-##-#----#-------#------#---#----#---#----#-----#---###------#