?diagonal=OnlyWhenNoObstacles;
##----------#-##----###-#---------#-###--#--#----#-#---##---------------#------------------#----#---
-###-------#-#--#-###---------###--------#-##-#--#--##---#----------#----------##--##---------#-#--#
#-#--##--#---------------##-----#---#----#----###----#--#----#----#-##---##---#-#--#--###-#-------##
--##-##------#-##-#---##----#---##-------###-#--#--###---#--##---#-----##-##-------#---#------#---##
-#--#-##-#--#-##-##---#--##-----#----------------###---####----##-####-------#-----#------#-----##--
---##---#---##----##-#---#---##-###-------###-#--#-----#---#--#---#-#--#----#---#--##-#-----#--#----
##--------##-###----#---###---------------#-#-#--##--#--#---#--##------##-#-#-#-----##-##----#-#-#--
-#-#-#-#-#-#-###---#---#-----#----#---#----------#--#----#-##--#------##-#-#---#-----##--#-#---#----
#-#---#--##-##-------#-#-###----------#-----#--##-#----###-----##-----#--#-#--#-#-#-#--##-#-#--#----
--#-----#-------------#------------##---#-#--#----------#-#-----#----####--#-#-#------#-###--##-----
#-##---###-#####-#--------#-##----#----#----#------#-#---#------#-----#---#-#---#--#----##----#--#--
---##-#---#--#-#-###-#-###------#-#-##---#-----#----#-#---###---#---##--##-----#-#----##-#----##---#
#-##--#-#----#---#-#----#-#--#----#---#----#-#--------##-#--#--#-##--------#--##---#---------#-#-#-#
#--#-##----#--#--#--###------#-#-------#-#--##-#-##----#---##------#-#-#--#######----#----#----##---
------------#---##--#-##--##------#---##------#--#----##-----#-##----##--###---#-##---#-#-----------
#--#-------------####-#-##------------#---#-#---##-##----#--#-#--#---##---#-#-#---#-#--#------##---#
--------#------#-#-----#-#-#-#--##-###---#----------###--#-##-#----------#--#-----#-----#----##-#---
-#---#------#------#---#--#--------#-------#--#----##-#--#-##------#---#--#-###-#------#-##-#----###
#-----#--#-------#--#-#-##-#--#-#-#--#----------#--------#-#--#--------#-----#--#-#-#-----##--------
-#-------##---#---#--#--#-#--#----##-----#-#---#--#--#---#------#---#------##-#---##-#----#-#----#--
---#-------###--#--##-#-#-#-#-##---#----#--#-#--#-----#--#-#-#-##---#--#-#--#-----#-------#---####-#
----------#------##--#--------#--#----###--##-#-###-##-----#-##--##---#-##-#---##--##-----------#--#
-#---------#----#----#---##---#---##----------#-##----###--#---##-#-----#--#--#--##-------##----#-##
#---#--##----##-#-#-------#-------###----#--#-----#-#----#--------###-#-####-#--------------#-----##
-#-##---#------------#-#-#-#--##-----#-#-#--##--#--#--#----#-------#---------##---#--------##--#----
##---------#-###-----------#-#-----###----#-#--#--###--#-------#-##-#----#------##--#--#-##------#--
-#--##---#-#--######---#--#--#--##---#----#----##--##---###---#--#-----#---#----##---#--##-##-##----
--##----#-----#--##----#--#--###---#---##--##-##----##--##-#--#---#-#---##----###---#-#--------#-###
-#--###-#-#--------------#-##----#--#--------#-###-#-----#------#-###-------#####-----#-###--####---
---------#-##-##--###---##----#-----------#-----#--#--#-#---#--##--#-#-#-#--#-------#--#-#---#-----#
-------#---#-------###--#---#----------#---##-###-#-#--#-------#---------#-###--#-----------#---##--
---#-#-#--------#E---#---#-------#--#-----#----##----#-#-#-#--##--#--##-#--#---#--#-#-#--#----#--#--
-#-------#------------#-#--##--#-#----#---###-##-#-#--#-#---##--#---##---------#-#--##-#-##---###-#-
----##------#-----#-#-###-----#--------#---#--####--------##--------#-#-----#--#---------#-#--------
-#-#--#-------#-###---------#---##---#-------#-##-##---------#-#-#--#----#---#--#--------#-----##---
---##-----#----##----##-----#-----#-#-----#---------#----#--##---#-##-----#-##-#-#--###--#--#--##--#
--#-#--------##-#-##-#-##--###--#-----##-#-#-#-----##----#--#-#----##----#-#-###----#-#-#####-------
----#-#------#-------#-#-#---#--#####--#----#----#-##-####-#-----##------###--##-###--------#-------
-#---#-----------------###-------------#-#-###-###-#-#---##-#-#-#------###---##-##--###-##-----#-#--
###-----#--#----####-#--#-#--#--####------##---#--#-#-----#-#---------###-##-###-#-#-#------#-#-#---
---#-----#---####--#-#-#---####-#-##-##------#--##-----##-####-##--#---##-#-#---------#-#---#-#-#--#
------#---#----#-#####-----#---------#-#------#-#-#-#-----#-#-----#--#-----#--#-#---#-#-##---##---#-
--#-------#---##-##-------#------#-#---##-----------#-#---#------------##-----#-------#-------#-----
-#---##----#--#--#----#--#-#--------#--#-------#-#-##---#-#----#---##---#--###--##--#-#---##----#--#
-######-###----##-#-##-------#---#---#------##------#-###--##-#-#---##---------#---#-#---#-#-##----#
------#--#-##--#--#-####---#-------#----#-----#-------------------##------------##---#--#-----#---##
---#-##--###------##-##--#---#--#-#--#---------#-----#--###--#----#-----#--#-##-------#-#-----------
-#-----#--#-##----#-###------#-#--#---#--#-##-------#---##----###--##---#---##------#--##-#--###--#-
-----#---##-##--##----#-#----##-#-----##---#--#-##-------###--#-#---###--##-#---#-####--#-#------##-
-#---#---##--#----#------#-----#---#####--###-----#--#---#---#---##-----#--------##------###-##----#
----#--##-#-----------#----#------#-#-----------##--------#-#-##------#-#-----#-#---#-#--#--#-##-###
----#-###-##-###-----##-#--#---#------#-#---#-###----#-#---##---#-------#--#---#---#----#-##-----###
#-----##---###---------------#----#-##---##-#--##-----#-----#-#-#-#--#---#-------#-###------------##
---#--##-##---#----#-------#---#-#--#------------##-----#-##--#---#--#---###----##---#----#---------
-------##----#-----###-#-----#----------------#---#---#----##-#-----##---#---#-#--#-#-------#--#----
-----###-###--#---#---------#-------##--#--##--#-----#-----------------#-#-----#--#-------------#--#
-####-##--#---####-#--#-----##-#-----#---#---####-#-#--#-------##-#------#-----#--#----###----#----#
-#----#-#--##-###----#--#-#-###--##---#--#--#--##--#-#--#-###----#-#----####-#---------#----###---#-
---#--#----##-#--##--#---##-##----##-----##-----#-#-##--#--####--#-#-##--------#--------#----#-----#
--##--##---#---#---#--#---##-----#------###--##----#-#---#-###-------#-------#----------##-#-#-#--#-
------#---##----##------#-##--------##------#--##----#--#--#----#--###-#-#-----##--#-#---####--#-#--
#-##--#---------------#-#-##-----###------#---#--#-----##-#--##-#-#-------#---#-#-#-------#--#---#--
#-----#--####----###--##--------------##--------#-----#-##----#---#------#----#--###-##-###--#---#--
-#---#-#-#---#-##---##---#-#---#--##-------#-----##-##--#--#-----#-##------#--##-#---#-#--#-----##-#
-##-------##-----#------##-##----#---##-#-###---#--#---##-------##---###----#--------#--------##----
------####--#----#-#--###-----#-----##---##----#------#-###-------------#------#----#-#-#--S-----#--
-----#---#--###-----------##--#----#-#---------###------#------#----##-----#-#---#--------#-#-------
--##----#-#-#-##---#--#------#-#--##--##---#-#-#---#--##---####-#--#-----##----#-#-#-####--#-#------
#--------------------#----#---#-----#--------#------##-------##-#----------#----#--------#---##-----
-----------##-#-#-####---#-#---##-#--##-#---#-#--#--------##-###---#---#--##-#--#----##----------#--
-###-###--#----#--##----###----#-#--#--------#-#-##--------#--##---##-------#-##-----#----#---#-###-
-##--#-#------#--#----##-#--#----#-#----##---#----#---###--#---#------#---##--#----#---##----#---#--
-#-#--#------##-#-#--#------#-####---#--#-------#-#---#-#-#-#----#--###---#---#--#-#----#-##-#---##-
--##--#----#----##-###-##--##-#-----#-----------------#-#-###--#-------#-##-----##---#--#--#-#------
-##-------------##-#--#-#---#--###-#--##----#------###--#-#---#------------#-#--#---#-------#---#--#
---#--##--###-#-----#--#-#----#-------#-----##----##----#----#-#-#-#-##-----#---#--#---#---#-#-----#
#--#--------#---#-------#-----###--------#--------#-----#---#--####------###-------#------#----##---
--#---#-#-----#---#--#-##-----#--#---#--#-----------#----------#-----#-#-#--###-#---#-------###---##
--#---#--##-#-#--------##-#------##-#--#----#---##--#-----##--#---#-##----#-#---#-#--#----#-###-----
#######---#----#-##-#---------#-#---###-###----#-#-#--#----------------#---#-----#----###-#-#---####
-#--#-------#----------#--#----####-----#----#----------##--##--#--#---##---------###---#--#-#-##---
---#----#--#-##-#-#--#------------##-#----#-----#------##--##---##------#---------##-----##----#-#--
-#-----------------#--#-##-#-------#-##----#--#-#-#--#--#-----#-#--#-----------#-##-----#----#----#-
---#--#-#---##---#--------###--##-#--#-#-----#-----##--#------#---#-#--#-#------------#----#-#-####-
------###----#----------#----##---#--#----------#-------#--##----#----#-----#--#####-#----#-#####--#
-----#-##----#--#-------#--#----##------#--#------###--#-#--------##-#-#-------#--------------##----
----#-#--#-####--#--#---##---##---##--##--#---#--#---#---###--####---#--##-----#------------------#-
--#--------#-#-#----#--###--#--##-##--#----#------#------------#--#----#-#---#----------###--------#
###---#-#---#-----------#-##-------#-#--#-----#-##-#------#--#-----##-#--#-#-##-#--#-####-#-#-#-----
---#---#-#---#--------#-##-#--------##-#-----------##-------#---##----#-----#----#----#--##---#---##
--#---#--##-#--------#---------#----#----#---##--#-#-##------#--##-----##---------#-#-----------#-##
-----###--#-##-#---------#--#-----##--#----#------###-##-#-#----#-#----#--##--#-#-##-------#----##--
#-#--------#-#--##-##--------##-#--##-----#--###---#----#---##-##---#-#-##--------####---##-----#-##
-#-#--------#----##-----------##-##-#------#--#-#-#----#-#--#-#---##----#-##-#-----#-#-#-#---#-##---
---#-#-----##-#------#-#-#-----#-#-------#-#-----#--#-------#-#-#----#-----#----#-#---#--#---#---##-
#---##---#---#-#------#--#-----------#---##-###--#-#-#-#-------#----#--#------#--#--##------##-#----
-#--#-##----##----#--#-#-#-###-#--##--#-------#----#--#----#-#-------#-#----------------#---#--#--#-
--##----#----##--#---------#-#----#----#---------------##---###---#--##--##----#-----#----#-------#-
-----#---#-#--#-#-##---#-##-----#-------#-#-#-----###-##-------#-----#------#-#--#-####----#--#----#
#-----#-##-#-##----#---###-##----##-----#--##--#---#--##----##----------------#-------#-----##------