?diagonal=OnlyWhenNoObstacles;
--#---#---###---#------------#-#-#--##-#--#-------#--####-------#--#-##------###------#-----#-#----#
#-----#-##----#----#-#---#--#-#-#----#-#--------#--#----#--------#-#-#-#--#--#--##--#-##--------#---
------##--##---#-#-#-#----##------##-----##------###----#--#-----#-##--#--##-------#---#-#-----#-#--
-#---#--#-----#---#------#-------#-#-##-#----#--###-------#-##----#-#-----#---##-##--#--###---####--
---#-----####---#--#-##-------##--#--#-##--#--------#---#--#--#--#------#-##----#----------#----##--
---#-----##--#-###--##----##------##-#----###------#----------#----#-##---#---##-#-----#-##-##-#---#
#-#--------#-#--#----####-----#--#------#---------------#---#--#-----#-----#--#---#-#-#-#-#-------#-
--------------#---#--##-------##-#------#------#---------#-#------####---#-##-#----#-#--###-#-------
-##-##----#-##------#--##------#--#--###---##-#----#----#---##--##--###--##----##--#-#-#---#--#-----
-#-##-#----#------##----##----#---#------##---#---#---#------#---#----#-------#--####-------#---###-
#-----#--#-------###-###-#--#----#----#-#-######----------#-##-#---------#---#-#--#--##-#--##-###--#
-#--#---#-#---##---#-------#--#-----#----##-------#-##---##----#-----------##---#-#-#-----###-------
-#------#----------###--##--#-#-#---#-----#---###--#----#-#-#---##-##-------#--#------##-----#-#-#--
---#-#--#---#--#---#--#-------#--#----#---##--#-##----###--#--##--------###-##----------#-#-#-####--
##-#-#--#-#-#----#----#------#--#-------#--##-#---#----#--##---#---#---#---#--#----#--#-----#--#-###
--#-----#-##-#-#-##----###----------#-------##-#---###-#------#---##-----###--#-----#--------####---
-#---#---##------#-#-----#-----#-#-#-------#----#-----#---#---------##---#-##---#---#---#-#--#-#--#-
---##-------#---##-------##-------#-##-##--##-----#--##----###-#---#---##-#------------##--#---#----
------##---#---#-##-#---#-#----------#---#-----#---#--#-------###--#-#-#---#-###-####--##---#--#----
--###-----#-----------#-##------------#----#-----#---#--#---------##---#--#-#--#-----####--------#--
#-----####--#--###--#-----#-#--#-##--------#--#-#-##--#---###---##----###-#-#---##--##-----------#--
-##-----##-----###-##-##---#-#-#----------##---#----------#---------##-#---#-###-#-#--#----#-#----#-
--#-##-----#--#----#-#-#-#--#-#-----#---#------#------#--#-##-###---------------#--#--#--#-#--------
##--###-##-----#--#------------#----##-###--##---#---#---###-#-##--#--#----#-#---#--#----#---#------
--------------------#---#-----#------#-------##-----#-#---#-###--#--------#-#-###-#----#-##----#--##
--#--###---#---##-#-------##------------#--#-#--------#---#--#----#---#----##-------#----##-##-#--#-
#-#---#-----#-------##--#-###--#---------#--------#-#--#--#-#--#-----##-#---##--###--------#--#-#--#
-----#-----#---#----###-----#---#---#-#####-#-#---#----#------###-----#-----#-#--------#-------#---#
-----##-----#-#-#-#--#----#-#----##-###-#---#-#-##---#-#------###--#####------##-#-#-#-##-#--#------
---------##-###--##-#----##--##-----#-##-#-#------#-#--#----#-#--##------------#--------##-###-----#
------#---#-###-----#-#----------#-#-----##--#------#-##--------##--------#--###--#-#------##-####-#
-###-##---------##-#-#---#-------##---#-#------#-##---##-----#--##---#--##---#-#----#-#------#######
---##-#-#-#-#-#---##-#----#----#----#-#------#-----#-#--#-#-#---#--#----#---#----#---##-----##--#--#
--##---##----#---##---#-#--##--#---#-#-#-----------------#--##------##--------#---#---#-----------##
-----##------##------#-#--#-----#---##-----#--###---##--####-#---#-------#-#------###--#-#-#-#-##---
-#-----##--#--####-##----#--##-#--------##-----#-#--###---#--#--###-#-------#-----##--##--##--##----
#---##--#-#-##--#--##-#--##----#-#--#-#-----#----#---#-#--#--#-----##---#-#----#---#--------###---#-
--#--#-----------##-#------#-----#---#---####--##-###-------#-##---#----##-----#---##----###-#-#-#-#
-#--#---####-----#------#------##-#-#--#-------#--#-##--#----#--#-------#-----#----#--##-------#----
------#-#--###---#--#---------#-#--##-#----##--#------#--#-##---#--##-#----##-----##-#--#--##-##--#-
#-##----#--------#--##--##-#-----#-----------#--------#---#---#--#--###--#---#--#-####--#--#-#--##--
#----###----####-----##--#--#----##---###---#-#------#-#------------#-#------#-----#-#----#---#-###-
-----#------------##--#----#-------#---##-------#---##--###-#--#---#-------###------###-#-#-##--#--#
--##-##--#-#-#-#---------##--#-#---##-----###----#----#----#----###---##--#------##-#----#--##-#---#
----#--#---#-##-----##------#-#---#--#----##-###--#----#--#--##-#---##-#-----#---#-------#---#---###
----#--###---#-#-##-#-#--#-#-#--#-#---#--###-##------------#---#------###---##---#-#####--###------#
----#---------#-#---#---#-#------#--#----#-#-----##-----#--##--#--###------#--#--###--##----#--##-##
--#-#-#-#------##-----------#-----#--#--#-#----------#--#---#-#-#-#---#--##--#----###-#--#----#-----
#-#-##-#----##--##----#--#--#-#--------#---##-#--####--###--##-------####------#----#--#--#---------
#-#-###-----------#---#-###---------#-#--#####-#-----#--##-#----------#-##-###----#-###---##-#-#----
-#-#---##--#-##-------#---#-----#-#--##-#-#----#-#-------------------#------#-##---#---##--##----#--
-##-------#------#---#-#------#-#-----#-------####-#--#-#-#-#--####-----##---#--##--###---#-#------#
--#-#-#-#-#---##--------##-#--#-#-#-----#-##--#-#---#-#--#----##---------------###-#-------####-----
---#E--#-#--#-----#-----#------#-----#-----##---#--#--#-#--#----##-----##-------#-#-#--#--#-#--#-##-
----#---------#--#-#-----#-#-------##-#---#-#--#-###--#-#-----##---##-----#--#-#---####-----###-#---
--##--#---#-#---------#--#-----#--#----#-#--#-##-----#--------###-#-##----#--#-#---#-#-----#--##-##-
------------#------------##--#-----#--#--##-------####-----#--##----#----##-##-----------#--#---##--
-----#--#----##-------------##-------#--##-#-#--#--#--------#-#----#-#---##--#-##------##-#-##---##-
---#--##-------#--------#---#-----#-#-#------##----#-#--#-####--------#----##-#-#-#-#--#--------##--
----------#----#-#--#----##--##-##-#----#----#--#--#--####-#-#-##--#----------##----###--#-#-------#
----#----#-----#----#-#-#-#----#-----#---#------#---#-----##-----#--#--##--#--#-----#--------#--#--#
-##---#-------##-#-#--#--##---###----------##----#-----#----#---#---##------#-------#---#----#-#-#--
---#----------##--#---##--##--#-##--#------#----------#--#----#-##----##-##-#---#-#----#----###-#-##
--------#----#--#---------#----#------#-----------#---#-##--##---#-#----#-------##------#---#---#-#-
------#-----#-----------------#----#-#--#-#--#-#----#-##-#--#--#-------#--#-------#---#--##-#-##--##
#---#-#-##-#--#------#----#-##--##-#----####----S#---------###--###-----#-#-----------##---#-#--#---
-#-------#--------##-----##-----#--------#-------#---------#--#---#---#--#-##--#-##-#-##-#-#---##--#
#------#--#----#--#----#--##-###-#--#-------###---#--#--#-#-##-#-#-#----#-##--#-----##--#-#---#--#-#
-#-------#--#---------##---#---####-#---##--#--##-#-#-----#----#-#-##-##--#---------#------#---##-##
--#---#---#----#----##--#-##--##----##------###-###-------#--#-#----#-#---#-#-#------##--#-#-------#
--##----##------#-#--###--###-----#---#--##-#----###-#---#--#--#----#-###-#--#-------###--#-#-------
------#--------#--#------#---#--#--#---------#-------#-----#-#-#---#------##---------#----##------##
----#-----#---#---#-#----#--##-##----#####--#-#-#--#----#-#-#-#--##-#-##-#--###--------#--##------#-
-###---#---##----#-##-##-#------##-#--------#-------#--##-##-##---#-#-#-#-#---##----------##--#-----
#--#--###--------#-#-#---#-#-------#-------###------#--#--#----#-#---#--------#--#--#-----#------#--
---#-#--#---------#---#-#-#----##-------#--#--------##-###-#-#---#-#-#--#--##----#-##---##-#-#-#--#-
-#-----###--#--#-#-#-#---#-##--##-#--------##-----##---#-#--#-----------#----#-#-----#------##--#---
-------#-#----#--####----##-----#-####--##-#--#--####-#--#-#-##---#--#-#---#---#--#---#----#-#--##--
-#------#--#-----#-##-------#--#---#-#--------#-#--#----#----##-#---#---#-#-#-#-#-##---------------#
#-#-#--#-#--#------#-----#---------#------#--#--#-#---#-----#-------#------##--#--#-##----#--######-
-------#---#---------#---###----#-##--###--#----#-#---##-##-##-------##-----#---##--#-#----#-#--#-#-
----#------#######-##-##-#-#-#-----##--#-#--#--#-##-##---#-----#-------------#-#-------#-#--#--#-#--
#--#--###-#----#--##------##---#-----#-##---###-#--#-#-#-----------#---##-#-------------##--#-#-----
-#-----#-----------------###-#----------#--------##---#--#-#----#-----#----#------###-----##----#--#
----##-#----##--###------------#---#----------##--#---#----#--#-----#--##---#-##--#----#--#-----#-##
-----##--#-#---#-#---#--#-------#----------##----#----###----##---#------#----#----###---#-#----#-##
-#---#---##-##--#-#-#--#--#-####-#-----#---###--#---##---###---#-##-##------------------#-#---------
-#---#--#--#-#----##-----#---#----##----#------#--#-#----##-----#---#--------#-#-#--#---#----#-----#
#-----#-------------#-#--##-##----###-#-----#-----##-##---#----##-#-#-----#--#--##---#-###-#-#-#-#-#
###---#--------------------##---#-#-------#----#----#--##-##----#-----#-----#--------##----#--#----#
----##----####--#-##------#-------#-#--#-#---#--#----------------#---##-----##-#--#------#----#---#-
##--#------#--#-#--#-----#----#-----#-#-------##--##-##---##---#-------#-#-----#-----------#--#-##-#
-------#---#--##--#-#-------#-#-##--#--#----#----#--------#-#-------##---#--------#-----#--#--##---#
--##-----##--#-------###---##--#---#-#---#---------##-##-#-#--##--------#--##---#-##-#----#-----#---
-#--------#--------------##--#-#----#--####-#-##-#-##---#---#----#--#-##----##-##-#----#---##-#-----
-#--#--##--#-----##---#-##-#---------#---#---#--##---##-#---------#-#---#----#-#----###--#-#-###-#-#
--###---####--#-#-----#--#---#----##-#------#--##-----#------#--#---#---#------#-#-----##--#---#-###
--#-#-----------##----#--#-----#--#-------###---##-##--#-##--#----#-----#----#-#-#--------#-###----#
###-#----#--#-#------#---##--#---#-----#-------#-----------#-#--#-#---#------#--##-------#------#---
-#---##---#-###-------------##---##--#-#-#---#-------------#----#--#----------#-#----#----##-#------