?diagonal=OnlyWhenNoObstacles;
--#----#---#---###----#------###-----#---##--##-----##--------##------##-----#-##--#---#-##-#-#----#
----#--#---------#--#--#----##-------#--#-----#-#-#------##-#---#####--#-#---#---#--#--#---#--###---
--##-------#-##--#-#--------#-----#-#-#-#----##--#---#-#--------#-#-----##-----#--#-----------##----
----#--#---#----------#-------####-----#---#-###-###-#--##----#-#----#--##-------------#--------#---
-----#----###--------#------#-----#---##-#--------#---#-#---#--#----#-#---#--#-----#-#-------------#
---#-#---#-##----#-----#----#-#-#--#----##-#-##-#-#--#-##-##-#-##-#-#--#------------#-#-##-###-##---
---#-#---##--#--##--#-#-----##--##-#-#-#------------#--#--#-#-#---------#-##-###------##-----#----#-
--------##-##--###---##--#---##---#-----#---#--#---#-####-----#-----------#----#---#---------#-----#
----#--#------#-----###--##--##-#----#-----#-#-------##---#-----#---------#-#-##--##------##--#--##-
#----------###-#------#---------##-#---#-##-#---#---##--#-----##-##--#-##--#------#--#--------#-----
-#---#-#--#--------#-#-#----#-#---#-##---#--#-----#---------#-###--------##--#---#-##-----#---#---#-
-#-#----#-#---------------#-----#-#-#----#-#-------#-##-##-#-----------#--##-##---#-------#---#-####
#---##------##---#-##-#-##-#--##--#-------##----#----------#--#-#-#--##-------#-#--#-#-#--#-#----#-#
--#-##---#---#--#----#-#-##-##--#--#-#---#--#-##-----#--##-------#---#---#---#------##-##-#---#--#-#
#-###------#####---#-#---##--#---#--#-#-#--#---#-#-##--#-#--------##----#----##------#-###-#-###-##-
##--###--------#-#-#---###-#----##--------##----###-#--#---#-#--#-----#-###--------#--#--------##--#
##----#-----------#--------#--#---####--#-#--#----#---##--###----#-#------#--###--#-##----#--#-#---#
--#-##-#-#-##--#-------##-#----##-#--#--##--#--#-----#-#------##-----#-#---#-##-#---#----##-#-------
###---#---##---#-##----####--##--#---#--#---#----#-------#---------#------##--------##--###----#--#-
##--##---------##----#--###--#---##-#-###--##-####-------#---#-#-##-####--#---#---#------##----#----
-#---#-#-#---#--#--------------------##-##--#---#-#----#-------#-#--#--#-#-##-###-------#-#-----#---
##---#-####--#----#--##---#---#-##-#--#---#-#----#----#----#-----#------###-#-------##-#-----#---#-#
--#---####-##---#-----#--#----------#-#--#-#-----------#-##-----#-#--#---#----####--#-##-##-#-------
##---#-#------#-------------####-#--#-#--------#-##---##--#-#----#-#-#-----##------#-#-#-----#-#----
-#-#-----#---#-##--------#-##---#-#--#-#-----#----#-#-----####-#-----##---#--#-#-##-------##----#---
#------##--##--##---##------#--#-#####---------#----##--#-------##-#--------------------#--##-----##
#---##----#----#---#--#-#-----#------#-#-#--######-#--#---##-#-####-#-----#--#---#-##-#-###-------#-
----#----#---#-----#-#-#-#-----------#-###-###-#-------#-#---#------##----###--#------#-#-----##----
#--#----------###--##---#---#--###-#-----#--#----#-##--#-##--#-------#------#-----#-#-----####--#-##
-#--#-#---------##---#--#-#------#--#---#-#-----------#-----##-----##---#--#---#--#-----------#-#---
--#-#--#-#-#--------#---#-#--#-#--#--#--#--#-##-------------#-------#--------####-#----#--###-#----#
-----#---#---##-----#-#-#--##-#-#-#-##-##-----###--#-#-#------#-#--##--##----#---###--##-#------#---
---------###-----##--##########--#-#---#------#---#------#------------#------##-###-------#---------
---#-#--#-##--##------#--#-#---#---#---#--###-------##-##--#-----#--#----#------##-#-#------##------
#--------#-------------##--#----------###-#-#--#---#--#--###---#-#---####-#--#-#----##-######----#--
##----##--##----#-#------------##-#-#----#-#-----------#---##---------###----##----##--#-#-#-----#--
-----#-#---##--#--#---#----------#--#---#--#------#----#-------##--#---#--##-##----##-###-------#--#
##-----#---#--#---#-----##-#-#--#-----#--#-#--##---------#-#-----#-#-#----##---##---#-#--------#--#-
-------#-#-------####-#-#--#--#-#-------#--#--#--------#-#-#-#-#--#--#-------###--#----##--#--#---#-
####-----#-#--------#--#-----##-------------##---##-----#---#-----------#------##-------#---#-----##
--#-##---#-#-##-------#--#--#--------##------#-----##--#---#----------##-------#---#-------###--#---
-----#-#---#------##-##-----#-#----#--##--###-####-#-------##---##----##------###--#--##----#---#-#-
--#----#-##--#--####-#-#-#-#-#-##--#--------#--#-----#-----#-#-----#--#-#-#---#---#####-------------
-#-#-----#--#####-##--#-#--#--#-------###--#-##-#---#--#-#--#----#--##----#-----##----#-#-----------
-#-#--#--#--#-#--#--##---#-#---------#-#-#----#------#--#----##--------#-----#-#-#---#---#-##---##--
-#------#--#-####---------#--#--#---#-------#######-#-#####-#--#-#-#------#-#-----#-----------##--#-
-##--#-----#-#----#----##------###---------##-###-------##---#-#-#---#--###-------#-###-#-----------
--#--#--------#--#----##-#-----#####-#---##---#--#--#-----#--#------#--------#--#-----#-##---##----#
-----#-#--------###-------##---#---#-----##-#--#-#-#---##---###-#--#-#---#-##--#---------#-#-----#--
#--#-----#-#####--#--#----#---#---#-#-#--##-#--#-----###----#--#-#--#-----#--#-##------#-----------#
------#-#-------#-#-#-#--####-##---###----#----#--#-----#----------#--#----##--------#--##--#-#---#-
-----#--#-#---#-#-#----##-#---#-----#---------#----#-----#--#--#---------##---##--#--#-#----##------
-#-#--##---###-#----##-#--####-------##--#--#-------#--#---##-##-#------###-##-------#----------#---
##--#-#----#------#-##--##-------#-##---------##----#-#--##------#---#--#-----##--##-------------#--
---#-###-#--------##--#-#-##-####-----------####---#-#----##-#----#--##-----###---##-#------#-------
#----------------##-#---#------#----------#------------------#-#--##----####---#----#------####---#-
--#----#-#-#--#---#----#---#----#-----#-----------------#--#------#-#-##--#-##-#---#-----##-------#-
-----#-##-#------------#-----#---##---#-#--###-#--###----#--##---#-#------#--##-#-#####--------#----
-#-#----#----#-#--#-#---#----#------------##-----###---S-###-------##---#-------#--#-##-#----#------
##--#--#-####--##-#-##-#-------##--#-#-----###--#--#-------#-----#---#----------#-----##--##-#---#--
-------#-####---#--#-#-####-#------#--#--#--#---------------#--####-#---#----#--###-#--#-----------#
--#-----##-#----------###-#---##--#-#---#-------#-#-#----#---------#---#------#-#-----##----##--#--#
#--#--------#---#--#-##---###-###--------####-#---#-##-##-#-#---##-##--##--#---#-----###--------##--
--#-#------#-##-------#-#---##-----#---##--#-###-###----#-##----#----------#----#--#----##------####
#----#----#--#---#--#--#--#----##--##--#-#--#---------#--#-##---#-#-------#----#--#-#--#------------
-#--#--#-##---####-#--#-#--#----#-#--#--#----#-#------#--#-------#------#---#-#-#---#-##---##-#-----
##-#---#-#---#-----##----#-#-#--##-------#--###-----#-##-#-##--#-#-#--##-#--#----#------#----##----#
#-#-----#--##--#------##--#---#-----------##-#----#-#----#-#---#--#--#----##--#-----#--#---#---##---
---##--#---#---#--#-----------#--#--#---------#-----#--#-----#---#-#---##----#--------#----##--#-#--
#--#----##--#-----#-#-##----#---##-####-----##----------#--#---#---##----##------------##--####---##
-#---#---------###-------#--#-----#-#-#-#---#####-#---#-----#-###---#-------#-----#---#-----------#-
#--###-##--#--#-###-#----#-----#---###---#------##---###-##-##-#-----###---------#-------##-##----#-
#--#-#------###-#-####--#-#-----##-##------#--#---####-----#------##-----#----#---------#--------#--
------#-------#-----#-----##----##--#-##-----##--#-#----#--##-#----#-#-#----#-------------#-----####
#---------#---###--#------#-#------#--#----#-----------#---#-#---##------##----#--#-#--#---#-------#
--------#------#--#--#---#----#----#----#-----#----#-##---##--#-#--#---#--##-#----#-##--------------
#-##---#--#--#-----#--##----##---------------###-----##-#--#---#-#----#--#---#----##--###----#--#-##
----#---##-#-###-###-----#-----#------#-##---#--------#--#-#-#-----#-#----#----##------#-------#----
-#------#-###----------###-#----#-#-####-##--------#-------###--##---#-##----#-#--##-----##----#-##-
--##----------##-#--#------##--#-##--######-#--#-----#---#--------##--#-#-##--#--####-#--#--#---#-#-
-####------#--#-------#-----#-#----#--#-------#----#-#-#-#----#--#---#-##-#--#------#-#-#-#-#-----##
---#------#-#-#---------#--#-#------#-------#---#---#-#--#-###-##--#-#---#-#--#--####-----##---#----
-----#-------#--#----#-----#-#-##----####----#-##--#---#-#----#-#-----------------#-----------------
----#---##-##-#-#-----#-#-#--#-----#--#------#-##-#-#-#--------#--#-##-####--#-------#-#-----####--#
#--##-#---------#----#--#--##--#-#-#-----##--##--#-###--###----#----------###-#-#--#----#--------#-#
---#------##-#--#-----#--##-#-#--####--###-##-#---###--#-#--#--##---#-#---#--#---##---#-##---#---##-
-###----#----##--#-#-------#--#--#-#-###----------####-----###----------##---------------#---#---#--
-#-#------#-#------#-#-#--##-----#--#---#----##-#---#----------##--#---##--#--#----#-----##---##----
----##--##---#--#-------#-#-##----#-#----##-#-##-#----#---##------####---##---##-------#--#--#------
##--------#-#--#---#----------------##-##----------##---#---#----##---#---#--------#--#---##--------
--###-#-###--#---#-#-#---##--##--##--#-##---#-#-----#####----#--------------#-------##--#----##---#-
-------#--##-----##-----##-#----#--##-#--##-#---#--#--#--#----#-#-------####-----------#-#--###---#-
----#--------#--##--#--#-------#---#--#--#----------------#-----#-#-#--------#------#--#--##--##--#-
--#-#--#---#-#----#---##-#-#----###--#---------------#-#-----#--##---#-#---#------#--#--##-#----##--
###----#----####---#-###-#------#-#----#-#-##-----#-----#-#----#-#-----------#------#---##-##-#----#
---------##--#-------------##--#----###-#---#--##-----#---#-#----#-#-##--#-#--#----##-----#-#-----#-
---#-----##-#----###---#--#----------##-#-----#-#-#-------##-#---##---#-##----###-#-##------##-#----
-#---#-------##---##---##-#------#-------##-#-#-#-----#-#-#---###----------------#-#--#----#--------
#--E-----#-#---------#-#--#---#-----###---#---##---------#------#--##--#--#-#-----##---#-#-#-#------
----###----#------#------##-##-#-##------#-----##--#---#-#------#--#------##-----##-#-#-----#--##--#