?diagonal=OnlyWhenNoObstacles;
--#----#----#-----#-----#---------#-##-----#-#---#---------------#----#--#-##---#-#----------#----#-
#----#-----#---#-###-#--##----#---#---#--#--#-------##----##-####--#---##------#--#------#--#---#---
-#--#--#-##------#---#---------#----#----#-#-----##-#--#--#--#-------##-#---#####-#-----##-----##-#-
----#-#------##------##--###---#--#--------#--#------#---#---#-#-##---#-###--##----#-#-#-#-------#--
#---------#--##-#---#-#--#---#----#-----#---------#-----#-#--#----#-----#-#-#--#-#-------------##---
---#####----#---#-#-#---###---#----#--#--#--------#----#-#--#---##----------##-#--#-####----#------#
-------#--#--#---#-----#----#-#-#--##----#-----##----------------------#--#--#-----------#------#--#
---#--------#-#-#----#----#---#-#------#----#-#--##--###---#------###----------#----###---###--#----
#-#----#-#--#--#--#-----#-#--#---------#-------#----#---#---#--#------##---#-#---#-#-#----#--###----
####-#-------##----#-###---------##-#-#-#-#-#####--#----#---#-----#-------#--#----##---------#--##--
--#--#------#--##--#-#-#-##----#--##----#---#--#-#------#--#####------#---#---#-----#---#-----------
-#-#-#-##----#-------#----##-#-#--#-----------#--#--#---###--#--#-#-#-------##--###-#---#-------#---
#-#-------####-#----------#-------###-#-###---#--##-#-####----#---#-----#-#---#------##--#--#-##----
-###-#-----##-#----#-#---------------#----#----------#-------#--#-----#---#-#-###--#---##---#---#-#-
#--###--#------#-##--#-----####-#---#-####-##--#-###-----#-----#---##--##-##-#####---#-----------#--
##----#----#---#------##--------##-##-----#-----##---------#---##------#-###-----#-#-------#-------#
#-#-#-#--##---#---##--#--##--#---#-#--###-##--#-----#---#---#--#--#--####--#----#---##---#--#---#---
---##-#--#---#----#--####--#---#---#--------##-##---#-#-#--------------#--#---#---#-###------#-#--#-
#-#-------#-------##-------#--#---##---##--##-#----#--#--##----#-#--#----------#--#---#-#---#----#--
-------#--#--#----------#------##-------##---###--#--##---#-###------#---#--###-----#--##---##-#--#-
-#-#--#-----#-#--##--#------#-#####-#---------###--##-------#-#-------#----##-#-------###-#---#-#-#-
-#--#--#--------#--###---##-#-#-----#-#-#-#-##--#--##--#-##-------#------#---#-###-----#------#----#
-#-#-#---#----##---#---#-#-#----#-#--##-------#----#####------#-----#------#----#----#---#--#-#----#
-#----#--#-##--#-------#-##--##-##---#------##----#---#----------#-------#-------#-#-#----##------#-
----##----#-----#-#---#------------#--##--##---#-#--##-##-#--------#--#-##---#------#-----##-----#--
-#----------####-#---#--###---#---#-------#-----#---###-------#---#E----#-#--##---#-#--#--#-------#-
-#----#----#-#--##----#--##----#---#----#------#--#-#----#-------#-------------##------------#--#---
--##--------#---#---#----##--##--###--####-##----#-#--##--###--#--#----#-#----#-------#-##--------##
-----#-#---------#-#-------------###----##------------#-----#-#######---------#-#-#-#-#-##-#---##---
##--------#---##-----#-------###--###----##-------#---##---#-#--#--##----#---#---##-#------####-#--#
--##-######-#--#-----#-###-----#-----##-----#--------###-#-------#-------##---#--#--#-#----#-----#-#
----##-#--#-#----###----#-----##-#---#-----#-#---##--#-##----#--###-----###---##-#---#--#-----#---##
#----#-#-------##---#------#---##----#---#-----##---#--#-#-----#------#----------#-----#--------#---
#-##--#-#----###-#------#-####-#---#-------------##---------------------#-#-#####-----#-#-----##---#
----#--#---------#----#----##---#-----#----#----#-#--##--#--#---#---#----#--------##---#----##-#--##
-----#-##----#-----#-#-------##-###-----#---#-#---------##-#--##-###-----#--##--#---##---#------#-#-
-------------------#---#-#-##-##-##-#--#-#-#---#--##--#--#--#---#----------#--#-#------#------##--##
#-------------##----#---##----#-#--##--#---------#-#-#--#-----##---#-----##---#--#-#-#----#-----#---
------#-----#-----###-##-----#--------#-#--#--------#------------#-----------#--#-----#---------####
--#--#-----#--#--#-##--##-#-#-###-##------###--------####-#-------###-----#----#-----------#-------#
---###-----#---#-#-#-----##--#-###--------#-----#-#----#-#-#-#---#------#--#-#-#---#----#--##--##--#
-#------------#--#----###----#-----##-#--#-#-####--#-#-#-#-#--#--------------------#-------###---#-#
#-##-####---##-----------#---#------------#-#-------##-------#-#---#-------##-----------#-----#-#--#
-------#-#-##-------#---##-#--------#-#-----##-#--#--#-##---##---#--#---------#-#--#---------##-----
#--#--##-#-----#------#-#---#------#-##---#--#-#-#-------##--#------------#-#---##--#--#-##-###---##
---###--#-##----#--##-#--#-#-#-#------##-#--####-#-##------##--#--#-----------#-####---#---##----#--
----------#-----#---#--#-#--------------##-----#------#--#-----#--#---#-#-----#-#-#-#--#-#--#-##----
#---#---#-##---#---#####-S###-#-#---#--#-------##--#---###--#-#-#-#-------##-##--#-#-------#--##----
---#----#------#-------###----##-----#-#--#--#-----#-#-----#----####-#--##--###-##---#-#--#----#-#--
--#-----##----#-#----#-#---#-##----------#-#####-#---------##-----#--#----------#-#----------#-#---#
#---#--------#-#-#-#---##---#----#-##----#----##-------#-#-###-#------#-##------#-------#--##-----#-
#--#---#-##--##--#-------#-##--#------#-----#---#-#-#--#----#---#-#-----###--#----#-#----#----------
#----####-###-------##-##--#---#----##-------#---#------#-#-##--#----#-####--#--##-#----#----#----#-
##------#--#-----#-------#------#--##-#----##---------#--#---------##-#-----#--#--#-#-#--#---#----#-
#----#----##--#--##----#--#---#-----##-##--#--#-##--#---##--#---#--##---##--#--##--##-----####--##-#
#---###----#--#-#-##---##--#-#--####--------###-------#----###---#----#-#--##---#-#---------#-----#-
#------#-##-#-#-#---#-----#---##-#--#-----------#-##--#-##--#-------#--#----------##---##--#---#--##
-----#-#####-#----#-#--#--#-#---##----#---#--#--#----------#-##---#----------#-#-#-#-###---------#--
----##-#---#-##----#-----#-------#-##------##--#-##------#-##---##--------#-#---#-------####--#-#--#
---##----#---------#--#-#---#--####-----#------####----##----#-#---##-#----#-#--#-#-####---#--#-####
------####--##---##--##----#-##---#-##-#-#---------#----#----##---------#--#------##----#-##-##-##--
----#-###----#----#--#--###---#---##----##------------#-------#---#-#---#-#--##--#-###--------#-#--#
-#-----#--#-----#----#-#------#----#-----#-#--#-----#-#-----#-###--###---#--#--#------#--##-##---#--
#---#-----------#--##-##------------#-#-##--###-#--##----#---####-##-----##--#--------#------#-##--#
##--##-----#-##--#-#-------#-#---##-#-#--#-##---#---------#----#-#----#-------#--#-#-----#------#---
##--##------#-----#---#--#--#---#---###----###-------#-#--#-#----#-------------###---###-###--------
-#---#--###--##--##-#----#-----------#-#-##---#-----#------------#----#-------#-##-----####-#-##-#--
#----#----#-----##--#----#-----#-#---###-----------##---#---##---------#-#---------------#------#--#
##-----------#----#---##--#-#--#--#-#--------#-#-#-#---#-----#---#--#-------#-####---##---##--#-----
##--#--#-#--#---#---##----#--#-#--###---#------------#-##-#--#-#------#---##------##----#-----##-#--
-----##---#---#------#---#--##-#--#--#---#-----#-#---#------#--#---##---###----##-##----#--###---##-
-----##---###--#-#--##--#---##------------#-##--#---#--------#-----###----#-#-#------#---###---###--
#---##--------####---##--###------#-------#--#----###----#-####-#----#-###--##--------##-#-##-##---#
---#---##-#------------#-##------##------##-------------##--##-##-----#--##--#------#-------------#-
#---###---------#--#--#----------#--#----#--#---#--#-#----#--###---------------#-#--------------#--#
#--#---##--#---#--------#---#----#####---#-----#-#----#--#-##---#--###-##----#---#----------##-----#
##-----#---####---#----#-#---#--#-#----###--#--#----##-#---##-######---#---#--#-####---#---#-#-----#
-#-##----#-#-#---#-##--#--#-#-##--#--#-#-###-#--###----#--##-----#---#----#--#-#------##------------
-##------#---#---##----##---#------------###------------#-#------#--#-----#--#---#---#-##----#------
----#-#---#-##-------##--#--#--#-#-#-#---##-##--#------##-##---#-#-#----##------#------#-##-###--#--
-###----##----##------#---##-#-----#----------#-------#---#-##---#---#-----#---##--#-#---------#--#-
#-#---##---#--##--##---#---##--------#-#--#-###----##--#-----##-----#-####-----#----------#-#--##-##
#---#--#-#-#---##----#-##---##--###--#-##--#-##----##-####--####-#-#-----###--#-##-###-###--------#-
-#-#-####----------#-#-------#--##-##-#-----#--#---##-----#----#--#-----#----#----##-#-#-##--------#
---------------#-------#--#--#---#-###----#--#--------------#---------#-#------##---#----##--#--####
-#-#--#--#--##------#------------#--------------#-#-----###---------#--#---#--#---##--#---#-#--##---
#--#---###--#-#--#--#-##-#---------#--##--##------#----#---#---#-##---#---#-#--#--##----##-#--###--#
---#--##-##---#-#-##-----#--#---#--###-#-#-##---##-#--##---##---##--#-##-#-#-#---#----#-#--#-#------
#--#-----#-----##---##-#-#-------#------##-###-----#-###----##--#-##---------#-----#----##---#-#----
-----#--#----##-##-#---#--#--#------#-#-#-------##-#-#-----#--##---##----#-#--#-#---##--##-#-##-----
-##----#-#--#-------#-----#---------##--###-#--#--#--#--##---##---###---##------##-#-----#-#----##-#
------####---###-#-#-#-#-----#--#-##----##------#----#----##--#--##--#-#--##---#----#------#--#--#--
--#--#------------#---#-#--#---#---###-#----#-#-------###--#-#--#----------#-#----------#---#--#--#-
--#-#---#------###-###---##-##-----#----#-----#------##-#-#-##--#--#---#-------#----#----------##---
##-##------------#--#--##---#--#---#-#---###-#-#-----#----#-------##-#--------#----#-#---#--#----#-#
-###---#--##---##--#-------------#---##---------#----#-#---#--------#-----#--#--#-##-#--#-#--#---#-#
--#-##-#-#-#----#---##-#-------#--#----#--#-####-------##-##----##---#--#-----#--#----#--#-#--------
#-#-####----#---#-####---#-#-#---#--##-----#-----##-##-#-###-----#--#----#-###--------#----#-#-----#
----##--#---#--###-#---#-#-#-#----#-#----#-----#-------#------#-#-#-#---#--##-----###----#---#----#-
#-------#--#-----###----#--#-#-##-------####---#--------#--#-#-#--##--#--------#--#-##------##-#-###