?diagonal=OnlyWhenNoObstacles;
-------#--#---#--###-------#-----#-----#-#-#---------#--#------#--#-#-#-----#-#-----#--------#------
-----##----#--#-------#------##-#----###----##-#-#---#-----#----#-####---#--------##--#-------------
#---#-##--#-#-#-#---##-#------------#-#----#-##-#-----##-------#----------------#-----#--#----------
--###---##-#---#-----#-##--------#-#-------#-#-#---#--##-#---#----###-#---#-----#-###----##---#-----
##--#--#-#--##--#----##--#--#-#--#----##--#----#---#-#------#-#-#---------###---#--#----#----##----#
-#--#-----#-##-#------####----#--#-#-#-#-----#-#--##-#---##---#-#---------#-#-#----------##--------#
---------#--#-####-------#--###-----#---#-#--#####---#--##------##----#----##-##----#-------#-------
---##--#--#---###---#-------#--#-##----#--#--#----#-#-##----#----#---#-----#-#-------#--#-----###-##
------##------#---#---##--##------#-##---------#---##--#-#----#---------#-#-#--#-#--#------#-#--##--
--------#-#-##----#-----#----##---------##-#-----#--##-----##-#-#-####--###--#-#------###-----------
-----------#-#---##---------##------#---###----#-#----------------------##--##----##-#-#--#-##----##
--#--#-#----##-##-#-#-----#----#--#---##------#-#-#-----#--#--------#--#-#-##--#-#------------#--##-
-##--##-#---#-E--#--------#--#--#-----###--#-###----#-#--#----#-----------##-------#--#-#-#-#-#--#--
-----#----#-#----#---#-#-----##--##-#-------##----------#-###-#-##---#--#--#--##---###---#-##--#----
-----##--##-##-----###-##---##------#---#-#--###---#----#-------#-#--#---#---#--##-----#---#-----#-#
--#--###---####-#-###--#-----------#--###----#------###-###-##-#-#--#####--#----##--#----##--###-##-
-#-#-#------#---------#----#-#---------#-------#--#-#-#-#-#-----#--#------#---#----#---##--###-----#
-#--#---#-###-##--#----####-#------#-----#---##-#-####-#-#-##--------##-#----#----#-----#-------####
###-----------###-#------###--##--#--------#--#--##-#-#-##--###--------##------##-#-#---#-----------
##--##----#------#--#--------#--#-##------#-##-#--##--------#---##---#--###---#-#-###----#-#-----##-
##---#--#-------#---###-#-#--#-----#-###-#-###---#---#-#-####-------##-----#-#-------#-##-----------
-#--#---#--#----#-------#-#---####-#-#-##-#--###---##--#--#-----####---#--------#-#---#--#-#--#----#
#-#--#----#-####-#-#-------###-#------##-------#-#--------#-##----#####------#--#--#-##-##-#--#---#-
--#--##----#--#--#--#-#-###-----#-##--#-#-#------#--##-----#------#-#-#-#----#----#--##------##----#
--##-##----#--###-##---#-#####-----------#---###-#--#-------#----------#-----##---##-----#--#----#--
--#----#--------#--#--#--##--#------#-#-#-##--#-----#----------#-##--#-#-----#-#-#--##--#-#---##-#--
#---#--#---#-#-#------##----##----#-#--#-----##---#---##--#--###----#-#-#---#-#-#---##---#---#####--
-----#--#---#-#####-----#-#------##---#--#-----#--#--#-------##--#--###--#-----------#---#----#-----
##--#-#--##-###--##-#-------###--##-####------#-#----###-----#--#-###-######-#---#-##--#----#--###--
----#-#-----#-###--------#-#---#---#----#-------##---#-##-##---#---#-#------#-#--##--#-S-----#-#----
-----##--#------#----------#---#-----------##------------#----------------#--#-------##-#-----##----
-----##--##-----##-#-#-##--#----#---###---#-##---###--#-#---#---#--#----##-#------#--##-----#---#-#-
###-#--#---#-----##-##-#------#--##----#-####---###-----##--#----#---#--#----#----#--###-#-----#----
##--###---#-###-#-##--#--#--##----##----#-###--###-------------##--------#-------#-#-#-------#------
#--#---#------#-#--#----##-------###-#--##-#-#---#-####----#-#-#--#---------#-----#--####-#-#-#-----
#---#---##-------#---------#---#---#-##-##------##-##-----#--#-------#----#---#-##-#--####---------#
--------#-####----#----#---#####--#--##-##-----###---#-----#-------#-------##-------#-##--#-#-#---##
#--##----#----#----##---#---#-#--#------##---#---#-#----#--#-###----#------#-------#-------#--------
##-----###--#--------------#-#-##---#----#-#---##---#--##-#-----#-----####---#-#----##--#--------#--
--#-#---#-----------------#-##-#----#-#-###--------#----#----#----#-------##--------#-#---#-###--###
###--##-#--------#-#-#####-#-------#------#-#-----#-#-#--#---##----#-----#--#--#-#-##------##-------
----##---#-#-----#---#--###---#--#--------#---##--#--#--#-----##-------###--#-#-#----##-#--#---#--#-
-----#-------##--#---#-#-#-###--####----------------##---#-----###-#----#--#-#-#-#---------#---#-##-
#---#---#----##---###--#---#-#-#---#-#---#-#-##------#------#------#---#---#--------#-----##---#-###
--##--#--#-#----#--#-##-##----##------##-#--#-----#---#----#---#-#---#------#-#--##---#----#---#---#
-----#------#--#-----#------#-#---#--#--#--#----#----#--#-####-#-----#---#---##--#----#-##-----#----
-###-------#--#-###------#-#----#------####---#---#-#--##--#---##----####--#---#------#--#--####-#--
#---#------##-----#-#------#-#-#-#---#------#####--##-#-###----#---#-------#------------------------
--#----#-#---#---#-##---#-##---###--#----#-------------------#-##-#--#-----#---------#-#--#--------#
------#--#---#--#-######---#-#-#-----#----#----#-#-----#--###-##--#-----#-----#####-#---###--###---#
-------#---#-----#--##-----##--#---#-##--####-##--#-#-#-#-####---#------####---#-----##---#-#--##--#
-#-#####-------#----------#-#---------#-#-#--#----##-#-#----#----#####-#-#---------#-------#--------
--------##-#------#----##--#--##--##---#-----#-#-----#---#---###--###---------#----#-##-------#---##
--------------------##----##----##-----##--#----#----#---------------#--#--------##--------##----#--
-#----#--##--#-#--#------#----------#---#-----------#--#--#----#-#--#--##-#---#-##---#-#-----#--#-#-
#--##------#--#------#-###--#-#--#----#-##-###------##---#-#-#--------###-----#-##------------------
#--##-#---#----#-------#-----#-----#-##---##-#---#-#---------#-#-#----#-#----------#-----#-----##--#
-#---##--#------#--##--#-#-#--#---#------#------#-------#---#----#----#-----#-------##---#-#--#-----
--##----#----#------##------#---#---#---####--#----##---#-#-##----#--#---##-#---#-----##--##------#-
----##-##---#--#--#------#-----####-#--#--#-----#----#----#-##-#---#--##-#----####------#---#-#-----
-----#---###--#----##-#----##-------###-##----#--#-#------###--#---#-#-#---#--####-#-#---###--------
-----##--#-#-----##---#----#---#---#---#--##----#--#---------#####-##-##-----##----##-#-###--##-----
###----##----##---#---#-----##---#------#-#------#-##-----#--##-#-#--#------#-#--#-#----#-----##---#
-#----##-#####--#-##--#---#-#----------#--#-#-##---------#--#-----------##-#-#-----------#----#---#-
#-----#-------#--###---##--#--#----#----------##--------###---#-##-##--###---#-#-----------#--#-#---
##-#--###----#-#-#--##----------#------------####---#-#--------###----##-----#-#----##--#--------#-#
-####--#---#---#----#----##---##----#--##-#--#-------##--##-#--#--#--###-##----------##---###----#--
--#--#-----#--#-----#----#-##-#------##--#----###--#-#------#--#--##-----#-#----#---------#----##-##
-#------#--#--#-#----###---#-#--##---#---##---#-----#---#-----------##--##--#--###-#--##-##-------#-
#------#---#--------#-####-------#--##--#--#-#--#-#---###-#-#-----#------#-------##------#---#------
-------#--#-----##---#--------##-------------#-#-##-#----##--#--------#-------#-------#--#-###-----#
---#---#-#-----#----#--#---##--##-----#-#---#----##-#-#-----#--#------##--##----#---#-----#---#--##-
-####---#-#--#--#-##-#-----------------##-----#-#-#-##--#-##-------#------------------#---##-#---###
------#------#--#-#---###--###------#-#----#-#---#---#----#--------#---#----#-#----#-------#-#-##---
-#---##---#------------#----------#--#-#-##-#---#--#--#-##------#---##------#---#-#--#----#-##-###--
-----------#--#--#-#-##---#---#---#--#--------------#-#------#-----#--#-#----#---#-#--#-----#--#----
--#----#-#--#--###------#-----#--##-#-#-------#-#--##----#---#--#-#-#----#--#--#------#-#---##--#---
-#------####---##------------####---##-##------#----#-#-#-----#---#--#-##-----#------##----#----#-##
--#-##----#--#--#---##-----------#-#--#---###-##---#--#--#-----------#---#----------##-----#------##
--###--##-#-#---##------------#-#-----#---#---#---#--#--##----##----##---##--#-##-#-#------#-#--##--
#---##-----------#-##----------#--------#--##-##-##--------##-#-----##--##--------##-##---#--##--#--
#----##-#------#-#-----------##----##--------#-#---#-------##-#-----#-----#-----#-##----#--#--##----
---#-##---#-#--#--#-------###-----###--#--------#--###--##-----#-------#------#-#--#---#----#####-#-
-#----------#-####--##-------#--#-##---#---------#-#-#----#-----#-#-#--#--------------#-#--------##-
---#------#----#-------#-#####-##---#------#-#-#---##-##----##---#---####----#--##-#-##-####---#--#-
-----#-#-----------##------------#--#-#--#---#---#----##-#---#-#--##-----#----------#------------##-
------#-#-#-####-##--------#---#--#-------###------###-------##------####----#--#---#--#-#-#-------#
-##---###------------#-----###-###--------#---#-###--#--------#-----#---##-#---#-#--##-##-#-#------#
-#-#-#-#----#------#--#--#---##----#---#--#-------##----#-#--#-#-----#-#-#-#--------#--------###----
-#-----------#---#-#--###---#-#-#-----#-#-#--#---#----#-##-#-#---##--#--##--#--##--##---#---#----#-#
#--####---#-#-##-#---##-#-----##--##------#------#-----#-------#----#-------##-#-#-####--#---#--#-#-
-#--#-------##---#####---##-#--#----#######-#-----------###------##-#-#--#-#-----#---#-#--##-##-#-#-
-#-----#-###----------#------###---#----#-#-#--##-----#------#-------#--##-----#-#----#--------#-#--
--#---#--##-#--##-#--#-#----------######--------#-##-#----#----#-#-##---#-#----##--#--#---##-#---#--
-----#--##-#--##----#--##----##---#---#-##---#----##--#--#--#------#-#---#-##-----#-----##------#-#-
-###-----------#----##--#--#------#-#--###-#--#-#------#----------###-----#-##---##------#-----#----
-#--##---#----#-#---#-#-----------#------------###---##-#-#-#-#--##-#-##--#--#--#-------------------
#-#-----#--##-#--##--#--#--#-#---#-#-------#---------#---##-#-----##---#--#------#--#----#------#---
--#-#-------#-----------------#-#-#--------##-----#-#-#-#--------#----#---#------------#--#-#-###---
---####-----#--#----#---#-#-#----#------#---###-#--##----#-##--##-#---#-#--###-##--##----#--#---#-#-