?diagonal=OnlyWhenNoObstacles;
-----##-##-----------#---##-#--#--#--##----#-##--#---#---####--##-------#------#-#---##-----####----
--#--##-#--##----------#----#--##----#--#-#---##--###-##-----#####---###---###--------#--#----##----
#--#-#----#-------#---------------#---##--#-##--#--------#-------#-----#---#----#---#--##-##-----#--
--#--#-#--#--#---#-###-#---##--##-#------#-#-#---#--#--------#--##-#--#----#----#-------#-#-##------
--###--#--#------#-#---##----#-------------##---#-###------###-#-----------#----##-####------------#
-#-##--#-#-#----#----#--------#-#----##-#--#--#---#---#-#---#-------#--##----#--#------#-#-#--#-####
#-##--###---------#---#--#----#---#--##-----#-----#--##-------##---#----#--#-------#-##--##---#-----
-#--##--------#-----#-#--#-##---#--#------##-#---##------#---------#--#-#--#--#------#--##-#---#----
----#----##----##-##-#-----#--##--#-#####---##-------------##----#-----##--##-----#-----------#---#-
------#-###--#---######--#-#---###--#--#-#---#---###---####-----#---#---#-####-------#----###--#----
-##-----#------------#------#-#---##-##--#---------#------##---------##-#----------#-----#-##-#-#---
-#--#-----#-##---##-#---##-##--#---###-----#--#---#-------###-#-------#------#--##---#--#--#---##---
----##----#---#-#----#----###---##--#------#-#-----##-----#-----#------#------##-#---#-##---###--#--
-##-###----#----#--#-#------#-##--##-----#--##------#----#-##--#-#-##---###-##----#---#------#-#-#--
---#---------#-#--#----------#-##----#--------#--#-#---------#--#-#---------#--------------#--------
##---##------#-----##---------#-######----#----#-#--#---###-##---#----#----##--#-#---#--#-----#--##-
-##--##-##--#-##-#-##---##--#-----#-##-----------#-#-##---#-#-#--#----#---------------#-#-#-#---#---
---##---#--###-#---#-----#-#--#-#---#-#---#--##-##--#----------#-----#---#-#-#---#-######-#-----#-#-
##-----#--------#-#---###-#------------#--#----##---#-##--##--------------#-------#-------#--##--#--
#--------##-----#---#---#--#######--##-##--##----#---------#--#--#---#-#-#------#--#-#-#-#-##-##----
--###---##---#-##-#-------#--##-#-#-#---#-#--------##----#-#-#--#--#-#------#-##-----------#-#--##--
-----##-#-##----###----#--#-##-#--#--####-----#---------------#--#-#-##-#---#-#---#-----------#-#--#
-##---###----#-#---#-#-----#--#--##--------#-#--------#--#---#----#-------#--#--#---#------#-#--#-#-
---#-----#-#-------#--------#---#--#-#-##---#----##--##---#------#-----##--#-#-##----#----------#---
---#--#--#--#--#---##--#---#-#--#--##-#-##--#--##--##----#----#---#-#-#--#-#-#-----#---#----#-----#-
-#-#-----#-#--#-#-#--#---##--------####-#----##-----###--#-------#--##-#--#-----#-#--#-##---#-------
#----#---#-----#-#-#----------####---#---#-#------------#------#--#--#--#---#----#--#-##-----##--##-
##-#-----#-------------------#---#-###-#--#--#--#----#---------#-----#-------#---#-#----#-------##--
-#-#-#---------#---#-------#------#-----###-----#----#--#---#--------#-###-###-##--------##--#---##-
---#-#---#--#---##-#-#-#-##----#---#-##----#-##-#--#-#---#--------###-#-##-#---#--------#-##-##-#-##
-#--------------#----#-##---#-#-#--#--###-------##-------#-#-###-#-#---##----------#-#---#-----#---#
-#----#-#-#-#-#--#----------#-##-#--------------##--#-#-#------#---------#---#----#-#--------#--#--#
------#-##-#------##-#--#-##---#--#####--#--#--##--#-#-##----#---#-#-#---#----#-#-#-##-#--###--#--#-
-##--####-#---#-#-----##--------#----##--#-#---##-----##-##---#---#-#--------------#------#-------#-
##------------------#--#------#---#####------#-#----#-#---------#-#-#-----#-----------#---#---##-###
--#-##-#-----#-------##--#-####-----#---#--#--#-------------------#--#-----------#-------###------##
-#--##-------###------#-----####-#-#---###-####---#-#-#----#-#-#----##-#------#--------#-#------##--
------#--#----#--#----#--##----#--#-#---#-#----#--#-#-#-----##---#-#-##------#-------#------###--#--
###-#-#-----#---###------#-#------##--------#-#--#-#--#--#---#----#--#-##-##-#----#-#---#-#------#-#
#----------#-##--#-----#-##--------#--##----#-#####--##-#-#-#--#-#-----##---#-#---#------##----##---
----####-------#--#------#---##---#-##---##--------#---##-#----#--##-----#------#-----#-###-###-----
-##-------#-----#---##--#----------##-####-#----#-##---#-#---#---#--#--###-----------------#------#-
----------#-----#---#--------#--#----#-#----#-###-#-#--#--------#-#-----##-#--#-#----#-#-#--#-#--#-#
----#-##-----#---#-##----##---#--#----#-###-------##-----#---####-####---#--###-#-####--#--------##-
--#---#----##----#-##---#--#--#-#-#-----##-#-#-##----##------##-#--##-#--##-#-#-##-#--#-#-##-##-----
-------#-#--##---#--#--#----#---#--#-#--####-#---------#-#-##-------------###-#--##------#---#--#---
#-------#-----###-##--#--#---#-#####-##--#--#-#--#-####-------------###--#-#-----#---#-#-#---#---#--
#---------#---#--#------------#--#-----------#---#--####----#---##-#----#-------##----#-#-----#-----
###-#--#------###-#---#----#-----#-----#---#--###---###--#-#--##-#-##-###--#--#-------#---##-##-----
--------##----#---#------#-##-#---##-#-##-#---#--#----##------#-#--#-----#-#------#--#----###-------
------#----#--##----#-#----#-#--#---------#--#-#-----##--------####---#--#-#-----###--##-##-#----##-
#----##------#-#-----##--###----------#---------#-----###---------##-#--#--##----###--#######---###-
---#---###-##-##-##-#-#-----###---#---##--#-##--##-------#-#-#-###---#------#--#-#-##---#-##---##--#
---#---#--##-##--#-#-#-----##---------###--#------###----#--------#--#-#--#-###-----#--------##-#---
--##---##---------#---##--------#-----##--##-####--##--#-#---#-----#----#-#-###-#--##--###---##--#--
##-##--#--##---##-------##-#---##--#---------#-#----##----###-#----#-#-#------#--##-#------#--------
-----#--##----#-#--#--##-----#----#------##-#------#-#-------#-#-###--#-#-###-#-----------------#---
----#--#-##--#-------#-#----------S#--##---###-#----#---------#-----------##--------#----##----#--#-
-----#-#-#-#-----------##-------#-#-##---#--#---###----#--#---#-#---------#--#--#----#-#----#---#---
-#--##------#-#----#------#----#-#-##-##-#-#--##-####--##--##-#---#-#-##-#----------#--#------#----#
##---------------#-------#-##-##--#-------#--#-#---##------##-#----##--#-#---#--#--###-####-#-###---
-----##---------#-#-#-##--#-#---#-#------#-----#----#--#---##--#-------------#-###-------#--#-----#-
-##-##------#---#-#---#-#--#--#-#-##-#------#-#-----------#---#-----###-------##---#---#--#--#------
-#--#-#--#--#-#--#---#-#---#--#--#-#-#---#---#---#------#-----#--#-----#--###----#-#-#----#--#---#-#
---##--###---#-------#-----#--#--#-#-----#-###-##--##--#--#---####--#----#--#--#--#-##-#---#-----#-#
#----##----#-#-##-#-----------##-#----#---#---###------------#-##----###-#-##-----#-------#-----#---
-#---#--#-#-##---#----#---###---##--#--------#-----##-----------####-##-#------#-#----#--##---#--#-#
#-----###---#-#-----#-----#-#-#-#--------#-----#-#####----------#--#--#--#----------#-#----#-##----#
---------#-#--#----##--------#---#-#-#---#-##--#-#-----------#----------##--#---###------#---#-#-#--
------##-------#----##-------#---------###-#-#---#-----##----#----##-------#--#-#--#--#--##-------#-
----##-##-#--##----#-#---------#--#---#--###--#--##-------#------#------#---#---##-#---#--##-----#--
---##---------#----#-#--#-#--##---#-----------#--##-----------##-#-#----##-###-----##--#---#-#-#----
#---#---#---##--###---##-#---#--#----##--#-#-#-####---#---##---#-#--------#--------#-##-------------
---#----#----#-#------#-#----#---------#-------##---#-##---##-----#-#---#-#--##-------##--#---#-##-#
##-#--#--##---#--##-#-##---------##----#-#--###--------#-#---#----#-#------#-------#-##---#---------
---#--#-#-----##-##-#--##--#---#------------#--#-##-----#-##-----#-#------#------------#-------##---
-#-#---#--#-##-#----##-#--------##--#--#-#--------#-###--#------##-#-#----#---#--##-----#-##--##-#--
---#--#-------#----#---#-#-----#-##---#------###-##---#----#----#-#-#--#-#------#---##---##---------
-#--##-----#---------#-----#---#-------###-#-#----##---#-#-#----#--##-#--###------------------------
#####---------#-#--#----------###------#--#--##--#-##--------#------#--#---#--#--------##-------#---
-------#-#--#--#-----#-###-#--------------------##--#--#---#--#---#-##-##-#--##--#-----------####-#-
--#--#-##---#------#-#---#---##----##----------#--#--#----##------#---#----#---#--#----#-#-##------#
--------#-#-----##-#--------#-#----------##-#-##-###--#-#-----###----------------#--#--#-####--#-###
#####-###-----#-#-#----#--##--####---------#-##-#--------#---##------##--##---#----##--##-###---##-#
---##-##---#---#####----#---##-#---#--#--#---##-----#----------##-#----####------------#-#--##--#--#
-#-#-#-#-#----#--#-##--####--#-##-----#----#-#---#---#--#-#---###--------###---#--#-#----#-##----##-
##--###----#-#--#-##--#-#--##------#------#------#---#---#----##---##----#---###-#-#---#--#---------
#-#--#---#-------#-#--##---##-#--#------------##---#--#-#-#--#----------#---#-#-####---#--#-#-##----
-------##---#----#-----#-#-#----#---#-#-#-#--#-#---------#----------#--##-#---#-----#-----------#---
----#--#----#--###-#----##-##---#----##--#---#-------#-###------------#-###---#-----------#----###-#
------#-##------#-#-#----------#----------#--#-----#--#---#------------###--#-###-----#--##---#-#-#-
--#-#---#--#--#------#--------#-##----##--#-#--#-----##-#---#-#-----#----##------##----#-#------#---
----#---####--#-----#----#-------#-----------##-##-#--#---------#-#--#--##--#--#--#----#---###---#--
-##--#--------------#------###-------------#-##-----#---#-------#-#--##---#--#-#---#---------E-#--##
----##---###--#------#-#--------#-#--##-------------##-#--###----------####-#-----------###---------
##-----##---##-##---#-#####-#---###---##---#-#---###---#--#-###-#-#----------------------#-##--#--#-
--#--#-----#--#-#-----#----------#--#-#----#--#------#--#-##-------#-##--##----#---#-##-#-----#-----
-##-----------#-#---#--#---#----#---#-#-###-----##-------------#--#####-#------#------##--#----#-#-#
---------#----##-##-#-#-#--#-#--#-######-##-#----##----###-#--###--#----####-----#------##-----##--#
---###-##-#--#----#-#####-######--##----#-#------#-#-------#-#--#--#-----##---#--#----#------#-#----