?diagonal=IfAtMostOneObstacle;
--##---##---##---##---##---##---##---##---##---##---##---##---##---##---##---##---##---##---##---##-
---#----#----#----#----#----#----#----#----#----#----#----#----#----#----#----#----#----#----#----#-
--#----#----#----#----#----#----#----#----#----#----#----#----#----#----#----#----#----#----#----#--
#---##---##---##---##---##---##---##---##---##---##---##---##---##---##---##---##---##---##---##---#
----------------------------------------------------------------------------------------------------
--##---##---##---##---##---##---##---##---##---##---##---##---##---##---##---##---##---##---##---##-
---#----#----#----#----#----#----#----#----#----#----#----#----#----#----#----#----#----#----#----#-
--#----#----#----#----#----#----#----#----#----#----#----#----#----#----#----#----#----#----#----#--
#---##---##---##---##---##---##---##---##---##---##---##---##---##---##---##---##---##---##---##---#
-----------------S----------------------------------------------------------------------------------
--##---##---##---##---##---##---##---##---##---##---##---##---##---##---##---##---##---##---##---##-
---#----#----#----#----#----#----#----#----#----#----#----#----#----#----#----#----#----#----#----#-
--#----#----#----#----#----#----#----#----#----#----#----#----#----#----#----#----#----#----#----#--
#---##---##---##---##---##---##---##---##---##---##---##---##---##---##---##---##---##---##---##---#
----------------------------------------------------------------------------------------------------
--##---##---##---##---##---##---##---##---##---##---##---##---##---##---##---##---##---##---##---##-
---#----#----#----#----#----#----#----#----#----#----#----#----#----#----#----#----#----#----#----#-
--#----#----#----#----#----#----#----#----#----#----#----#----#----#----#----#----#----#----#----#--
#---##---##---##---##---##---##---##---##---##---##---##---##---##---##---##---##---##---##---##---#
----------------------------------------------------------------------------------------E-----------
--##---##---##---##---##---##---##---##---##---##---##---##---##---##---##---##---##---##---##---##-
---#----#----#----#----#----#----#----#----#----#----#----#----#----#----#----#----#----#----#----#-
--#----#----#----#----#----#----#----#----#----#----#----#----#----#----#----#----#----#----#----#--
#---##---##---##---##---##---##---##---##---##---##---##---##---##---##---##---##---##---##---##---#
----------------------------------------------------------------------------------------------------
--##---##---##---##---##---##---##---##---##---##---##---##---##---##---##---##---##---##---##---##-
---#----#----#----#----#----#----#----#----#----#----#----#----#----#----#----#----#----#----#----#-
--#----#----#----#----#----#----#----#----#----#----#----#----#----#----#----#----#----#----#----#--
#---##---##---##---##---##---##---##---##---##---##---##---##---##---##---##---##---##---##---##---#
----------------------------------------------------------------------------------------------------
--##---##---##---##---##---##---##---##---##---##---##---##---##---##---##---##---##---##---##---##-
---#----#----#----#----#----#----#----#----#----#----#----#----#----#----#----#----#----#----#----#-
--#----#----#----#----#----#----#----#----#----#----#----#----#----#----#----#----#----#----#----#--
#---##---##---##---##---##---##---##---##---##---##---##---##---##---##---##---##---##---##---##---#
----------------------------------------------------------------------------------------------------
--##---##---##---##---##---##---##---##---##---##---##---##---##---##---##---##---##---##---##---##-
---#----#----#----#----#----#----#----#----#----#----#----#----#----#----#----#----#----#----#----#-
--#----#----#----#----#----#----#----#----#----#----#----#----#----#----#----#----#----#----#----#--
#---##---##---##---##---##---##---##---##---##---##---##---##---##---##---##---##---##---##---##---#
----------------------------------------------------------------------------------------------------
--##---##---##---##---##---##---##---##---##---##---##---##---##---##---##---##---##---##---##---##-
---#----#----#----#----#----#----#----#----#----#----#----#----#----#----#----#----#----#----#----#-
--#----#----#----#----#----#----#----#----#----#----#----#----#----#----#----#----#----#----#----#--
#---##---##---##---##---##---##---##---##---##---##---##---##---##---##---##---##---##---##---##---#
----------------------------------------------------------------------------------------------------
--##---##---##---##---##---##---##---##---##---##---##---##---##---##---##---##---##---##---##---##-
---#----#----#----#----#----#----#----#----#----#----#----#----#----#----#----#----#----#----#----#-
--#----#----#----#----#----#----#----#----#----#----#----#----#----#----#----#----#----#----#----#--
#---##---##---##---##---##---##---##---##---##---##---##---##---##---##---##---##---##---##---##---#
----------------------------------------------------------------------------------------------------
--##---##---##---##---##---##---##---##---##---##---##---##---##---##---##---##---##---##---##---##-
---#----#----#----#----#----#----#----#----#----#----#----#----#----#----#----#----#----#----#----#-
--#----#----#----#----#----#----#----#----#----#----#----#----#----#----#----#----#----#----#----#--
#---##---##---##---##---##---##---##---##---##---##---##---##---##---##---##---##---##---##---##---#
----------------------------------------------------------------------------------------------------
--##---##---##---##---##---##---##---##---##---##---##---##---##---##---##---##---##---##---##---##-
---#----#----#----#----#----#----#----#----#----#----#----#----#----#----#----#----#----#----#----#-
--#----#----#----#----#----#----#----#----#----#----#----#----#----#----#----#----#----#----#----#--
#---##---##---##---##---##---##---##---##---##---##---##---##---##---##---##---##---##---##---##---#
----------------------------------------------------------------------------------------------------
--##---##---##---##---##---##---##---##---##---##---##---##---##---##---##---##---##---##---##---##-
---#----#----#----#----#----#----#----#----#----#----#----#----#----#----#----#----#----#----#----#-
--#----#----#----#----#----#----#----#----#----#----#----#----#----#----#----#----#----#----#----#--
#---##---##---##---##---##---##---##---##---##---##---##---##---##---##---##---##---##---##---##---#
----------------------------------------------------------------------------------------------------
--##---##---##---##---##---##---##---##---##---##---##---##---##---##---##---##---##---##---##---##-
---#----#----#----#----#----#----#----#----#----#----#----#----#----#----#----#----#----#----#----#-
--#----#----#----#----#----#----#----#----#----#----#----#----#----#----#----#----#----#----#----#--
#---##---##---##---##---##---##---##---##---##---##---##---##---##---##---##---##---##---##---##---#
----------------------------------------------------------------------------------------------------
--##---##---##---##---##---##---##---##---##---##---##---##---##---##---##---##---##---##---##---##-
---#----#----#----#----#----#----#----#----#----#----#----#----#----#----#----#----#----#----#----#-
--#----#----#----#----#----#----#----#----#----#----#----#----#----#----#----#----#----#----#----#--
#---##---##---##---##---##---##---##---##---##---##---##---##---##---##---##---##---##---##---##---#
----------------------------------------------------------------------------------------------------
--##---##---##---##---##---##---##---##---##---##---##---##---##---##---##---##---##---##---##---##-
---#----#----#----#----#----#----#----#----#----#----#----#----#----#----#----#----#----#----#----#-
--#----#----#----#----#----#----#----#----#----#----#----#----#----#----#----#----#----#----#----#--
#---##---##---##---##---##---##---##---##---##---##---##---##---##---##---##---##---##---##---##---#
----------------------------------------------------------------------------------------------------
--##---##---##---##---##---##---##---##---##---##---##---##---##---##---##---##---##---##---##---##-
---#----#----#----#----#----#----#----#----#----#----#----#----#----#----#----#----#----#----#----#-
--#----#----#----#----#----#----#----#----#----#----#----#----#----#----#----#----#----#----#----#--
#---##---##---##---##---##---##---##---##---##---##---##---##---##---##---##---##---##---##---##---#
----------------------------------------------------------------------------------------------------
--##---##---##---##---##---##---##---##---##---##---##---##---##---##---##---##---##---##---##---##-
---#----#----#----#----#----#----#----#----#----#----#----#----#----#----#----#----#----#----#----#-
--#----#----#----#----#----#----#----#----#----#----#----#----#----#----#----#----#----#----#----#--
#---##---##---##---##---##---##---##---##---##---##---##---##---##---##---##---##---##---##---##---#
----------------------------------------------------------------------------------------------------
--##---##---##---##---##---##---##---##---##---##---##---##---##---##---##---##---##---##---##---##-
---#----#----#----#----#----#----#----#----#----#----#----#----#----#----#----#----#----#----#----#-
--#----#----#----#----#----#----#----#----#----#----#----#----#----#----#----#----#----#----#----#--
#---##---##---##---##---##---##---##---##---##---##---##---##---##---##---##---##---##---##---##---#
----------------------------------------------------------------------------------------------------
--##---##---##---##---##---##---##---##---##---##---##---##---##---##---##---##---##---##---##---##-
---#----#----#----#----#----#----#----#----#----#----#----#----#----#----#----#----#----#----#----#-
--#----#----#----#----#----#----#----#----#----#----#----#----#----#----#----#----#----#----#----#--
#---##---##---##---##---##---##---##---##---##---##---##---##---##---##---##---##---##---##---##---#
----------------------------------------------------------------------------------------------------