?diagonal=IfAtMostOneObstacle;
----------------------------------------------------------------------------------------------------
--#-#--#-#--#-#--#-#--#-#--#-#--#-#--#-#--#-#--#-#--#-#--#-#--#-#--#-#--#-#--#-#--#-#--#-#--#-#--#-#
##---##---##---##---##---##---##---##---##---##---##---##---##---##---##---##---##---##---##---##---
-#--#-#--#-#--#-#--#-#--#-#--#-#--#-#--#-#--#-#--#-#--#-#--#-#--#-#--#-#--#-#--#-#--#-#--#-#--#-#--#
--#----#----#----#----#----#----#----#----#----#----#----#----#----#----#----#----#----#----#----#--
----------------------------------------------------------------------------------------------------
--#-#--#-#--#-#--#-#--#-#--#-#--#-#--#-#--#-#--#-#--#-#--#-#--#-#--#-#--#-#--#-#--#-#--#-#--#-#--#-#
##---##---##---##---##---##---##---##---##---##---##---##---##---##---##---##---##---##---##---##---
-#--#-#--#-#--#-#--#-#--#-#--#-#--#-#--#-#--#-#--#-#--#-#--#-#--#-#--#-#--#-#--#-#--#-#--#-#--#-#--#
--#----#----#----#----#----#----#----#----#----#----#----#----#----#----#----#----#----#----#----#--
----------------------------------------------------------------------------------------------------
--#-#--#-#--#-#--#-#--#-#--#-#--#-#--#-#--#-#--#-#--#-#--#-#--#-#--#-#--#-#--#-#--#-#--#-#--#-#--#-#
##---##---##---##---##---##---##---##---##---##---##---##---##---##---##---##---##---##---##---##---
-#--#-#--#-#--#-#--#-#--#-#--#-#--#-#--#-#--#-#--#-#--#-#--#-#--#-#--#-#--#-#--#-#--#-#--#-#--#-#--#
--#----#----#----#----#----#----#-S--#----#----#----#----#----#----#----#----#----#----#----#----#--
----------------------------------------------------------------------------------------------------
--#-#--#-#--#-#--#-#--#-#--#-#--#-#--#-#--#-#--#-#--#-#--#-#--#-#--#-#--#-#--#-#--#-#--#-#--#-#--#-#
##---##---##---##---##---##---##---##---##---##---##---##---##---##---##---##---##---##---##---##---
-#--#-#--#-#--#-#--#-#--#-#--#-#--#-#--#-#--#-#--#-#--#-#--#-#--#-#--#-#--#-#--#-#--#-#--#-#--#-#--#
--#----#----#----#----#----#----#----#----#----#----#----#----#----#----#----#----#----#----#----#--
----------------------------------------------------------------------------------------------------
--#-#--#-#--#-#--#-#--#-#--#-#--#-#--#-#--#-#--#-#--#-#--#-#--#-#--#-#--#-#--#-#--#-#--#-#--#-#--#-#
##---##---##---##---##---##---##---##---##---##---##---##---##---##---##---##---##---##---##---##---
-#--#-#--#-#--#-#--#-#--#-#--#-#--#-#--#-#--#-#--#-#--#-#--#-#--#-#--#-#--#-#--#-#--#-#--#-#--#-#--#
--#----#----#----#----#----#----#----#----#----#----#----#----#----#----#----#----#----#----#----#--
----------------------------------------------------------------------------------------------------
--#-#--#-#--#-#--#-#--#-#--#-#--#-#--#-#--#-#--#-#--#-#--#-#--#-#--#-#--#-#--#-#--#-#--#-#--#-#--#-#
##---##---##---##---##---##---##---##---##---##---##---##---##---##---##---##---##---##---##---##---
-#--#-#--#-#--#-#--#-#--#-#--#-#--#-#--#-#--#-#--#-#--#-#--#-#--#-#--#-#--#-#--#-#--#-#--#-#--#-#--#
--#----#----#----#----#----#----#----#----#----#----#----#----#----#----#----#----#----#----#----#--
----------------------------------------------------------------------------------------------------
--#-#--#-#--#-#--#-#--#-#--#-#--#-#--#-#--#-#--#-#--#-#--#-#--#-#--#-#--#-#--#-#--#-#--#-#--#-#--#-#
##---##---##---##---##---##---##---##---##---##---##---##---##---##---##---##---##---##---##---##---
-#--#-#--#-#--#-#--#-#--#-#--#-#--#-#--#-#--#-#--#-#--#-#--#-#--#-#--#-#--#-#--#-#--#-#--#-#--#-#--#
--#----#----#----#----#----#----#----#----#----#----#----#----#----#----#----#----#----#----#----#--
----------------------------------------------------------------------------------------------------
--#-#--#-#--#-#--#-#--#-#--#-#--#-#--#-#--#-#--#-#--#-#--#-#--#-#--#-#--#-#--#-#--#-#--#-#--#-#--#-#
##---##---##---##---##---##---##---##---##---##---##---##---##---##---##---##---##---##---##---##---
-#--#-#--#-#--#-#--#-#--#-#--#-#--#-#--#-#--#-#--#-#--#-#--#-#--#-#--#-#--#-#--#-#--#-#--#-#--#-#--#
--#----#----#----#----#----#----#----#----#----#----#----#----#----#----#----#----#----#----#----#--
----------------------------------------------------------------------------------------------------
--#-#--#-#--#-#--#-#--#-#--#-#--#-#--#-#--#-#--#-#--#-#--#-#--#-#--#-#--#-#--#-#--#-#--#-#--#-#--#-#
##---##---##---##---##---##---##---##---##---##---##---##---##---##---##---##---##---##---##---##---
-#--#-#--#-#--#-#--#-#--#-#--#-#--#-#--#-#--#-#--#-#--#-#--#-#--#-#--#-#--#-#--#-#--#-#--#-#--#-#--#
--#---E#----#----#----#----#----#----#----#----#----#----#----#----#----#----#----#----#----#----#--
----------------------------------------------------------------------------------------------------
--#-#--#-#--#-#--#-#--#-#--#-#--#-#--#-#--#-#--#-#--#-#--#-#--#-#--#-#--#-#--#-#--#-#--#-#--#-#--#-#
##---##---##---##---##---##---##---##---##---##---##---##---##---##---##---##---##---##---##---##---
-#--#-#--#-#--#-#--#-#--#-#--#-#--#-#--#-#--#-#--#-#--#-#--#-#--#-#--#-#--#-#--#-#--#-#--#-#--#-#--#
--#----#----#----#----#----#----#----#----#----#----#----#----#----#----#----#----#----#----#----#--
----------------------------------------------------------------------------------------------------
--#-#--#-#--#-#--#-#--#-#--#-#--#-#--#-#--#-#--#-#--#-#--#-#--#-#--#-#--#-#--#-#--#-#--#-#--#-#--#-#
##---##---##---##---##---##---##---##---##---##---##---##---##---##---##---##---##---##---##---##---
-#--#-#--#-#--#-#--#-#--#-#--#-#--#-#--#-#--#-#--#-#--#-#--#-#--#-#--#-#--#-#--#-#--#-#--#-#--#-#--#
--#----#----#----#----#----#----#----#----#----#----#----#----#----#----#----#----#----#----#----#--
----------------------------------------------------------------------------------------------------
--#-#--#-#--#-#--#-#--#-#--#-#--#-#--#-#--#-#--#-#--#-#--#-#--#-#--#-#--#-#--#-#--#-#--#-#--#-#--#-#
##---##---##---##---##---##---##---##---##---##---##---##---##---##---##---##---##---##---##---##---
-#--#-#--#-#--#-#--#-#--#-#--#-#--#-#--#-#--#-#--#-#--#-#--#-#--#-#--#-#--#-#--#-#--#-#--#-#--#-#--#
--#----#----#----#----#----#----#----#----#----#----#----#----#----#----#----#----#----#----#----#--
----------------------------------------------------------------------------------------------------
--#-#--#-#--#-#--#-#--#-#--#-#--#-#--#-#--#-#--#-#--#-#--#-#--#-#--#-#--#-#--#-#--#-#--#-#--#-#--#-#
##---##---##---##---##---##---##---##---##---##---##---##---##---##---##---##---##---##---##---##---
-#--#-#--#-#--#-#--#-#--#-#--#-#--#-#--#-#--#-#--#-#--#-#--#-#--#-#--#-#--#-#--#-#--#-#--#-#--#-#--#
--#----#----#----#----#----#----#----#----#----#----#----#----#----#----#----#----#----#----#----#--
----------------------------------------------------------------------------------------------------
--#-#--#-#--#-#--#-#--#-#--#-#--#-#--#-#--#-#--#-#--#-#--#-#--#-#--#-#--#-#--#-#--#-#--#-#--#-#--#-#
##---##---##---##---##---##---##---##---##---##---##---##---##---##---##---##---##---##---##---##---
-#--#-#--#-#--#-#--#-#--#-#--#-#--#-#--#-#--#-#--#-#--#-#--#-#--#-#--#-#--#-#--#-#--#-#--#-#--#-#--#
--#----#----#----#----#----#----#----#----#----#----#----#----#----#----#----#----#----#----#----#--
----------------------------------------------------------------------------------------------------
--#-#--#-#--#-#--#-#--#-#--#-#--#-#--#-#--#-#--#-#--#-#--#-#--#-#--#-#--#-#--#-#--#-#--#-#--#-#--#-#
##---##---##---##---##---##---##---##---##---##---##---##---##---##---##---##---##---##---##---##---
-#--#-#--#-#--#-#--#-#--#-#--#-#--#-#--#-#--#-#--#-#--#-#--#-#--#-#--#-#--#-#--#-#--#-#--#-#--#-#--#
--#----#----#----#----#----#----#----#----#----#----#----#----#----#----#----#----#----#----#----#--
----------------------------------------------------------------------------------------------------
--#-#--#-#--#-#--#-#--#-#--#-#--#-#--#-#--#-#--#-#--#-#--#-#--#-#--#-#--#-#--#-#--#-#--#-#--#-#--#-#
##---##---##---##---##---##---##---##---##---##---##---##---##---##---##---##---##---##---##---##---
-#--#-#--#-#--#-#--#-#--#-#--#-#--#-#--#-#--#-#--#-#--#-#--#-#--#-#--#-#--#-#--#-#--#-#--#-#--#-#--#
--#----#----#----#----#----#----#----#----#----#----#----#----#----#----#----#----#----#----#----#--
----------------------------------------------------------------------------------------------------
--#-#--#-#--#-#--#-#--#-#--#-#--#-#--#-#--#-#--#-#--#-#--#-#--#-#--#-#--#-#--#-#--#-#--#-#--#-#--#-#
##---##---##---##---##---##---##---##---##---##---##---##---##---##---##---##---##---##---##---##---
-#--#-#--#-#--#-#--#-#--#-#--#-#--#-#--#-#--#-#--#-#--#-#--#-#--#-#--#-#--#-#--#-#--#-#--#-#--#-#--#
--#----#----#----#----#----#----#----#----#----#----#----#----#----#----#----#----#----#----#----#--
----------------------------------------------------------------------------------------------------
--#-#--#-#--#-#--#-#--#-#--#-#--#-#--#-#--#-#--#-#--#-#--#-#--#-#--#-#--#-#--#-#--#-#--#-#--#-#--#-#
##---##---##---##---##---##---##---##---##---##---##---##---##---##---##---##---##---##---##---##---
-#--#-#--#-#--#-#--#-#--#-#--#-#--#-#--#-#--#-#--#-#--#-#--#-#--#-#--#-#--#-#--#-#--#-#--#-#--#-#--#
--#----#----#----#----#----#----#----#----#----#----#----#----#----#----#----#----#----#----#----#--
----------------------------------------------------------------------------------------------------
--#-#--#-#--#-#--#-#--#-#--#-#--#-#--#-#--#-#--#-#--#-#--#-#--#-#--#-#--#-#--#-#--#-#--#-#--#-#--#-#
##---##---##---##---##---##---##---##---##---##---##---##---##---##---##---##---##---##---##---##---
-#--#-#--#-#--#-#--#-#--#-#--#-#--#-#--#-#--#-#--#-#--#-#--#-#--#-#--#-#--#-#--#-#--#-#--#-#--#-#--#
--#----#----#----#----#----#----#----#----#----#----#----#----#----#----#----#----#----#----#----#--
----------------------------------------------------------------------------------------------------
--#-#--#-#--#-#--#-#--#-#--#-#--#-#--#-#--#-#--#-#--#-#--#-#--#-#--#-#--#-#--#-#--#-#--#-#--#-#--#-#
##---##---##---##---##---##---##---##---##---##---##---##---##---##---##---##---##---##---##---##---
-#--#-#--#-#--#-#--#-#--#-#--#-#--#-#--#-#--#-#--#-#--#-#--#-#--#-#--#-#--#-#--#-#--#-#--#-#--#-#--#
--#----#----#----#----#----#----#----#----#----#----#----#----#----#----#----#----#----#----#----#--