?diagonal=IfAtMostOneObstacle;
---##---##---##---##---##---##---##---##---##---##---##---##---##---##---##---##---##---##---##---##
----#----#----#----#----#----#----#----#----#----#----#----#----#----#----#----#----#----#----#----#
-#-#--#-#--#-#--#-#--#-#--#-#--#-#--#-#--#-#--#-#--#-#--#-#--#-#--#-#--#-#--#-#--#-#--#-#--#-#--#-#-
#----#----#----#----#----#----#----#----#----#----#----#----#----#----#----#----#----#----#----#----
#---##---##---##---##---##---##---##---##---##---##---##---##---##---##---##---##---##---##---##---#
---##---##---##---##---##---##---##---##---##---##---##---##---##---##---##---##---##---##---##---##
----#----#----#----#----#----#----#----#----#----#----#----#----#----#----#----#----#----#----#----#
-#-#--#-#--#-#--#-#--#-#--#-#--#-#--#-#--#-#--#-#--#-#--#-#--#-#--#-#--#-#--#-#--#-#--#-#--#-#--#-#-
#----#----#----#----#----#----#----#----#----#----#----#----#----#----#----#----#----#----#--S-#----
#---##---##---##---##---##---##---##---##---##---##---##---##---##---##---##---##---##---##---##---#
---##---##---##---##---##---##---##---##---##---##---##---##---##---##---##---##---##---##---##---##
----#----#----#----#----#----#----#----#----#----#----#----#----#----#----#----#----#----#----#----#
-#-#--#-#--#-#--#-#--#-#--#-#--#-#--#-#--#-#--#-#--#-#--#-#--#-#--#-#--#-#--#-#--#-#--#-#--#-#--#-#-
#----#----#----#----#----#----#----#----#----#----#----#----#----#----#----#----#----#----#----#----
#---##---##---##---##---##---##---##---##---##---##---##---##---##---##---##---##---##---##---##---#
---##---##---##---##---##---##---##---##---##---##---##---##---##---##---##---##---##---##---##---##
----#----#----#----#----#----#----#----#----#----#----#----#----#----#----#----#----#----#----#----#
-#-#--#-#--#-#--#-#--#-#--#-#--#-#--#-#--#-#--#-#--#-#--#-#--#-#--#-#--#-#--#-#--#-#--#-#--#-#--#-#-
#----#----#----#----#----#----#----#----#----#----#----#----#----#----#----#----#----#----#----#----
#---##---##---##---##---##---##---##---##---##---##---##---##---##---##---##---##---##---##---##---#
---##---##---##---##---##---##---##---##---##---##---##---##---##---##---##---##---##---##---##---##
----#----#----#----#----#----#----#----#----#----#----#----#----#----#----#----#----#----#----#----#
-#-#--#-#--#-#--#-#--#-#--#-#--#-#--#-#--#-#--#-#--#-#--#-#--#-#--#-#--#-#--#-#--#-#--#-#--#-#--#-#-
#----#----#----#----#----#----#----#----#----#----#----#----#----#----#----#----#----#----#----#----
#---##---##---##---##---##---##---##---##---##---##---##---##---##---##---##---##---##---##---##---#
---##---##---##---##---##---##---##---##---##---##---##---##---##---##---##---##---##---##---##---##
----#----#----#----#----#----#----#----#----#----#----#----#----#----#----#----#----#----#----#----#
-#-#--#-#--#-#--#-#--#-#--#-#--#-#--#-#--#-#--#-#--#-#--#-#--#-#--#-#--#-#--#-#--#-#--#-#--#-#--#-#-
#----#----#----#----#----#----#----#----#----#----#----#----#----#----#----#----#----#----#----#----
#---##---##---##---##---##---##---##---##---##---##---##---##---##---##---##---##---##---##---##---#
---##---##---##---##---##---##---##---##---##---##---##---##---##---##---##---##---##---##---##---##
----#----#----#----#----#----#----#----#----#----#----#----#----#----#----#----#----#----#----#----#
-#-#--#-#--#-#--#-#--#-#--#-#--#-#--#-#--#-#--#-#--#-#--#-#--#-#--#-#--#-#--#-#--#-#--#-#--#-#--#-#-
#----#----#----#----#----#----#----#----#----#----#----#----#----#----#----#----#----#----#----#----
#---##---##---##---##---##---##---##---##---##---##---##---##---##---##---##---##---##---##---##---#
---##---##---##---##---##---##---##---##---##---##---##---##---##---##---##---##---##---##---##---##
----#----#----#----#----#----#----#----#----#----#----#----#----#----#----#----#----#----#----#----#
-#-#--#-#--#-#--#-#--#-#--#-#--#-#--#-#--#-#--#-#--#-#--#-#--#-#--#-#--#-#--#-#--#-#--#-#--#-#--#-#-
#----#----#----#----#----#----#----#----#----#----#----#----#----#----#----#----#----#----#----#----
#---##---##---##---##---##---##---##---##---##---##---##---##---##---##---##---##---##---##---##---#
---##---##---##---##---##---##---##---##---##---##---##---##---##---##---##---##---##---##---##---##
----#----#----#----#----#----#----#----#----#----#----#----#----#----#----#----#----#----#----#----#
-#-#--#-#--#-#--#-#--#-#--#-#--#-#--#-#--#-#--#-#--#-#--#-#--#-#--#-#--#-#--#-#--#-#--#-#--#-#--#-#-
#----#----#----#----#----#----#----#----#----#----#----#----#----#----#----#----#----#----#----#----
#---##---##---##---##---##---##---##---##---##---##---##---##---##---##---##---##---##---##---##---#
---##---##---##---##---##---##---##---##---##---##---##---##---##---##---##---##---##---##---##---##
----#----#----#----#----#----#----#----#----#----#----#----#----#----#----#----#----#----#----#----#
-#-#--#-#--#-#--#-#--#-#--#-#--#-#--#-#--#-#--#-#--#-#--#-#--#-#--#-#--#-#--#-#--#-#--#-#--#-#--#-#-
#----#----#----#----#----#----#----#----#----#----#----#----#----#----#----#----#----#----#----#----
#---##---##---##---##---##---##---##---##---##---##---##---##---##---##---##---##---##---##---##---#
---##---##---##---##---##---##---##---##---##---##---##---##---##---##---##---##---##---##---##---##
----#----#----#----#----#----#----#----#----#----#----#----#----#----#----#----#----#----#----#----#
-#-#--#-#--#-#--#-#--#-#--#-#--#-#--#-#--#-#--#-#--#-#--#-#--#-#--#-#--#-#--#-#--#-#--#-#--#-#--#-#-
#----#----#----#----#----#----#----#----#----#----#----#----#----#----#----#----#----#----#----#----
#---##---##---##---##---##---##---##---##---##---##---##---##---##---##---##---##---##---##---##---#
---##---##---##---##---##---##---##---##---##---##---##---##---##---##---##---##---##---##---##---##
----#----#----#----#----#----#----#----#----#----#----#----#----#----#----#----#----#----#----#----#
-#-#--#-#--#-#--#-#--#-#--#-#--#-#--#-#--#-#--#-#--#-#--#-#--#-#--#-#--#-#--#-#--#-#--#-#--#-#--#-#-
#----#----#----#----#----#----#----#----#----#----#----#----#----#----#----#----#----#----#----#----
#---##---##---##---##---##---##---##---##---##---##---##---##---##---##---##---##---##---##---##---#
---##---##---##---##---##---##---##---##---##---##---##---##---##---##---##---##---##---##---##---##
----#----#----#----#----#----#----#----#----#----#----#----#----#----#----#----#----#----#----#----#
-#-#--#-#--#-#--#-#--#-#--#-#--#-#--#-#--#-#--#-#--#-#--#-#--#-#--#-#--#-#--#-#--#-#--#-#--#-#--#-#-
#----#----#----#----#----#----#----#----#----#----#----#----#----#----#----#----#----#----#----#----
#---##---##---##---##---##---##---##---##---##---##---##---##---##---##---##---##---##---##---##---#
---##---##---##---##---##---##---##---##---##---##---##---##---##---##---##---##---##---##---##---##
----#----#----#----#----#----#----#----#----#----#----#-E--#----#----#----#----#----#----#----#----#
-#-#--#-#--#-#--#-#--#-#--#-#--#-#--#-#--#-#--#-#--#-#--#-#--#-#--#-#--#-#--#-#--#-#--#-#--#-#--#-#-
#----#----#----#----#----#----#----#----#----#----#----#----#----#----#----#----#----#----#----#----
#---##---##---##---##---##---##---##---##---##---##---##---##---##---##---##---##---##---##---##---#
---##---##---##---##---##---##---##---##---##---##---##---##---##---##---##---##---##---##---##---##
----#----#----#----#----#----#----#----#----#----#----#----#----#----#----#----#----#----#----#----#
-#-#--#-#--#-#--#-#--#-#--#-#--#-#--#-#--#-#--#-#--#-#--#-#--#-#--#-#--#-#--#-#--#-#--#-#--#-#--#-#-
#----#----#----#----#----#----#----#----#----#----#----#----#----#----#----#----#----#----#----#----
#---##---##---##---##---##---##---##---##---##---##---##---##---##---##---##---##---##---##---##---#
---##---##---##---##---##---##---##---##---##---##---##---##---##---##---##---##---##---##---##---##
----#----#----#----#----#----#----#----#----#----#----#----#----#----#----#----#----#----#----#----#
-#-#--#-#--#-#--#-#--#-#--#-#--#-#--#-#--#-#--#-#--#-#--#-#--#-#--#-#--#-#--#-#--#-#--#-#--#-#--#-#-
#----#----#----#----#----#----#----#----#----#----#----#----#----#----#----#----#----#----#----#----
#---##---##---##---##---##---##---##---##---##---##---##---##---##---##---##---##---##---##---##---#
---##---##---##---##---##---##---##---##---##---##---##---##---##---##---##---##---##---##---##---##
----#----#----#----#----#----#----#----#----#----#----#----#----#----#----#----#----#----#----#----#
-#-#--#-#--#-#--#-#--#-#--#-#--#-#--#-#--#-#--#-#--#-#--#-#--#-#--#-#--#-#--#-#--#-#--#-#--#-#--#-#-
#----#----#----#----#----#----#----#----#----#----#----#----#----#----#----#----#----#----#----#----
#---##---##---##---##---##---##---##---##---##---##---##---##---##---##---##---##---##---##---##---#
---##---##---##---##---##---##---##---##---##---##---##---##---##---##---##---##---##---##---##---##
----#----#----#----#----#----#----#----#----#----#----#----#----#----#----#----#----#----#----#----#
-#-#--#-#--#-#--#-#--#-#--#-#--#-#--#-#--#-#--#-#--#-#--#-#--#-#--#-#--#-#--#-#--#-#--#-#--#-#--#-#-
#----#----#----#----#----#----#----#----#----#----#----#----#----#----#----#----#----#----#----#----
#---##---##---##---##---##---##---##---##---##---##---##---##---##---##---##---##---##---##---##---#
---##---##---##---##---##---##---##---##---##---##---##---##---##---##---##---##---##---##---##---##
----#----#----#----#----#----#----#----#----#----#----#----#----#----#----#----#----#----#----#----#
-#-#--#-#--#-#--#-#--#-#--#-#--#-#--#-#--#-#--#-#--#-#--#-#--#-#--#-#--#-#--#-#--#-#--#-#--#-#--#-#-
#----#----#----#----#----#----#----#----#----#----#----#----#----#----#----#----#----#----#----#----
#---##---##---##---##---##---##---##---##---##---##---##---##---##---##---##---##---##---##---##---#
---##---##---##---##---##---##---##---##---##---##---##---##---##---##---##---##---##---##---##---##
----#----#----#----#----#----#----#----#----#----#----#----#----#----#----#----#----#----#----#----#
-#-#--#-#--#-#--#-#--#-#--#-#--#-#--#-#--#-#--#-#--#-#--#-#--#-#--#-#--#-#--#-#--#-#--#-#--#-#--#-#-
#----#----#----#----#----#----#----#----#----#----#----#----#----#----#----#----#----#----#----#----
#---##---##---##---##---##---##---##---##---##---##---##---##---##---##---##---##---##---##---##---#