?diagonal=IfAtMostOneObstacle;
#---##---##---##---##---##---##---##---##---##---##---##---##---##---##---##---##---##---##---##---#
--#----#----#----#----#----#----#----#----#----#----#----#----#----#----#----#----#----#----#----#--
-##---##---##---##---##---##---##---##---##---##---##---##---##---##---##---##---##---##---##---##--
--#-#--#-#--#-#--#-#--#-#--#-#--#-#--#-#--#-#--#-#--#-#--#-#--#-#--#-#--#-#--#-#--#-#--#-#--#-#--#-#
----#----#----#----#----#----#----#----#----#----#----#----#----#----#----#----#----#----#----#----#
#---##---##---##---##---##---##---##---##---##---##---##---##---##---##---##---##---##---##---##---#
--#----#----#----#----#----#----#----#----#----#----#----#----#----#----#----#----#----#----#----#--
-##---##---##---##---##---##---##---##---##---##---##---##---##---##---##---##---##---##---##---##--
--#-#--#-#--#-#--#-#--#-#--#-#--#-#--#-#--#-#--#-#--#-#--#-#--#-#--#-#--#-#--#-#--#-#--#-#--#-#--#-#
----#----#----#----#----#----#----#----#----#----#----#----#----#----#----#----#----#----#----#----#
#---##---##---##---##---##---##---##---##---##---##---##---##---##---##---##---##---##---##---##---#
--#----#----#----#----#----#----#----#----#----#----#----#----#----#----#----#----#----#----#----#--
-##---##---##---##---##---##---##---##---##---##---##---##---##---##---##---##---##---##---##---##--
--#-#--#-#--#-#--#-#--#-#--#-#--#-#--#-#--#-#--#-#--#-#--#-#--#-#--#-#--#-#--#-#--#-#--#-#--#-#--#-#
----#----#----#----#----#----#----#----#----#----#----#----#----#----#----#----#----#----#----#----#
#---##---##---##---##---##---##---##---##---##---##---##---##---##---##---##---##---##---##---##---#
--#----#----#----#----#----#----#----#----#----#----#----#----#----#----#----#----#----#----#----#--
-##---##---##---##---##---##---##---##---##---##---##---##---##---##---##---##---##---##---##---##--
--#-#--#-#--#-#--#-#--#-#--#-#--#-#--#-#--#-#--#-#--#-#--#-#--#-#--#-#--#-#--#-#--#-#--#-#--#-#--#-#
----#----#----#----#----#----#----#----#----#----#----#----#----#----#----#----#----#----#----#----#
#---##---##---##---##---##---##---##---##---##---##---##---##---##---##---##---##---##---##---##---#
--#----#----#----#----#----#----#----#----#----#----#----#----#----#----#----#----#----#----#----#--
-##---##---##---##---##---##---##---##---##---##---##---##---##---##---##---##---##---##---##---##--
--#-#--#-#--#-#--#-#--#-#--#-#--#-#--#-#--#-#--#-#--#-#--#-#--#-#--#-#--#-#--#-#--#-#--#-#--#-#--#-#
----#----#----#----#----#----#----#----#----#----#----#----#----#----#----#----#----#----#----#----#
#---##---##---##---##---##---##---##---##---##---##---##---##---##---##---##---##---##---##---##---#
--#----#----#----#----#----#----#----#----#----#----#----#----#----#----#----#----#----#----#----#--
-##---##---##---##---##---##---##---##---##---##---##---##---##---##---##---##---##---##---##---##--
--#-#--#-#--#-#--#-#--#-#--#-#--#-#--#-#--#-#--#-#--#-#--#-#--#-#--#-#--#-#--#-#--#-#--#-#--#-#--#-#
----#----#----#----#----#----#----#----#----#----#----#----#----#----#----#----#----#----#----#----#
#---##---##---##---##---##---##---##---##---##---##---##---##---##---##---##---##---##---##---##---#
--#----#----#----#----#----#----#----#----#----#----#----#----#----#----#----#----#----#----#----#--
-##---##---##---##---##---##---##---##---##---##---##---##---##---##---##---##---##---##---##---##--
--#-#--#-#--#-#--#-#--#-#--#-#--#-#--#-#--#-#--#-#--#-#--#-#--#-#--#-#--#-#--#-#--#-#--#-#--#-#--#-#
----#----#----#----#----#----#----#----#----#----#----#----#----#----#----#----#----#----#----#----#
#---##---##---##---##---##---##---##---##---##---##---##---##---##---##---##---##---##---##---##---#
--#----#----#----#----#----#----#----#----#----#----#----#----#----#----#----#----#----#----#----#--
-##---##---##---##---##---##---##---##---##---##---##---##---##---##---##---##---##---##---##---##--
--#-#--#-#--#-#--#-#--#-#--#-#--#-#--#-#--#-#--#-#--#-#--#-#--#-#--#-#--#-#--#-#--#-#--#-#--#-#--#-#
----#----#----#----#----#----#----#----#----#----#----#----#----#----#----#----#----#----#----#----#
#---##---##---##---##---##---##---##---##---##---##---##---##---##---##---##---##---##---##---##---#
--#----#----#----#----#----#----#----#----#----#----#----#----#----#----#----#----#----#----#----#--
-##---##---##---##---##---##---##---##---##---##---##---##---##---##---##---##---##---##---##---##--
--#-#--#-#--#-#--#-#--#-#--#-#--#-#--#-#--#-#--#-#--#-#--#-#--#-#--#-#--#-#--#-#--#-#--#-#--#-#--#-#
----#----#----#----#----#----#----#----#----#----#----#----#----#----#----#----#----#----#----#----#
#---##---##---##---##---##---##---##---##---##---##---##---##---##---##---##---##---##---##---##---#
--#----#----#----#----#----#----#----#----#----#----#----#----#----#----#----#----#----#----#----#--
-##---##---##---##---##---##---##---##---##---##---##---##---##---##---##---##---##---##---##---##--
--#-#--#-#--#-#--#-#--#-#--#-#--#-#--#-#--#-#--#-#--#-#--#-#--#-#--#-#--#-#--#-#--#-#--#-#--#-#--#-#
----#----#----#----#----#----#----#----#----#----#----#----#----#----#----#----#----#----#----#----#
#---##---##---##---##---##---##---##---##---##---##---##---##---##---##---##---##---##---##---##---#
--#----#----#----#----#----#----#----#----#----#----#----#----#----#----#----#----#----#----#----#--
-##---##---##---##---##---##---##---##---##---##---##---##---##---##---##---##---##---##---##---##--
--#-#--#-#--#-#--#-#--#-#--#-#--#-#--#-#--#-#--#-#--#-#--#-#--#-#--#-#--#-#--#-#--#-#--#-#--#-#--#-#
----#----#----#----#----#----#S---#----#----#----#----#----#----#----#----#----#----#----#----#----#
#---##---##---##---##---##---##---##---##---##---##---##---##---##---##---##---##---##---##---##---#
--#----#----#----#----#----#----#----#----#----#----#----#----#----#----#----#----#----#----#----#--
-##---##---##---##---##---##---##---##---##---##---##---##---##---##---##---##---##---##---##---##--
--#-#--#-#--#-#--#-#--#-#--#-#--#-#--#-#--#-#--#-#--#-#--#-#--#-#--#-#--#-#--#-#--#-#--#-#--#-#--#-#
----#----#----#----#----#----#----#----#----#----#----#----#----#----#----#----#----#----#----#----#
#---##---##---##---##---##---##---##---##---##---##---##---##---##---##---##---##---##---##---##---#
--#----#----#----#----#----#----#----#----#----#----#----#----#----#----#----#----#----#----#----#--
-##---##---##---##---##---##---##---##---##---##---##---##---##---##---##---##---##---##---##---##--
--#-#--#-#--#-#--#-#--#-#--#-#--#-#--#-#--#-#--#-#--#-#--#-#--#-#--#-#--#-#--#-#--#-#--#-#--#-#--#-#
----#----#----#----#----#----#----#----#----#----#----#----#----#----#----#----#----#----#----#----#
#---##---##---##---##---##---##---##---##---##---##---##---##---##---##---##---##---##---##---##---#
--#----#----#----#----#----#----#----#----#----#----#----#----#----#----#----#----#----#----#----#--
-##---##---##---##---##---##---##---##---##---##---##---##---##---##---##---##---##---##---##---##--
--#-#--#-#--#-#--#-#--#-#--#-#--#-#--#-#--#-#--#-#--#-#--#-#--#-#--#-#--#-#--#-#--#-#--#-#--#-#--#-#
----#----#----#----#----#----#----#----#----#----#----#----#----#----#----#----#----#----#----#----#
#---##---##---##---##---##---##---##---##---##---##---##---##---##---##---##---##---##---##---##---#
--#----#----#----#----#----#----#----#----#----#----#----#----#----#----#----#----#----#----#----#--
-##---##---##---##---##---##---##---##---##---##---##---##---##---##---##---##---##---##---##---##--
--#-#--#-#--#-#--#-#--#-#--#-#--#-#--#-#--#-#--#-#--#-#--#-#--#-#--#-#--#-#--#-#--#-#--#-#--#-#--#-#
----#----#----#----#----#----#----#----#----#----#----#----#----#----#----#----#----#----#----#----#
#---##---##---##---##---##---##---##---##---##---##---##---##---##---##---##---##---##---##---##---#
--#----#----#----#----#----#----#----#----#----#----#----#----#----#----#----#----#----#----#----#--
-##---##---##---##---##---##---##---##---##---##---##---##---##---##---##---##---##---##---##---##--
--#-#--#-#--#-#--#-#--#-#--#-#--#-#--#-#--#-#--#-#--#-#--#-#--#-#--#-#--#-#--#-#--#-#--#-#--#-#--#-#
----#----#----#----#----#----#----#----#----#----#----#----#----#----#----#----#----#----#----#----#
#---##---##---##---##---##---##---##---##---##---##---##---##---##---##---##---##---##---##---##---#
--#----#----#----#----#----#----#----#----#----#----#----#----#----#----#----#----#----#----#----#--
-##---##---##---##---##---##---##---##---##---##---##---##---##---##---##---##---##---##---##---##--
--#-#--#-#--#-#--#-#--#-#--#-#--#-#--#-#--#-#--#-#--#-#--#-#--#-#--#-#--#-#--#-#--#-#--#-#--#-#--#-#
----#----#----#----#----#----#----#----#----#----#----#----#----#----#----#----#----#----#----#----#
#---##---##---##---##---##---##---##---##---##---##---##---##---##---##---##---##---##---##---##---#
--#----#----#----#----#----#----#----#----#----#----#----#----#----#----#----#----#----#----#----#--
-##---##---##---##---##---##---##---##---##---##---##---##---##---##---##---##---##---##---##---##--
--#-#--#-#--#-#--#-#--#-#--#-#--#-#--#-#--#-#--#-#--#-#--#-#--#-#--#-#--#-#--#-#--#-#--#-#--#-#--#-#
----#----#----#----#----#----#----#----#----#----#----#----#----#----#----#----#----#----#----#----#
#---##---##---##---##---##---##---##---##---##---##---##---##---##---##---##---##---##---##---##---#
--#----#----#----#----#----#----#----#----#----#----#----#----#----#----#----#----#----#----#----#--
-##---##---##---##---##---##---##---##---##---##---##---##---##---##---##---##---##---##---##---##--
--#-#--#-#--#-#--#-#--#-#--#-#--#-#--#-#--#-#--#-#--#-#--#-#--#-#--#-#--#-#--#-#--#-#--#-#--#-#--#-#
---E#----#----#----#----#----#----#----#----#----#----#----#----#----#----#----#----#----#----#----#
#---##---##---##---##---##---##---##---##---##---##---##---##---##---##---##---##---##---##---##---#
--#----#----#----#----#----#----#----#----#----#----#----#----#----#----#----#----#----#----#----#--
-##---##---##---##---##---##---##---##---##---##---##---##---##---##---##---##---##---##---##---##--
--#-#--#-#--#-#--#-#--#-#--#-#--#-#--#-#--#-#--#-#--#-#--#-#--#-#--#-#--#-#--#-#--#-#--#-#--#-#--#-#
----#----#----#----#----#----#----#----#----#----#----#----#----#----#----#----#----#----#----#----#