?diagonal=IfAtMostOneObstacle;
-#----#----#----#----#----#----#----#----#----#----#----#----#----#----#----#----#----#----#----#---
-#-#--#-#--#-#--#-#--#-#--#-#--#-#--#-#--#-#--#-#--#-#--#-#--#-#--#-#--#-#--#-#--#-#--#-#--#-#--#-#-
----------------------------------------------------------------------------------------------------
#--###--###--###--###--###--###--###--###--###--###--###--###--###--###--###--###--###--###--###--##
--#----#----#----#----#----#----#----#----#----#----#----#----#----#----#----#----#----#----#----#--
-#----#----#----#----#----#----#----#----#----#----#----#----#----#----#----#----#----#----#----#---
-#-#--#-#--#-#--#-#--#-#--#-#--#-#--#-#--#-#--#-#--#-#--#-#--#-#--#-#--#-#--#-#--#-#--#-#--#-#--#-#-
----------------------------------------------------------------------------------------------------
#--###--###--###--###--###--###--###--###--###--###--###--###--###--###--###--###--###--###--###--##
--#----#----#----#----#----#----#----#----#----#----#----#----#----#----#----#----#----#----#----#--
-#----#----#----#----#----#----#----#----#----#----#----#----#----#----#----#----#----#----#----#---
-#-#--#-#--#-#--#-#--#-#--#-#--#-#--#-#--#-#--#-#--#-#--#-#--#-#--#-#--#-#--#-#--#-#--#-#--#-#--#-#-
----------------------------------------------------------------------------------------------------
#--###--###--###--###--###--###--###--###--###--###--###--###--###--###--###--###--###--###--###--##
--#----#----#----#----#----#----#----#----#----#---E#----#----#----#----#----#----#----#----#----#--
-#----#----#----#----#----#----#----#----#----#----#----#----#----#----#----#----#----#----#----#---
-#-#--#-#--#-#--#-#--#-#--#-#--#-#--#-#--#-#--#-#--#-#--#-#--#-#--#-#--#-#--#-#--#-#--#-#--#-#--#-#-
----------------------------------------------------------------------------------------------------
#--###--###--###--###--###--###--###--###--###--###--###--###--###--###--###--###--###--###--###--##
--#----#----#----#----#----#----#----#----#----#----#----#----#----#----#----#----#----#----#----#--
-#----#----#----#----#----#----#----#----#----#----#----#----#----#----#----#----#----#----#----#---
-#-#--#-#--#-#--#-#--#-#--#-#--#-#--#-#--#-#--#-#--#-#--#-#--#-#--#-#--#-#--#-#--#-#--#-#--#-#--#-#-
----------------------------------------------------------------------------------------------------
#--###--###--###--###--###--###--###--###--###--###--###--###--###--###--###--###--###--###--###--##
--#----#----#----#----#----#----#----#----#----#----#----#----#----#----#----#----#----#----#----#--
-#----#----#----#----#----#----#----#----#----#----#----#----#----#----#----#----#----#----#----#---
-#-#--#-#--#-#--#-#--#-#--#-#--#-#--#-#--#-#--#-#--#-#--#-#--#-#--#-#--#-#--#-#--#-#--#-#--#-#--#-#-
----------------------------------------------------------------------------------------------------
#--###--###--###--###--###--###--###--###--###--###--###--###--###--###--###--###--###--###--###--##
--#----#----#----#----#----#----#----#----#----#----#----#----#----#----#----#----#----#----#----#--
-#----#----#----#----#----#----#----#----#----#----#----#----#----#----#----#----#----#----#----#---
-#-#--#-#--#-#--#-#--#-#--#-#--#-#--#-#--#-#--#-#--#-#--#-#--#-#--#-#--#-#--#-#--#-#--#-#--#-#--#-#-
----------------------------------------------------------------------------------------------------
#--###--###--###--###--###--###--###--###--###--###--###--###--###--###--###--###--###--###--###--##
--#----#----#----#----#----#----#----#----#----#----#----#----#----#----#----#----#----#----#----#--
-#----#----#----#----#----#----#----#----#----#----#----#----#----#----#----#----#----#----#----#---
-#-#--#-#--#-#--#-#--#-#--#-#--#-#--#-#--#-#--#-#--#-#--#-#--#-#--#-#--#-#--#-#--#-#--#-#--#-#--#-#-
----------------------------------------------------------------------------------------------------
#--###--###--###--###--###--###--###--###--###--###--###--###--###--###--###--###--###--###--###--##
--#----#----#----#----#----#----#----#----#----#----#----#----#----#----#----#----#----#----#----#--
-#----#----#----#----#----#----#----#----#----#----#----#----#----#----#----#----#----#----#----#---
-#-#--#-#--#-#--#-#--#-#--#-#--#-#--#-#--#-#--#-#--#-#--#-#--#-#--#-#--#-#--#-#--#-#--#-#--#-#--#-#-
----------------------------------------------------------------------------------------------------
#--###--###--###--###--###--###--###--###--###--###--###--###--###--###--###--###--###--###--###--##
--#----#----#----#----#----#----#----#----#----#----#----#----#----#----#----#----#----#----#----#--
-#----#----#----#----#----#----#----#----#----#----#----#----#----#----#----#----#----#----#----#---
-#-#--#-#--#-#--#-#--#-#--#-#--#-#--#-#--#-#--#-#--#-#--#-#--#-#--#-#--#-#--#-#--#-#--#-#--#-#--#-#-
----------------------------------------------------------------------------------------------------
#--###--###--###--###--###--###--###--###--###--###--###--###--###--###--###--###--###--###--###--##
--#----#----#----#----#----#----#----#----#----#----#----#----#----#----#----#----#----#----#----#--
-#----#----#----#----#----#----#----#----#----#----#----#----#----#----#----#----#----#----#----#---
-#-#--#-#--#-#--#-#--#-#--#-#--#-#--#-#--#-#--#-#--#-#--#-#--#-#--#-#--#-#--#-#--#-#--#-#--#-#--#-#-
----------------------------------------------------------------------------------------------------
#--###--###--###--###--###--###--###--###--###--###--###--###--###--###--###--###--###--###--###--##
--#----#----#----#----#----#----#----#----#----#----#----#----#----#----#----#----#----#----#----#--
-#----#----#----#----#----#----#----#----#----#----#----#----#----#----#----#----#----#----#----#---
-#-#--#-#--#-#--#-#--#-#--#-#--#-#--#-#--#-#--#-#--#-#--#-#--#-#--#-#--#-#--#-#--#-#--#-#--#-#--#-#-
----------------------------------------------------------------------------------------------------
#--###--###--###--###--###--###--###--###--###--###--###--###--###--###--###--###--###--###--###--##
--#----#----#----#----#----#----#----#----#----#----#----#----#----#----#----#----#----#----#----#--
-#----#----#----#----#----#----#----#----#----#----#----#----#----#----#----#----#----#----#----#---
-#-#--#-#--#-#--#-#--#-#--#-#--#-#--#-#--#-#--#-#--#-#--#-#--#-#--#-#--#-#--#-#--#-#--#-#--#-#--#-#-
------------------S---------------------------------------------------------------------------------
#--###--###--###--###--###--###--###--###--###--###--###--###--###--###--###--###--###--###--###--##
--#----#----#----#----#----#----#----#----#----#----#----#----#----#----#----#----#----#----#----#--
-#----#----#----#----#----#----#----#----#----#----#----#----#----#----#----#----#----#----#----#---
-#-#--#-#--#-#--#-#--#-#--#-#--#-#--#-#--#-#--#-#--#-#--#-#--#-#--#-#--#-#--#-#--#-#--#-#--#-#--#-#-
----------------------------------------------------------------------------------------------------
#--###--###--###--###--###--###--###--###--###--###--###--###--###--###--###--###--###--###--###--##
--#----#----#----#----#----#----#----#----#----#----#----#----#----#----#----#----#----#----#----#--
-#----#----#----#----#----#----#----#----#----#----#----#----#----#----#----#----#----#----#----#---
-#-#--#-#--#-#--#-#--#-#--#-#--#-#--#-#--#-#--#-#--#-#--#-#--#-#--#-#--#-#--#-#--#-#--#-#--#-#--#-#-
----------------------------------------------------------------------------------------------------
#--###--###--###--###--###--###--###--###--###--###--###--###--###--###--###--###--###--###--###--##
--#----#----#----#----#----#----#----#----#----#----#----#----#----#----#----#----#----#----#----#--
-#----#----#----#----#----#----#----#----#----#----#----#----#----#----#----#----#----#----#----#---
-#-#--#-#--#-#--#-#--#-#--#-#--#-#--#-#--#-#--#-#--#-#--#-#--#-#--#-#--#-#--#-#--#-#--#-#--#-#--#-#-
----------------------------------------------------------------------------------------------------
#--###--###--###--###--###--###--###--###--###--###--###--###--###--###--###--###--###--###--###--##
--#----#----#----#----#----#----#----#----#----#----#----#----#----#----#----#----#----#----#----#--
-#----#----#----#----#----#----#----#----#----#----#----#----#----#----#----#----#----#----#----#---
-#-#--#-#--#-#--#-#--#-#--#-#--#-#--#-#--#-#--#-#--#-#--#-#--#-#--#-#--#-#--#-#--#-#--#-#--#-#--#-#-
----------------------------------------------------------------------------------------------------
#--###--###--###--###--###--###--###--###--###--###--###--###--###--###--###--###--###--###--###--##
--#----#----#----#----#----#----#----#----#----#----#----#----#----#----#----#----#----#----#----#--
-#----#----#----#----#----#----#----#----#----#----#----#----#----#----#----#----#----#----#----#---
-#-#--#-#--#-#--#-#--#-#--#-#--#-#--#-#--#-#--#-#--#-#--#-#--#-#--#-#--#-#--#-#--#-#--#-#--#-#--#-#-
----------------------------------------------------------------------------------------------------
#--###--###--###--###--###--###--###--###--###--###--###--###--###--###--###--###--###--###--###--##
--#----#----#----#----#----#----#----#----#----#----#----#----#----#----#----#----#----#----#----#--
-#----#----#----#----#----#----#----#----#----#----#----#----#----#----#----#----#----#----#----#---
-#-#--#-#--#-#--#-#--#-#--#-#--#-#--#-#--#-#--#-#--#-#--#-#--#-#--#-#--#-#--#-#--#-#--#-#--#-#--#-#-
----------------------------------------------------------------------------------------------------
#--###--###--###--###--###--###--###--###--###--###--###--###--###--###--###--###--###--###--###--##
--#----#----#----#----#----#----#----#----#----#----#----#----#----#----#----#----#----#----#----#--
-#----#----#----#----#----#----#----#----#----#----#----#----#----#----#----#----#----#----#----#---
-#-#--#-#--#-#--#-#--#-#--#-#--#-#--#-#--#-#--#-#--#-#--#-#--#-#--#-#--#-#--#-#--#-#--#-#--#-#--#-#-
----------------------------------------------------------------------------------------------------
#--###--###--###--###--###--###--###--###--###--###--###--###--###--###--###--###--###--###--###--##
--#----#----#----#----#----#----#----#----#----#----#----#----#----#----#----#----#----#----#----#--