?diagonal=IfAtMostOneObstacle;
#-#--#-#--#-#--#-#--#-#--#-#--#-#--#-#--#-#--#-#--#-#--#-#--#-#--#-#--#-#--#-#--#-#--#-#--#-#--#-#--
----#----#----#----#----#----#----#----#----#----#----#----#----#----#----#----#----#----#----#----#
----------------------------------------------------------------------------------------------------
#---##---##---##---##---##---##---##---##---##---##---##---##---##---##---##---##---##---##---##---#
##---##---##---##---##---##---##---##---##---##---##---##---##---##---##---##---##---##---##---##---
#-#--#-#--#-#--#-#--#-#--#-#--#-#--#-#--#-#--#-#--#-#--#-#--#-#--#-#--#-#--#-#--#-#--#-#--#-#--#-#--
----#----#----#----#----#----#----#----#----#----#----#----#----#----#----#----#----#----#----#----#
----------------------------------------------------------------------------------------------------
#---##---##---##---##---##---##---##---##---##---##---##---##---##---##---##---##---##---##---##---#
##---##---##---##---##---##---##---##---##---##---##---##---##---##---##---##---##---##---##---##---
#-#--#-#--#-#--#-#--#-#--#-#--#-#--#-#--#-#--#-#--#-#--#-#--#-#--#-#--#-#--#-#--#-#--#-#--#-#--#-#--
----#----#----#----#----#----#----#----#----#----#----#----#----#----#----#----#----#----#----#----#
----------------------------------------------------------------------------------------------------
#---##---##---##---##---##---##---##---##---##---##---##---##---##---##---##---##---##---##---##---#
##---##---##---##---##---##---##---##---##---##---##---##---##---##---##---##---##---##---##---##---
#-#--#-#--#-#--#-#--#-#--#-#--#-#--#-#--#-#--#-#--#-#--#-#--#-#--#-#--#-#--#-#--#-#--#-#--#-#--#-#--
----#----#----#----#----#----#----#----#----#----#----#----#----#----#----#----#----#----#----#----#
----------------------------------------------------------------------------------------------------
#---##---##---##---##---##---##---##---##---##---##---##---##---##---##---##---##---##---##---##---#
##---##---##---##---##---##---##---##---##---##---##---##---##---##---##---##---##---##---##---##---
#-#--#-#--#-#--#-#--#-#--#-#--#-#--#-#--#-#--#-#--#-#--#-#--#-#--#-#--#-#--#-#--#-#--#-#--#-#--#-#--
----#----#----#----#----#----#----#----#----#----#----#----#----#----#----#----#----#----#----#----#
----------------------------------------------------------------------------------------------------
#---##---##---##---##---##---##---##---##---##---##---##---##---##---##---##---##---##---##---##---#
##---##---##---##---##---##---##---##---##---##---##---##---##---##---##---##---##---##---##---##---
#-#--#-#--#-#--#-#--#-#--#-#--#-#--#-#--#-#--#-#--#-#--#-#--#-#--#-#--#-#--#-#--#-#--#-#--#-#--#-#--
----#----#----#----#----#----#----#----#----#----#----#----#----#----#----#----#----#----#----#----#
----------------------------------------------------------------------------------------------------
#---##---##---##---##---##---##---##---##---##---##---##---##---##---##---##---##---##---##---##---#
##---##---##---##---##---##---##---##---##---##---##---##---##---##---##---##---##---##---##---##---
#-#--#-#--#-#--#-#--#-#--#-#--#-#--#-#--#-#--#-#--#-#--#-#--#-#--#-#--#-#--#-#--#-#--#-#--#-#--#-#--
----#----#----#----#----#----#----#----#----#----#----#----#----#----#----#----#----#----#----#----#
----------------------------------------------------------------------------------------------------
#---##---##---##---##---##---##---##---##---##---##---##---##---##---##---##---##---##---##---##---#
##---##---##---##---##---##---##---##---##---##---##---##---##---##---##---##---##---##---##---##---
#-#--#-#--#-#--#-#--#-#--#-#--#-#--#-#--#-#--#-#--#-#--#-#--#-#--#-#--#-#--#-#--#-#--#-#--#-#--#-#--
----#----#----#----#----#----#----#----#----#----#----#----#----#----#----#----#----#----#----#----#
----------------------------------------------------------------------------------------------------
#---##---##---##---##---##---##---##---##---##---##---##---##---##---##---##---##---##---##---##---#
##---##---##---##---##---##---##---##---##---##---##---##---##---##---##---##---##---##---##---##---
#-#--#-#--#-#--#-#--#-#--#-#--#-#--#-#--#-#--#-#--#-#--#-#--#-#--#-#--#-#--#-#--#-#--#-#--#-#--#-#--
----#----#----#----#----#----#----#----#----#----#----#----#----#----#----#----#----#----#----#----#
----------------------------------------------------------------------------------------------------
#---##---##---##---##---##---##---##---##---##---##---##---##---##---##---##---##---##---##---##---#
##---##---##---##---##---##---##---##---##---##---##---##---##---##---##---##---##---##---##---##---
#-#--#-#--#-#--#-#--#-#--#-#--#-#--#-#--#-#--#-#--#-#--#-#--#-#--#-#--#-#--#-#--#-#--#-#--#-#--#-#--
----#----#----#----#----#----#----#----#----#----#----#----#----#----#----#----#----#----#----#----#
----------------------------------------------------------------------------------------------------
#---##---##---##---##---##---##---##---##---##---##---##---##---##---##---##---##---##---##---##---#
##---##---##---##---##---##---##---##---##---##---##---##---##---##---##---##---##---##---##---##---
#-#--#-#--#-#--#-#--#-#--#-#--#-#--#-#--#-#--#-#--#-#--#-#--#-#--#-#--#-#--#-#--#-#--#-#--#-#--#-#--
----#----#----#----#----#----#----#----#----#----#----#----#----#----#----#----#----#----#----#----#
----------------------------------------------------------------------------------------------------
#---##---##---##---##---##---##---##---##---##---##---##---##---##---##---##---##---##---##---##---#
##---##---##---##---##---##---##---##---##---##---##---##---##---##---##---##---##---##---##---##---
#-#--#-#--#-#--#-#--#-#--#-#--#-#--#-#--#-#--#-#--#-#--#-#--#-#--#-#--#-#--#-#--#-#--#-#--#-#--#-#--
----#----#----#----#----#----#----#----#----#----#----#----#----#----#----#----#----#----#----#----#
----------------------------------------------------------------------------------------------------
#---##---##---##---##---##---##---##---##---##---##---##---##---##---##---##---##---##---##---##---#
##---##---##---##---##---##---##---##---##---##---##---##---##---##---##---##---##---##---##---##---
#-#--#-#--#-#--#-#--#-#--#-#--#-#--#-#--#-#--#-#--#-#--#-#--#-#--#-#--#-#--#-#--#-#--#-#--#-#--#-#--
----#----#----#----#----#----#----#----#----#----#----#----#----#----#----#----#----#----#----#----#
----------------------------------------------------------------------------------------------------
#---##---##---##---##---##---##---##---##---##---##---##---##---##---##---##---##---##---##---##---#
##---##---##---##---##---##---##---##---##---##---##---##---##---##---##---##---##---##---##---##---
#-#--#-#--#-#--#-#--#-#--#-#--#-#--#-#--#-#--#-#--#-#--#-#--#-#--#-#--#-#--#-#--#-#--#-#--#-#--#-#--
----#----#----#----#----#----#----#----#----#----#----#----#----#----#----#----#----#----#----#----#
----------------------------------------------------------------------------------------------------
#---##---##---##---##---##---##---##---##---##---##---##---##---##---##---##---##---##---##---##---#
##---##---##---##---##---##---##---##---##---##---##---##---##---##---##---##---##---##---##---##---
#-#--#-#--#-#--#-#--#-#--#-#--#-#--#-#--#-#--#-#--#-#--#-#--#-#--#-#--#-#--#-#--#-#--#-#--#-#--#-#--
----#----#----#----#----#----#----#----#----#----#----#----#----#----#----#----#----#----#----#----#
----------------------------------------------------------------------------------------------------
#---##---##---##---##---##---##---##---##---##---##---##---##---##---##---##---##---##---##---##---#
##---##---##---##---##---##---##---##---##---##---##---##---##---##---##---##---##---##---##---##---
#-#--#-#--#-#--#-#--#-#--#-#--#-#--#-#--#-#--#-#--#-#--#-#--#-#--#-#--#-#--#-#--#-#--#-#--#-#--#-#--
----#----#----#----#----#----#----#----#----#----#----#----#----#----#----#----#----#----#----#----#
----------------------------------------------------------------------------------------------------
#---##---##---##---##---##---##---##---##---##---##---##---##---##---##---##---##---##---##---##---#
##---##---##---##---##---##---##---##---##---##---##---##---##---##---##---##---##---##---##---##---
#-#--#-#--#-#--#-#--#-#--#-#--#-#--#-#--#-#--#-#--#-#--#-#--#-#--#-#--#-#--#-#--#-#--#-#--#-#--#-#--
----#----#----#----#----#----#----#----#----#----#----#----#----#----#----#----#----#----#----#----#
----------------------------------------------------------------------------------------------------
#---##---##---##---##---##---##---##---##---##---##---##---##---##---##---##---##---##---##---##---#
##---##---##---##---##---##---##---##---##---##---##---##---##---##---##---##---##---##---##---##---
#-#--#-#--#-#--#-#--#-#--#-#--#-#--#-#--#-#--#-#--#-#--#-#--#-#--#-#--#-#--#-#--#-#--#-#--#-#--#-#--
----#----#----#----#----#----#----#----#----#----#----#----#----#----#----#----#----#----#----#----#
--E-------------------------------------------------------------------------------------------------
#---##---##---##---##---##---##---##---##---##---##---##---##---##---##---##---##---##---##---##---#
##---##---##---##---##---##---##---##---##---##---##---##---##---##---##---##---##---##---##---##---
#-#--#-#--#-#--#-#--#-#--#-#--#-#--#-#--#-#--#-#--#-#--#-#--#-#--#-#--#-#--#-#--#-#--#-#--#-#--#-#--
----#----#----#----#----#----#----#----#----#----#----#----#----#----#----#----#----#----#----#----#
----------------------------------------------------------------------------------------------------
#---##---##---##---##---##---##---##---##---##---##---##--S##---##---##---##---##---##---##---##---#
##---##---##---##---##---##---##---##---##---##---##---##---##---##---##---##---##---##---##---##---
#-#--#-#--#-#--#-#--#-#--#-#--#-#--#-#--#-#--#-#--#-#--#-#--#-#--#-#--#-#--#-#--#-#--#-#--#-#--#-#--
----#----#----#----#----#----#----#----#----#----#----#----#----#----#----#----#----#----#----#----#
----------------------------------------------------------------------------------------------------
#---##---##---##---##---##---##---##---##---##---##---##---##---##---##---##---##---##---##---##---#
##---##---##---##---##---##---##---##---##---##---##---##---##---##---##---##---##---##---##---##---