?diagonal=IfAtMostOneObstacle;
#--#-#--#-#--#-#--#-#--#-#--#-#--#-#--#-#--#-#--#-#--#-#--#-#--#-#--#-#--#-#--#-#--#-#--#-#--#-#--#-
---##---##---##---##---##---##---##---##---##---##---##---##---##---##---##---##---##---##---##---##
-##---##---##---##---##---##---##---##---##---##---##---##---##---##---##---##---##---##---##---##--
----#----#----#----#----#----#----#----#----#----#----#----#----#----#----#----#----#----#----#----#
----#----#----#----#----#----#----#----#----#----#----#----#----#----#----#----#----#----#----#----#
#--#-#--#-#--#-#--#-#--#-#--#-#--#-#--#-#--#-#--#-#--#-#--#-#--#-#--#-#--#-#--#-#--#-#--#-#--#-#--#-
---##---##---##---##---##---##---##---##---##---##---##---##---##---##---##---##---##---##---##---##
-##---##---##---##---##---##---##---##---##---##---##---##---##---##---##---##---##---##---##---##--
----#----#----#----#----#----#----#----#----#----#----#----#----#----#----#----#----#----#----#----#
----#----#----#----#----#----#----#----#----#----#----#----#----#----#----#----#----#----#----#----#
#--#-#--#-#--#-#--#-#--#-#--#-#--#-#--#-#--#-#--#-#--#-#--#-#--#-#--#-#--#-#--#-#--#-#--#-#--#-#--#-
---##---##---##---##---##---##---##---##---##---##---##---##---##---##---##---##---##---##---##---##
-##---##---##---##---##---##---##---##---##---##---##---##---##---##---##---##---##---##---##---##--
----#----#----#----#----#----#----#----#----#----#----#----#----#----#----#----#----#----#----#----#
----#----#----#----#----#----#----#----#----#----#----#----#----#----#----#----#----#----#----#----#
#--#-#--#-#--#-#--#-#--#-#--#-#--#-#--#-#--#-#--#-#--#-#--#-#--#-#--#-#--#-#--#-#--#-#--#-#--#-#--#-
---##---##---##---##---##---##---##---##---##---##---##---##---##---##---##---##---##---##---##---##
-##---##---##---##---##---##---##---##---##---##---##---##---##---##---##---##---##---##---##---##--
----#----#----#----#----#----#----#----#----#----#----#----#----#----#----#----#----#----#----#----#
----#----#----#----#----#----#----#----#----#----#----#----#----#----#----#----#----#----#----#----#
#--#-#--#-#--#-#--#-#--#-#--#-#--#-#--#-#--#-#--#-#--#-#--#-#--#-#--#-#--#-#--#-#--#-#--#-#--#-#--#-
---##---##---##---##---##---##---##---##---##---##---##---##---##---##---##---##---##---##---##---##
-##---##---##---##---##---##---##---##---##---##---##---##---##---##---##---##---##---##---##---##--
----#----#----#----#----#----#----#----#----#----#----#----#----#----#----#----#----#----#----#----#
----#----#----#----#----#----#----#----#----#----#----#----#----#----#----#----#----#----#----#----#
#--#-#--#-#--#-#--#-#--#-#--#-#--#-#--#-#--#-#--#-#--#-#--#-#--#-#--#-#--#-#--#-#--#-#--#-#--#-#--#-
---##---##---##---##---##---##---##---##---##---##---##---##---##---##---##---##---##---##---##---##
-##---##---##---##---##---##---##---##---##---##---##---##---##---##---##---##---##---##---##---##--
----#----#----#----#----#----#----#----#----#----#----#----#----#----#----#----#----#----#----#----#
----#----#----#----#----#----#----#----#----#----#----#----#----#----#----#----#----#----#----#----#
#--#-#--#-#--#-#--#-#--#-#--#-#--#-#--#-#--#-#--#-#--#-#--#-#--#-#--#-#--#-#--#-#--#-#--#-#--#-#--#-
---##---##---##---##---##---##---##---##---##---##---##---##---##---##---##---##---##---##---##---##
-##---##---##---##---##---##---##---##---##---##---##---##---##---##---##---##---##---##---##---##--
----#----#----#----#----#----#----#----#----#----#----#----#----#----#----#----#----#----#----#----#
----#----#----#----#----#----#----#----#----#----#----#----#----#----#----#----#----#----#----#----#
#--#-#--#-#--#-#--#-#--#-#--#-#--#-#--#-#--#-#--#-#--#-#--#-#--#-#--#-#--#-#--#-#--#-#--#-#--#-#--#-
---##---##---##---##---##---##---##---##---##---##---##---##---##---##---##---##---##---##---##---##
-##---##---##---##---##---##---##---##---##---##---##---##---##---##---##---##---##---##---##---##--
----#----#----#----#----#----#----#----#----#----#----#----#----#----#----#----#----#----#----#----#
----#----#----#----#----#----#----#----#----#----#----#----#----#----#----#----#----#----#----#----#
#--#-#--#-#--#-#--#-#--#-#--#-#--#-#--#-#--#-#--#-#--#-#--#-#--#-#--#-#--#-#--#-#--#-#--#-#--#-#--#-
---##---##---##---##---##---##---##---##---##---##---##---##---##---##---##---##---##---##---##---##
-##---##---##---##---##---##---##---##---##---##---##---##---##---##---##---##---##---##---##---##--
----#----#----#----#----#----#----#----#----#----#----#----#----#----#----#----#----#----#----#----#
----#----#----#----#----#----#----#----#----#----#----#----#----#----#----#----#----#----#----#----#
#--#-#--#-#--#-#--#-#--#-#--#-#--#-#--#-#--#-#--#-#--#-#--#-#--#-#--#-#--#-#--#-#--#-#--#-#--#-#--#-
---##---##---##---##---##---##---##---##---##---##---##---##---##---##---##---##---##---##---##---##
-##---##---##---##---##---##---##---##---##---##---##---##---##---##---##---##---##---##---##---##--
----#----#----#----#----#----#----#----#----#----#----#----#----#----#----#----#----#----#----#----#
--S-#----#----#----#----#----#----#----#----#----#----#----#----#----#----#----#----#----#----#----#
#--#-#--#-#--#-#--#-#--#-#--#-#--#-#--#-#--#-#--#-#--#-#--#-#--#-#--#-#--#-#--#-#--#-#--#-#--#-#--#-
---##---##---##---##---##---##---##---##---##---##---##---##---##---##---##---##---##---##---##---##
-##---##---##---##---##---##---##---##---##---##---##---##---##---##---##---##---##---##---##---##--
----#----#----#----#----#----#----#----#----#----#----#----#----#----#----#----#----#----#----#----#
----#----#----#----#----#----#----#----#----#----#----#----#----#----#----#----#----#----#----#----#
#--#-#--#-#--#-#--#-#--#-#--#-#--#-#--#-#--#-#--#-#--#-#--#-#--#-#--#-#--#-#--#-#--#-#--#-#--#-#--#-
---##---##---##---##---##---##---##---##---##---##---##---##---##---##---##---##---##---##---##---##
-##---##---##---##---##---##---##---##---##---##---##---##---##---##---##---##---##---##---##---##--
----#----#----#----#----#----#----#----#----#----#----#----#----#----#----#----#----#----#----#----#
----#----#----#----#----#----#----#----#----#----#----#----#----#----#----#----#----#----#----#----#
#--#-#--#-#--#-#--#-#--#-#--#-#--#-#--#-#--#-#--#-#--#-#--#-#--#-#--#-#--#-#--#-#--#-#--#-#--#-#--#-
---##---##---##---##---##---##---##---##---##---##---##---##---##---##---##---##---##---##---##---##
-##---##---##---##---##---##---##---##---##---##---##---##---##---##---##---##---##---##---##---##--
----#----#----#----#----#----#----#----#----#----#----#----#----#----#----#----#----#----#----#----#
----#----#----#----#----#----#----#----#----#----#----#----#----#----#----#----#----#----#----#----#
#--#-#--#-#--#-#--#-#--#-#--#-#--#-#--#-#--#-#--#-#--#-#--#-#--#-#--#-#--#-#--#-#--#-#--#-#--#-#--#-
---##---##---##---##---##---##---##---##---##---##---##---##---##---##---##---##---##---##---##---##
-##---##---##---##---##---##---##---##---##---##---##---##---##---##---##---##---##---##---##---##--
----#----#----#----#----#----#----#----#----#----#----#----#----#----#----#----#----#----#----#----#
----#----#----#----#----#----#----#----#----#----#----#----#----#----#----#----#----#----#----#----#
#--#-#--#-#--#-#--#-#--#-#--#-#--#-#--#-#--#-#--#-#--#-#--#-#--#-#--#-#--#-#--#-#--#-#--#-#--#-#--#-
---##---##---##---##---##---##---##---##---##---##---##---##---##---##---##---##---##---##---##---##
-##---##---##---##---##---##---##---##---##---##---##---##---##---##---##---##---##---##---##---##--
----#----#----#----#----#----#----#----#----#----#----#----#----#----#----#----#----#----#----#----#
----#----#----#----#----#----#----#----#----#----#----#----#----#----#----#----#----#----#----#----#
#--#-#--#-#--#-#--#-#--#-#--#-#--#-#--#-#--#-#--#-#--#-#--#-#--#-#--#-#--#-#--#-#--#-#--#-#--#-#--#-
---##---##---##---##---##---##---##---##---##---##---##---##---##---##---##---##---##---##---##---##
-##---##---##---##---##---##---##---##---##---##---##---##---##---##---##---##---##--E##---##---##--
----#----#----#----#----#----#----#----#----#----#----#----#----#----#----#----#----#----#----#----#
----#----#----#----#----#----#----#----#----#----#----#----#----#----#----#----#----#----#----#----#
#--#-#--#-#--#-#--#-#--#-#--#-#--#-#--#-#--#-#--#-#--#-#--#-#--#-#--#-#--#-#--#-#--#-#--#-#--#-#--#-
---##---##---##---##---##---##---##---##---##---##---##---##---##---##---##---##---##---##---##---##
-##---##---##---##---##---##---##---##---##---##---##---##---##---##---##---##---##---##---##---##--
----#----#----#----#----#----#----#----#----#----#----#----#----#----#----#----#----#----#----#----#
----#----#----#----#----#----#----#----#----#----#----#----#----#----#----#----#----#----#----#----#
#--#-#--#-#--#-#--#-#--#-#--#-#--#-#--#-#--#-#--#-#--#-#--#-#--#-#--#-#--#-#--#-#--#-#--#-#--#-#--#-
---##---##---##---##---##---##---##---##---##---##---##---##---##---##---##---##---##---##---##---##
-##---##---##---##---##---##---##---##---##---##---##---##---##---##---##---##---##---##---##---##--
----#----#----#----#----#----#----#----#----#----#----#----#----#----#----#----#----#----#----#----#
----#----#----#----#----#----#----#----#----#----#----#----#----#----#----#----#----#----#----#----#
#--#-#--#-#--#-#--#-#--#-#--#-#--#-#--#-#--#-#--#-#--#-#--#-#--#-#--#-#--#-#--#-#--#-#--#-#--#-#--#-
---##---##---##---##---##---##---##---##---##---##---##---##---##---##---##---##---##---##---##---##
-##---##---##---##---##---##---##---##---##---##---##---##---##---##---##---##---##---##---##---##--
----#----#----#----#----#----#----#----#----#----#----#----#----#----#----#----#----#----#----#----#
----#----#----#----#----#----#----#----#----#----#----#----#----#----#----#----#----#----#----#----#
#--#-#--#-#--#-#--#-#--#-#--#-#--#-#--#-#--#-#--#-#--#-#--#-#--#-#--#-#--#-#--#-#--#-#--#-#--#-#--#-
---##---##---##---##---##---##---##---##---##---##---##---##---##---##---##---##---##---##---##---##
-##---##---##---##---##---##---##---##---##---##---##---##---##---##---##---##---##---##---##---##--
----#----#----#----#----#----#----#----#----#----#----#----#----#----#----#----#----#----#----#----#
----#----#----#----#----#----#----#----#----#----#----#----#----#----#----#----#----#----#----#----#