?diagonal=IfAtMostOneObstacle;
-###--###--###--###--###--###--###--###--###--###--###--###--###--###--###--###--###--###--###--###-
---#----#----#----#----#----#----#----#----#----#----#----#----#----#----#----#----#----#----#----#-
-#-#--#-#--#-#--#-#--#-#--#-#--#-#--#-#--#-#--#-#--#-#--#-#--#-#--#-#--#-#--#-#--#-#--#-#--#-#--#-#-
--#-#--#-#--#-#--#-#--#-#--#-#--#-#--#-#--#-#--#-#--#-#--#-#--#-#--#-#--#-#--#-#--#-#--#-#--#-#--#-#
----------------------------------------------------------------------------------------------------
-###--###--###--###--###--###--###--###--###--###--###--###--###--###--###--###--###--###--###--###-
---#----#----#----#----#----#----#----#----#----#----#----#----#----#----#----#----#----#----#----#-
-#-#--#-#--#-#--#-#--#-#--#-#--#-#--#-#--#-#--#-#--#-#--#-#--#-#--#-#--#-#--#-#--#-#--#-#--#-#--#-#-
--#-#--#-#--#-#--#-#--#-#--#-#--#-#--#-#--#-#--#-#--#-#--#-#--#-#--#-#--#-#--#-#--#-#--#-#--#-#--#-#
----------------------------------------------------------------------------------------------------
-###--###--###--###--###--###--###--###--###--###--###--###--###--###--###--###--###--###--###--###-
---#----#----#----#----#----#----#----#----#----#----#----#----#----#----#----#----#----#----#----#-
-#-#--#-#--#-#--#-#--#-#--#-#--#-#--#-#--#-#--#-#--#-#--#-#--#-#--#-#--#-#--#-#--#-#--#-#--#-#--#-#-
--#-#--#-#--#-#--#-#--#-#--#-#--#-#--#-#--#-#--#-#--#-#--#-#--#-#--#-#--#-#--#-#--#-#--#-#--#-#--#-#
----------------------------------------------------------------------------------------------------
-###--###--###--###--###--###--###--###--###--###--###--###--###--###--###--###--###--###--###--###-
---#----#----#----#----#----#----#----#----#----#----#----#----#----#----#----#----#----#----#----#-
-#-#--#-#--#-#--#-#--#-#--#-#--#-#--#-#--#-#--#-#--#-#--#-#--#-#--#-#--#-#--#-#--#-#--#-#--#-#--#-#-
--#-#--#-#--#-#--#-#--#-#--#-#--#-#--#-#--#-#--#-#--#-#--#-#--#-#--#-#--#-#--#-#--#-#--#-#--#-#--#-#
----------------------------------------------------------------------------------------------------
-###--###--###--###--###--###--###--###--###--###--###--###--###--###--###--###--###--###--###--###-
---#----#----#----#----#----#----#----#----#----#----#----#----#----#----#----#----#----#----#----#-
-#-#--#-#--#-#--#-#--#-#--#-#--#-#--#-#--#-#--#-#--#-#--#-#--#-#--#-#--#-#--#-#--#-#--#-#--#-#--#-#-
--#-#--#-#--#-#--#-#--#-#--#-#--#-#--#-#--#-#--#-#--#-#--#-#--#-#--#-#--#-#--#-#--#-#--#-#--#-#--#-#
----------------------------------------------------------------------------------------------------
-###--###--###--###--###--###--###--###--###--###--###--###--###--###--###--###--###--###--###--###-
---#----#----#----#----#----#----#----#----#----#----#----#----#----#----#----#----#----#----#----#-
-#-#--#-#--#-#--#-#--#-#--#-#--#-#--#-#--#-#--#-#--#-#--#-#--#-#--#-#--#-#--#-#--#-#--#-#--#-#--#-#-
--#-#--#-#--#-#--#-#--#-#--#-#--#-#--#-#--#-#--#-#--#-#--#-#--#-#--#-#--#-#--#-#--#-#--#-#--#-#--#-#
----------------------------------------------------------------------------------------------------
-###--###--###--###--###--###--###--###--###--###--###--###--###--###--###--###--###--###--###--###-
---#----#----#----#----#----#----#----#----#----#----#----#----#----#----#----#----#----#----#----#-
-#-#--#-#--#-#--#-#--#-#--#-#--#-#--#-#--#-#--#-#--#-#--#-#--#-#--#-#--#-#--#-#--#-#--#-#--#-#--#-#-
--#-#--#-#--#-#--#-#--#-#--#-#--#-#--#-#--#-#--#-#--#-#--#-#--#-#--#-#--#-#--#-#--#-#--#-#--#-#--#-#
----------------------------------------------------------------------------------------------------
-###--###--###--###--###--###--###--###--###--###--###--###--###--###--###--###--###--###--###--###-
---#----#----#----#----#----#----#----#----#----#----#----#----#----#----#----#----#----#----#----#-
-#-#--#-#--#-#--#-#--#-#--#-#--#-#--#-#--#-#--#-#--#-#--#-#--#-#--#-#--#-#--#-#--#-#--#-#--#-#--#-#-
--#-#--#-#--#-#--#-#--#-#--#-#--#-#--#-#--#-#--#-#--#-#--#-#--#-#--#-#--#-#--#-#--#-#--#-#--#-#--#-#
----------------------------------------------------------------------------------------------------
-###--###--###--###--###--###--###--###--###--###--###--###--###--###--###--###--###--###--###--###-
---#----#----#----#----#----#----#----#----#----#----#----#----#----#----#----#----#----#----#----#-
-#-#--#-#--#-#--#-#--#-#--#-#--#-#--#-#--#-#--#-#--#-#--#-#--#-#--#-#--#-#--#-#--#-#--#-#--#-#--#-#-
--#-#--#-#--#-#--#-#--#-#--#-#--#-#--#-#--#-#--#-#--#-#--#-#--#-#--#-#--#-#--#-#--#-#--#-#--#-#--#-#
----------------------------------------------------------------------------------------------------
-###--###--###--###--###--###--###--###--###--###--###--###--###--###--###--###--###--###--###--###-
---#----#----#----#----#----#----#----#----#----#----#----#----#----#----#----#----#----#----#----#-
-#-#--#-#--#-#--#-#--#-#--#-#--#-#--#-#--#-#--#-#--#-#--#-#E-#-#--#-#--#-#--#-#--#-#--#-#--#-#--#-#-
--#-#--#-#--#-#--#-#--#-#--#-#--#-#--#-#--#-#--#-#--#-#--#-#--#-#--#-#--#-#--#-#--#-#--#-#--#-#--#-#
----------------------------------------------------------------------------------------------------
-###--###--###--###--###--###--###--###--###--###--###--###--###--###--###--###--###--###--###--###-
---#----#----#----#----#----#----#----#----#----#----#----#----#----#----#----#----#----#----#----#-
-#-#--#-#--#-#--#-#--#-#--#-#--#-#--#-#--#-#--#-#--#-#--#-#--#-#--#-#--#-#--#-#--#-#--#-#--#-#--#-#-
--#-#--#-#--#-#--#-#--#-#--#-#--#-#--#-#--#-#--#-#--#-#--#-#--#-#--#-#--#-#--#-#--#-#--#-#--#-#--#-#
----------------------------------------------------------------------------------------------------
-###--###--###--###--###--###--###--###--###--###--###--###--###--###--###--###--###--###--###--###-
---#----#----#----#----#----#----#----#----#----#----#----#----#----#----#----#----#----#----#----#-
-#-#--#-#--#-#--#-#--#-#--#-#--#-#--#-#--#-#--#-#--#-#--#-#--#-#--#-#--#-#--#-#--#-#--#-#--#-#--#-#-
--#-#--#-#--#-#--#-#--#-#--#-#--#-#--#-#--#-#--#-#--#-#--#-#--#-#--#-#--#-#--#-#--#-#--#-#--#-#--#-#
----------------------------------------------------------------------------------------------------
-###--###--###--###--###--###--###--###--###--###--###--###--###--###--###--###--###--###--###--###-
---#----#----#----#----#----#----#----#----#----#----#----#----#----#----#----#----#----#----#----#-
-#-#--#-#--#-#--#-#--#-#--#-#--#-#--#-#--#-#--#-#--#-#--#-#--#-#--#-#--#-#--#-#--#-#--#-#--#-#--#-#-
--#-#--#-#--#-#--#-#--#-#--#-#--#-#--#-#--#-#--#-#--#-#--#-#--#-#--#-#--#-#--#-#--#-#--#-#--#-#--#-#
----------------------------------------------------------------------------------------------------
-###--###--###--###--###--###--###--###--###--###--###--###--###--###--###--###--###--###--###--###-
---#----#----#----#----#----#----#----#----#----#----#----#----#----#----#----#----#----#----#----#-
-#-#--#-#--#-#--#-#--#-#--#-#--#-#--#-#--#-#--#-#--#-#--#-#--#-#--#-#--#-#--#-#--#-#--#-#--#-#--#-#-
--#-#--#-#--#-#--#-#--#-#--#-#--#-#--#-#--#-#--#-#--#-#--#-#--#-#--#-#--#-#--#-#--#-#--#-#--#-#--#-#
----------------------------------------------------------------------------------------------------
-###--###--###--###--###--###--###--###--###--###--###--###--###--###--###--###--###--###--###--###-
---#----#----#----#----#----#----#----#----#----#----#----#----#----#----#----#----#----#----#----#-
-#-#--#-#--#-#--#-#--#-#--#-#--#-#--#-#--#-#--#-#--#-#--#-#--#-#--#-#--#-#--#-#--#-#--#-#--#-#--#-#-
--#-#--#-#--#-#--#-#--#-#--#-#--#-#--#-#--#-#--#-#--#-#--#-#--#-#--#-#--#-#--#-#--#-#--#-#--#-#--#-#
----------------------------------------------------------------------------------------------------
-###--###--###--###--###--###--###--###--###--###--###--###--###--###--###--###--###--###--###--###-
---#----#----#----#----#----#----#----#----#----#----#----#----#----#----#----#----#----#----#----#-
-#-#--#-#--#-#--#-#--#-#--#-#--#-#--#-#--#-#--#-#--#-#--#-#--#-#--#-#--#-#--#-#--#-#--#-#--#-#--#-#-
--#-#--#-#--#-#--#-#--#-#--#-#--#-#--#-#--#-#--#-#--#-#--#-#--#-#--#-#--#-#--#-#--#-#--#-#--#-#--#-#
----------------------------------------------------------------------------------------------------
-###--###--###--###--###--###--###--###--###--###--###--###--###--###--###--###--###--###--###--###-
---#----#----#----#----#----#----#----#----#----#----#----#----#----#----#----#----#----#----#----#-
-#-#--#-#--#-#--#-#--#-#--#-#--#-#--#-#--#-#--#-#--#-#--#-#--#-#--#-#--#-#--#-#--#-#--#-#--#-#--#-#-
--#-#--#-#--#-#--#-#--#-#--#-#--#-#--#-#--#-#--#-#--#-#--#-#--#-#--#-#--#-#--#-#--#-#--#-#--#-#--#-#
----------------------------------------------------------------------------------------------------
-###--###--###--###--###--###--###--###--###--###--###--###--###--###--###--###--###--###--###--###-
---#----#----#----#----#----#----#----#----#----#----#----#----#----#----#----#----#----#----#----#-
-#-#--#-#--#-#--#-#--#-#--#-#--#-#--#-#--#-#--#-#--#-#--#-#--#-#--#-#--#-#--#-#--#-#--#-#--#-#--#-#-
--#-#--#-#--#-#--#-#--#-#--#-#--#-#--#-#--#-#--#-#--#-#--#-#--#-#--#-#--#-#--#-#--#-#--#-#--#-#--#-#
----------------------------------------------------------------------------------------------------
-###--###--###--###--###--###--###--###--###--###--###--###--###--###--###--###--###--###--###--###-
---#----#----#----#----#----#----#----#----#----#----#----#----#----#----#----#----#----#----#----#-
-#-#--#-#--#-#--#-#--#-#--#-#--#-#--#-#--#-#--#-#--#-#--#-#--#-#--#-#--#-#--#-#--#-#--#-#--#-#--#-#-
--#-#--#-#--#-#--#-#--#-#--#-#--#-#--#-#--#-#--#-#--#-#--#-#--#-#--#-#--#-#--#-#--#-#--#-#--#-#--#-#
----------------------------------------------------------------------------------------------------
-###--###--###--###--###--###--###--###--###--###--###--###--###--###--###--###--###--###--###--###-
---#----#----#----#----#----#----#----#----#----#----#----#----#----#----#----#----#----#----#----#-
-#-#--#-#--#-#--#-#--#-#--#-#--#-#--#-#--#-#--#-#--#-#--#-#--#-#--#-#--#-#--#-#--#-#--#-#--#-#--#-#-
--#-#--#-#--#-#--#-#--#-#--#-#--#-#--#-#--#-#--#-#--#-#--#-#--#-#--#-#--#-#--#-#--#-#--#-#--#-#--#-#
-------------------------------------------------------------------------S--------------------------