?diagonal=IfAtMostOneObstacle;
-#----#----#----#----#----#----#----#----#----#----#----#----#----#----#----#----#----#----#----#---
----#----#----#----#----#----#----#----#----#----#----#----#----#----#----#----#----#----#----#----#
-#--#-#--#-#--#-#--#-#--#-#--#-#--#-#--#-#--#-#--#-#--#-#--#-#--#-#--#-#--#-#--#-#--#-#--#-#--#-#--#
#--#-#--#-#--#-#--#-#--#-#--#-#--#-#--#-#--#-#--#-#--#-#--#-#--#-#--#-#--#-#--#-#--#-#--#-#--#-#--#-
----#----#----#----#----#----#----#----#----#----#----#----#----#----#----#----#----#----#----#----#
-#----#----#----#----#----#----#----#----#----#----#----#----#----#----#----#----#----#----#----#---
----#----#----#----#----#----#----#----#----#----#----#----#----#----#----#----#----#----#----#----#
-#--#-#--#-#--#-#--#-#--#-#--#-#--#-#--#-#--#-#--#-#--#-#--#-#--#-#--#-#--#-#--#-#--#-#--#-#--#-#--#
#--#-#--#-#--#-#--#-#--#-#--#-#--#-#--#-#--#-#--#-#--#-#--#-#--#-#--#-#--#-#--#-#--#-#--#-#--#-#--#-
----#----#----#----#----#----#----#----#----#----#----#----#----#----#----#----#----#----#----#----#
-#----#----#----#----#----#----#----#----#----#----#----#----#----#----#----#----#----#----#----#---
----#----#----#----#----#----#----#----#----#----#----#----#----#----#----#----#----#----#----#----#
-#--#-#--#-#--#-#--#-#--#-#--#-#--#-#--#-#--#-#--#-#--#-#--#-#--#-#--#-#--#-#--#-#--#-#--#-#--#-#--#
#--#-#--#-#--#-#--#-#--#-#--#-#--#-#--#-#--#-#--#-#--#-#--#-#--#-#--#-#--#-#--#-#--#-#--#-#--#-#--#-
----#----#----#----#----#----#----#----#----#----#----#----#----#----#----#----#----#----#----#----#
-#----#----#----#----#----#----#----#----#----#----#----#----#----#----#----#----#----#----#----#---
----#----#----#----#----#----#----#----#----#----#----#----#----#----#----#----#----#----#----#----#
-#--#-#--#-#--#-#--#-#--#-#--#-#--#-#--#-#--#-#--#-#--#-#--#-#--#-#--#-#--#-#--#-#--#-#--#-#--#-#--#
#--#-#--#-#--#-#--#-#--#-#--#-#--#-#--#-#--#-#--#-#--#-#--#-#--#-#--#-#--#-#--#-#--#-#--#-#--#-#--#-
----#----#----#----#----#----#----#----#----#----#----#----#----#----#----#----#----#----#----#----#
-#----#----#----#----#----#----#----#----#----#----#----#----#----#----#----#----#----#----#----#---
----#----#----#----#----#----#----#----#----#----#----#----#----#----#----#----#----#----#----#----#
-#--#-#--#-#--#-#--#-#--#-#--#-#--#-#--#-#--#-#--#-#--#-#--#-#--#-#--#-#--#-#--#-#--#-#--#-#--#-#--#
#--#-#--#-#--#-#--#-#--#-#--#-#--#-#--#-#--#-#--#-#--#-#--#-#--#-#--#-#--#-#--#-#--#-#--#-#--#-#--#-
----#----#----#----#----#----#----#----#----#----#----#----#----#----#----#----#----#----#----#----#
-#----#----#----#----#----#----#----#----#----#----#----#----#----#----#----#----#----#----#----#---
----#----#----#----#----#----#----#----#----#----#----#----#----#----#----#----#----#----#----#----#
-#--#-#--#-#--#-#--#-#--#-#--#-#--#-#--#-#--#-#--#-#--#-#--#-#--#-#--#-#--#-#--#-#--#-#--#-#--#-#--#
#--#-#--#-#--#-#--#-#--#-#--#-#--#-#--#-#--#-#--#-#--#-#--#-#--#-#--#-#--#-#--#-#--#-#--#-#--#-#--#-
----#----#----#----#----#----#----#----#----#----#----#----#----#----#----#----#----#----#----#----#
-#----#----#----#----#----#----#----#----#----#----#----#----#----#----#----#----#----#----#----#---
----#----#----#----#----#----#----#----#----#----#----#----#----#----#----#----#----#----#----#----#
-#--#-#--#-#--#-#--#-#--#-#--#-#--#-#--#-#--#-#--#-#--#-#--#-#--#-#--#-#--#-#--#-#--#-#--#-#--#-#--#
#--#-#--#-#--#-#--#-#--#-#--#-#--#-#--#-#--#-#--#-#--#-#--#-#--#-#--#-#--#-#--#-#--#-#--#-#--#-#--#-
----#----#----#----#----#----#----#----#----#----#----#----#----#----#----#----#----#----#----#----#
-#----#----#----#----#----#----#----#----#----#----#----#----#----#----#----#----#----#----#----#---
----#----#----#----#----#----#----#----#----#----#----#----#----#----#----#----#----#----#----#----#
-#--#-#--#-#--#-#--#-#--#-#--#-#--#-#--#-#--#-#--#-#--#-#--#-#--#-#--#-#--#-#--#-#--#-#--#-#--#-#--#
#--#-#--#-#--#-#--#-#--#-#--#-#--#-#--#-#--#-#--#-#--#-#--#-#--#-#--#-#--#-#--#-#--#-#--#-#--#-#--#-
----#----#----#----#----#----#----#----#----#----#----#----#----#----#----#----#----#----#----#----#
-#----#----#----#----#----#----#----#----#----#----#----#----#----#----#----#----#----#----#----#---
----#----#----#----#----#----#--E-#----#----#----#----#----#----#----#----#----#----#----#----#----#
-#--#-#--#-#--#-#--#-#--#-#--#-#--#-#--#-#--#-#--#-#--#-#--#-#--#-#--#-#--#-#--#-#--#-#--#-#--#-#--#
#--#-#--#-#--#-#--#-#--#-#--#-#--#-#--#-#--#-#--#-#--#-#--#-#--#-#--#-#--#-#--#-#--#-#--#-#--#-#--#-
----#----#----#----#----#----#----#----#----#----#----#----#----#----#----#----#----#----#----#----#
-#----#----#----#----#----#----#----#----#----#----#----#----#----#----#----#----#----#----#----#---
----#----#----#----#----#----#----#----#----#----#----#----#----#----#----#----#----#----#----#----#
-#--#-#--#-#--#-#--#-#--#-#--#-#--#-#--#-#--#-#--#-#--#-#--#-#--#-#--#-#--#-#--#-#--#-#--#-#--#-#--#
#--#-#--#-#--#-#--#-#--#-#--#-#--#-#--#-#--#-#--#-#--#-#--#-#--#-#--#-#--#-#--#-#--#-#--#-#--#-#--#-
----#----#----#----#----#----#----#----#----#----#----#----#----#----#----#----#----#----#----#----#
-#----#----#----#----#----#----#----#----#----#----#----#----#----#----#----#----#----#----#----#---
----#----#----#----#----#----#----#----#----#----#----#----#----#----#----#----#----#----#----#----#
-#--#-#--#-#--#-#--#-#--#-#--#-#--#-#--#-#--#-#--#-#--#-#--#-#--#-#--#-#--#-#--#-#--#-#--#-#--#-#--#
#--#-#--#-#--#-#--#-#--#-#--#-#--#-#--#-#--#-#--#-#--#-#--#-#--#-#--#-#--#-#--#-#--#-#--#-#--#-#--#-
----#----#----#----#----#----#----#----#----#----#----#----#----#----#----#----#----#----#----#----#
-#----#----#----#----#----#----#----#----#----#----#----#----#----#----#----#----#----#----#----#---
----#----#----#----#----#----#----#----#----#----#----#----#----#----#----#----#----#----#----#----#
-#--#-#--#-#--#-#--#-#--#-#--#-#--#-#--#-#--#-#--#-#--#-#--#-#--#-#--#-#--#-#--#-#--#-#--#-#--#-#--#
#--#-#--#-#--#-#--#-#--#-#--#-#--#-#--#-#--#-#--#-#--#-#--#-#--#-#--#-#--#-#--#-#--#-#--#-#--#-#--#-
----#----#----#----#----#----#----#----#----#----#----#----#----#----#----#----#----#----#----#----#
-#----#----#----#----#----#----#----#----#----#----#----#----#----#----#----#----#----#----#----#---
----#----#----#----#----#----#----#----#----#----#----#----#----#----#----#----#----#----#----#----#
-#--#-#--#-#--#-#--#-#--#-#--#-#--#-#--#-#--#-#--#-#--#-#--#-#--#-#--#-#--#-#--#-#--#-#--#-#--#-#--#
#--#-#--#-#--#-#--#-#--#-#--#-#--#-#--#-#--#-#--#-#--#-#--#-#--#-#--#-#--#-#--#-#--#-#--#-#--#-#--#-
----#----#----#----#----#----#----#----#----#----#----#----#----#----#----#----#----#----#----#----#
-#----#----#----#----#----#----#----#----#----#----#----#----#----#----#----#----#----#----#----#---
----#----#----#----#----#----#----#----#----#----#----#----#----#----#----#----#----#----#----#----#
-#--#-#--#-#--#-#--#-#--#-#--#-#--#-#--#-#--#-#--#-#--#-#--#-#--#-#--#-#--#-#--#-#--#-#--#-#--#-#--#
#--#-#--#-#--#-#--#-#--#-#--#-#--#-#--#-#--#-#--#-#--#-#--#-#--#-#--#-#--#-#--#-#--#-#--#-#--#-#--#-
----#----#----#----#----#----#----#----#----#----#----#----#----#----#----#----#----#----#----#----#
-#----#----#----#----#----#----#----#----#----#----#----#----#----#----#----#----#----#----#----#---
----#----#----#----#----#----#----#----#----#----#----#----#----#----#----#----#----#----#----#----#
-#--#-#--#-#--#-#--#-#--#-#--#-#--#-#--#-#--#-#--#-#--#-#--#-#--#-#--#-#--#-#--#-#--#-#--#-#--#-#--#
#--#-#--#-#--#-#--#-#--#-#--#-#--#-#--#-#--#-#--#-#--#-#--#-#--#-#--#-#--#-#--#-#--#-#--#-#--#-#--#-
----#----#----#----#----#----#----#----#----#----#----#----#----#----#----#----#----#----#----#----#
-#----#----#----#----#----#----#----#----#----#----#----#----#----#----#----#----#----#----#----#---
----#----#----#----#----#----#----#----#----#----#----#----#----#----#----#----#----#----#----#----#
-#--#-#--#-#--#-#--#-#--#-#--#-#--#-#--#-#--#-#--#-#--#-#--#-#--#-#--#-#--#-#--#-#--#-#--#-#--#-#--#
#--#-#--#-#--#-#--#-#--#-#--#-#--#-#--#-#--#-#--#-#--#-#--#-#--#-#--#-#--#-#--#-#--#-#--#-#--#-#--#-
----#----#----#----#----#----#----#----#----#----#----#----#----#----#----#----#----#----#----#----#
-#----#----#----#----#----#----#----#----#----#----#----#----#----#----#----#----#----#----#----#---
----#----#----#----#----#----#----#----#----#----#----#----#----#----#----#----#----#----#----#----#
-#--#-#--#-#--#-#--#-#--#-#--#-#--#-#--#-#--#-#--#-#--#-#--#-#--#-#--#-#--#-#--#-#--#-#--#-#--#-#--#
#--#-#--#-#--#-#--#-#--#-#--#-#--#-#--#-#--#-#--#-#--#-#--#-#--#-#--#-#--#-#--#-#--#-#--#-#--#-#--#-
----#----#----#----#----#----#----#----#----#----#----#----#----#----#----#----#----#----#----#----#
-#----#----#----#----#----#----#----#----#----#----#----#----#----#----#----#----#----#----#----#---
----#----#----#----#----#----#----#----#----#----#----#----#----#----#----#----#----#----#----#----#
-#--#-#--#-#--#-#--#-#--#-#--#-#--#-#--#-#--#-#--#-#--#-#--#-#--#-#--#-#--#-#--#-#--#-#--#-#--#-#--#
#--#-#--#-#--#-#--#-#--#-#--#-#--#-#--#-#--#-#--#-#--#-#--#-#--#-#--#-#--#-#--#-#--#-#--#-#--#-#--#-
----#----#----#----#----#----#----#----#----#----#----#----#----#----#----#----#----#----#----#----#
-#----#----#----#----#----#----#----#----#----#----#----#----#----#----#----#----#----#----#----#---
----#----#----#----#----#----#----#----#----#----#----#----#----#----#----#----#----#----#--S-#----#
-#--#-#--#-#--#-#--#-#--#-#--#-#--#-#--#-#--#-#--#-#--#-#--#-#--#-#--#-#--#-#--#-#--#-#--#-#--#-#--#
#--#-#--#-#--#-#--#-#--#-#--#-#--#-#--#-#--#-#--#-#--#-#--#-#--#-#--#-#--#-#--#-#--#-#--#-#--#-#--#-
----#----#----#----#----#----#----#----#----#----#----#----#----#----#----#----#----#----#----#----#
-#----#----#----#----#----#----#----#----#----#----#----#----#----#----#----#----#----#----#----#---
----#----#----#----#----#----#----#----#----#----#----#----#----#----#----#----#----#----#----#----#
-#--#-#--#-#--#-#--#-#--#-#--#-#--#-#--#-#--#-#--#-#--#-#--#-#--#-#--#-#--#-#--#-#--#-#--#-#--#-#--#
#--#-#--#-#--#-#--#-#--#-#--#-#--#-#--#-#--#-#--#-#--#-#--#-#--#-#--#-#--#-#--#-#--#-#--#-#--#-#--#-
----#----#----#----#----#----#----#----#----#----#----#----#----#----#----#----#----#----#----#----#