?diagonal=IfAtMostOneObstacle;
----------------------------------------------------------------------------------------------------
----------------------------------------------------------------------------------------------------
-#-#--#-#--#-#--#-#--#-#--#-#--#-#--#-#--#-#--#-#--#-#--#-#--#-#--#-#--#-#--#-#--#-#--#-#--#-#--#-#-
-####-####-####-####-####-####-####-####-####-####-####-####-####-####-####-####-####-####-####-####
-#-#--#-#--#-#--#-#--#-#--#-#--#-#--#-#--#-#--#-#--#-#--#-#--#-#--#-#--#-#--#-#--#-#S-#-#--#-#--#-#-
----------------------------------------------------------------------------------------------------
----------------------------------------------------------------------------------------------------
-#-#--#-#--#-#--#-#--#-#--#-#--#-#--#-#--#-#--#-#--#-#--#-#--#-#--#-#--#-#--#-#--#-#--#-#--#-#--#-#-
-####-####-####-####-####-####-####-####-####-####-####-####-####-####-####-####-####-####-####-####
-#-#--#-#--#-#--#-#--#-#--#-#--#-#--#-#--#-#--#-#--#-#--#-#--#-#--#-#--#-#--#-#--#-#--#-#--#-#--#-#-
----------------------------------------------------------------------------------------------------
----------------------------------------------------------------------------------------------------
-#-#--#-#--#-#--#-#--#-#--#-#--#-#--#-#--#-#--#-#--#-#--#-#--#-#--#-#--#-#--#-#--#-#--#-#--#-#--#-#-
-####-####-####-####-####-####-####-####-####-####-####-####-####-####-####-####-####-####-####-####
-#-#--#-#--#-#--#-#--#-#--#-#--#-#--#-#--#-#--#-#--#-#--#-#--#-#--#-#--#-#--#-#--#-#--#-#--#-#--#-#-
----------------------------------------------------------------------------------------------------
----------------------------------------------------------------------------------------------------
-#-#--#-#--#-#--#-#--#-#--#-#--#-#--#-#--#-#--#-#--#-#--#-#--#-#--#-#--#-#--#-#--#-#--#-#--#-#--#-#-
-####-####-####-####-####-####-####-####-####-####-####-####-####-####-####-####-####-####-####-####
-#-#--#-#--#-#--#-#--#-#--#-#--#-#--#-#--#-#--#-#--#-#--#-#--#-#--#-#--#-#--#-#--#-#--#-#--#-#--#-#-
----------------------------------------------------------------------------------------------------
----------------------------------------------------------------------------------------------------
-#-#--#-#--#-#--#-#--#-#--#-#--#-#--#-#--#-#--#-#--#-#--#-#--#-#--#-#--#-#--#-#--#-#--#-#--#-#--#-#-
-####-####-####-####-####-####-####-####-####-####-####-####-####-####-####-####-####-####-####-####
-#-#--#-#--#-#--#-#--#-#--#-#--#-#--#-#--#-#--#-#--#-#--#-#--#-#--#-#--#-#--#-#--#-#--#-#--#-#--#-#-
----------------------------------------------------------------------------------------------------
----------------------------------------------------------------------------------------------------
-#-#--#-#--#-#--#-#--#-#--#-#--#-#--#-#--#-#--#-#--#-#--#-#--#-#--#-#--#-#--#-#--#-#--#-#--#-#--#-#-
-####-####-####-####-####-####-####-####-####-####-####-####-####-####-####-####-####-####-####-####
-#-#--#-#--#-#--#-#--#-#--#-#--#-#--#-#--#-#--#-#--#-#--#-#--#-#--#-#--#-#--#-#--#-#--#-#--#-#--#-#-
----------------------------------------------------------------------------------------------------
----------------------------------------------------------------------------------------------------
-#-#--#-#--#-#--#-#--#-#--#-#--#-#--#-#--#-#--#-#--#-#--#-#--#-#--#-#--#-#--#-#--#-#--#-#--#-#--#-#-
-####-####-####-####-####-####-####-####-####-####-####-####-####-####-####-####-####-####-####-####
-#-#--#-#--#-#--#-#--#-#--#-#--#-#--#-#--#-#--#-#--#-#--#-#--#-#--#-#--#-#--#-#--#-#--#-#--#-#--#-#-
----------------------------------------------------------------------------------------------------
----------------------------------------------------------------------------------------------------
-#-#--#-#--#-#--#-#--#-#--#-#--#-#--#-#--#-#--#-#--#-#--#-#--#-#--#-#--#-#--#-#--#-#--#-#--#-#--#-#-
-####-####-####-####-####-####-####-####-####-####-####-####-####-####-####-####-####-####-####-####
-#-#--#-#--#-#--#-#--#-#--#-#--#-#--#-#--#-#--#-#--#-#--#-#--#-#--#-#--#-#--#-#--#-#--#-#--#-#--#-#-
----------------------------------------------------------------------------------------------------
----------------------------------------------------------------------------------------------------
-#-#--#-#--#-#--#-#--#-#--#-#--#-#--#-#--#-#--#-#--#-#--#-#--#-#--#-#--#-#--#-#--#-#--#-#--#-#--#-#-
-####-####-####-####-####-####-####-####-####-####-####-####-####-####-####-####-####-####-####-####
-#-#--#-#--#-#--#-#--#-#--#-#--#-#--#-#--#-#--#-#--#-#--#-#--#-#--#-#--#-#--#-#--#-#--#-#--#-#--#-#-
----------------------------------------------------------------------------------------------------
----------------------------------------------------------------------------------------------------
-#-#--#-#--#-#--#-#--#-#--#-#--#-#--#-#--#-#--#-#--#-#--#-#--#-#--#-#--#-#--#-#--#-#--#-#--#-#--#-#-
-####-####-####-####-####-####-####-####-####-####-####-####-####-####-####-####-####-####-####-####
-#-#--#-#--#-#--#-#--#-#--#-#--#-#--#-#--#-#--#-#--#-#--#-#--#-#--#-#--#-#--#-#--#-#--#-#--#-#--#-#-
----------------------------------------------------------------------------------------------------
----------------------------------------------------------------------------------------------------
-#-#--#-#--#-#--#-#--#-#--#-#--#-#--#-#--#-#--#-#--#-#--#-#--#-#--#-#--#-#--#-#--#-#--#-#--#-#--#-#-
-####-####-####-####-####-####-####-####-####-####-####-####-####-####-####-####-####-####-####-####
-#-#--#-#--#-#--#-#--#-#--#-#--#-#--#-#--#-#--#-#--#-#--#-#--#-#--#-#--#-#--#-#--#-#--#-#--#-#--#-#-
----------------------------------------------------------------------------------------------------
----------------------------------------------------------------------------------------------------
-#-#--#-#--#-#--#-#--#-#--#-#--#-#--#-#--#-#--#-#--#-#--#-#--#-#--#-#--#-#--#-#--#-#--#-#--#-#--#-#-
-####-####-####-####-####-####-####-####-####-####-####-####-####-####-####-####-####-####-####-####
-#-#--#-#--#-#--#-#--#-#--#-#--#-#--#-#--#-#--#-#--#-#--#-#--#-#--#-#--#-#--#-#--#-#--#-#--#-#--#-#-
----------------------------------------------------------------------------------------------------
----------------------------------------------------------------------------------------------------
-#-#--#-#--#-#--#-#--#-#--#-#--#-#--#-#--#-#--#-#--#-#--#-#--#-#--#-#--#-#--#-#--#-#--#-#--#-#--#-#-
-####-####-####-####-####-####-####-####-####-####-####-####-####-####-####-####-####-####-####-####
-#-#--#-#--#-#--#-#--#-#--#-#--#-#--#-#--#-#--#-#--#-#--#-#--#-#--#-#--#-#--#-#--#-#--#-#--#-#--#-#-
----------------------------------------------------------------------------------------------------
----------------------------------------------------------------------------------------------------
-#-#--#-#--#-#--#-#--#-#--#-#--#-#--#-#--#-#--#-#--#-#--#-#--#-#--#-#--#-#--#-#--#-#--#-#--#-#--#-#-
-####-####-####-####-####-####-####-####-####-####-####-####-####-####-####-####-####-####-####-####
-#-#--#-#--#-#--#-#--#-#--#-#--#-#--#-#--#-#--#-#--#-#--#-#--#-#--#-#--#-#--#-#--#-#--#-#--#-#--#-#-
----------------------------------------------------------------------------------------------------
----------------------------------------------------------------------------------------------------
-#-#--#-#--#-#--#-#--#-#--#-#--#-#--#-#--#-#--#-#--#-#--#-#--#-#--#-#--#-#--#-#--#-#--#-#--#-#--#-#-
-####-####-####-####-####-####-####-####-####-####-####-####-####-####-####-####-####-####-####-####
-#-#--#-#--#-#--#-#--#-#--#-#--#-#--#-#--#-#--#-#--#-#--#-#--#-#--#-#--#-#--#-#--#-#--#-#--#-#--#-#-
----------------------------------------------------------------------------------------------------
----------------------------------------------------------------------------------------------------
-#-#--#-#--#-#--#-#--#-#--#-#--#-#--#-#--#-#--#-#--#-#--#-#--#-#--#-#--#-#--#-#--#-#--#-#--#-#--#-#-
-####-####-####-####-####-####-####-####-####-####-####-####-####-####-####-####-####-####-####-####
-#-#--#-#--#-#--#-#--#-#--#-#--#-#--#-#--#-#--#-#--#-#--#-#--#-#--#-#--#-#--#-#--#-#--#-#--#-#--#-#-
----------------------------------------------------------------------------------------------------
----------------------------------------------------------------------------------------------------
-#-#--#-#--#-#--#-#--#-#--#-#--#-#--#-#--#-#--#-#--#-#--#-#--#-#--#-#--#-#--#-#--#-#--#-#--#-#--#-#-
-####-####-####-####-####-####-####-####-####-####-####-####-####-####-####-####-####-####-####-####
-#-#--#-#--#-#--#-#--#-#--#-#--#-#--#-#--#-#--#-#--#-#--#-#--#-#--#-#--#-#--#-#--#-#--#-#--#-#--#-#-
----------------------------------------------------------------------------------------------------
----------------------------------------------------------------------------------------------------
-#-#--#-#--#-#--#-#--#-#--#-#--#-#--#-#--#-#--#-#--#-#--#-#--#-#--#-#--#-#--#-#--#-#--#-#--#-#--#-#-
-####-####-####-####-####-####-####-####-####-####-####-####-####-####-####-####-####-####-####-####
-#-#--#-#--#-#--#-#--#-#--#-#--#-#--#-#--#-#--#-#--#-#--#-#--#-#--#-#--#-#--#-#--#-#--#-#--#-#--#-#-
----------------------------------------------------------------------------------------------------
----------------------------------------------------------------------------------------------------
-#-#--#-#--#-#--#-#--#-#--#-#--#-#--#-#--#-#--#-#--#-#--#-#--#-#--#-#--#-#--#-#--#-#--#-#--#-#--#-#-
-####-####-####-####-####-####-####-####-####-####-####-####-####-####-####-####-####-####-####-####
-#-#--#-#--#-#--#-#--#-#--#-#--#-#--#-#--#-#--#-#--#-#--#-#--#-#--#-#--#-#--#-#--#-#--#-#--#-#--#-#-
----------------------------------------------------------------------------------------------------
----------------------------------------------------------------------------------------------------
-#-#--#-#--#-#--#-#--#-#--#-#--#-#--#-#--#-#--#-#--#-#E-#-#--#-#--#-#--#-#--#-#--#-#--#-#--#-#--#-#-
-####-####-####-####-####-####-####-####-####-####-####-####-####-####-####-####-####-####-####-####
-#-#--#-#--#-#--#-#--#-#--#-#--#-#--#-#--#-#--#-#--#-#--#-#--#-#--#-#--#-#--#-#--#-#--#-#--#-#--#-#-