?diagonal=IfAtMostOneObstacle;
--##---##---##---##---##---##---##---##---##---##---##---##---##---##---##---##---##---##---##---##-
#--#-#--#-#--#-#--#-#--#-#--#-#--#-#--#-#--#-#--#-#--#-#--#-#--#-#--#-#--#-#--#-#--#-#--#-#--#-#--#-
----------------------------------------------------------------------------------------------------
--#----#----#----#----#----#----#----#----#----#----#----#----#----#----#----#----#----#----#----#--
---##---##---##---##---##---##---##---##---##--S##---##---##---##---##---##---##---##---##---##---##
--##---##---##---##---##---##---##---##---##---##---##---##---##---##---##---##---##---##---##---##-
#--#-#--#-#--#-#--#-#--#-#--#-#--#-#--#-#--#-#--#-#--#-#--#-#--#-#--#-#--#-#--#-#--#-#--#-#--#-#--#-
----------------------------------------------------------------------------------------------------
--#----#----#----#----#----#----#----#----#----#----#----#----#----#----#----#----#----#----#----#--
---##---##---##---##---##---##---##---##---##---##---##---##---##---##---##---##---##---##---##---##
--##---##---##---##---##---##---##---##---##---##---##---##---##---##---##---##---##---##---##---##-
#--#-#--#-#--#-#--#-#--#-#--#-#--#-#--#-#--#-#--#-#--#-#--#-#--#-#--#-#--#-#--#-#--#-#--#-#--#-#--#-
----------------------------------------------------------------------------------------------------
--#----#----#----#----#----#----#----#----#----#----#----#----#----#----#----#----#----#----#----#--
---##---##---##---##---##---##---##---##---##---##---##---##---##---##---##---##---##---##---##---##
--##---##---##---##---##---##---##---##---##---##---##---##---##---##---##---##---##---##---##---##-
#--#-#--#-#--#-#--#-#--#-#--#-#--#-#--#-#--#-#--#-#--#-#--#-#--#-#--#-#--#-#--#-#--#-#--#-#--#-#--#-
----------------------------------------------------------------------------------------------------
--#----#----#----#----#----#----#----#----#----#----#----#----#----#----#----#----#----#----#----#--
---##---##---##---##---##---##---##---##---##---##---##---##---##---##---##---##---##---##---##---##
--##---##---##---##---##---##---##---##---##---##---##---##---##---##---##---##---##---##---##---##-
#--#-#--#-#--#-#--#-#--#-#--#-#--#-#--#-#--#-#--#-#--#-#--#-#--#-#--#-#--#-#--#-#--#-#--#-#--#-#--#-
----------------------------------------------------------------------------------------------------
--#----#----#----#----#----#----#----#----#----#----#----#----#----#----#----#----#----#----#----#--
---##---##---##---##---##---##---##---##---##---##---##---##---##---##---##---##---##---##---##---##
--##---##---##---##---##---##---##---##---##---##---##---##---##---##---##---##---##---##---##---##-
#--#-#--#-#--#-#--#-#--#-#--#-#--#-#--#-#--#-#--#-#--#-#--#-#--#-#--#-#--#-#--#-#--#-#--#-#--#-#--#-
----------------------------------------------------------------------------------------------------
--#----#----#----#----#----#----#----#----#----#----#----#----#----#----#----#----#----#----#----#--
---##---##---##---##---##---##---##---##---##---##---##---##---##---##---##---##---##---##---##---##
--##---##---##---##---##---##---##---##---##---##---##---##---##---##---##---##---##---##---##---##-
#--#-#--#-#--#-#--#-#--#-#--#-#--#-#--#-#--#-#--#-#--#-#--#-#--#-#--#-#--#-#--#-#--#-#--#-#--#-#--#-
----------------------------------------------------------------------------------------------------
--#----#----#----#----#----#----#----#----#----#----#----#----#----#----#----#----#----#----#----#--
---##---##---##---##---##---##---##---##---##---##---##---##---##---##---##---##---##---##---##---##
--##---##---##---##---##---##---##---##---##---##---##---##---##---##---##---##---##---##---##---##-
#--#-#--#-#--#-#--#-#--#-#--#-#--#-#--#-#--#-#--#-#--#-#--#-#--#-#--#-#--#-#--#-#--#-#--#-#--#-#--#-
----------------------------------------------------------------------------------------------------
--#----#----#----#----#----#----#----#----#----#----#----#----#----#----#----#----#----#----#----#--
---##---##---##---##---##---##---##---##---##---##---##---##---##---##---##---##---##---##---##---##
--##---##---##---##---##---##---##---##---##---##---##---##---##---##---##---##---##---##---##---##-
#--#-#--#-#--#-#--#-#--#-#--#-#--#-#--#-#--#-#--#-#--#-#--#-#--#-#--#-#--#-#--#-#--#-#--#-#--#-#--#-
----------------------------------------------------------------------------------------------------
--#----#----#----#----#----#----#----#----#----#----#----#----#----#----#----#----#----#----#----#--
---##---##---##---##---##---##---##---##---##---##---##---##---##---##---##---##---##---##---##---##
--##---##---##---##---##---##---##---##---##---##---##---##---##---##---##---##---##---##---##---##-
#--#-#--#-#--#-#--#-#--#-#--#-#--#-#--#-#--#-#--#-#--#-#--#-#--#-#--#-#--#-#--#-#--#-#--#-#--#-#--#-
----------------------------------------------------------------------------------------------------
--#----#----#----#----#----#----#----#----#----#----#----#----#----#----#----#----#----#----#----#--
---##---##---##---##---##---##---##---##---##---##---##---##---##---##---##---##---##---##---##---##
--##---##---##---##---##---##---##---##---##---##---##---##---##---##---##---##---##---##---##---##-
#--#-#--#-#--#-#--#-#--#-#--#-#--#-#--#-#--#-#--#-#--#-#--#-#--#-#--#-#--#-#--#-#--#-#--#-#--#-#--#-
----------------------------------------------------------------------------------------------------
--#----#----#----#----#----#----#----#----#----#----#----#----#----#----#----#----#----#----#----#--
---##---##---##---##---##---##---##---##---##---##---##---##---##---##---##---##---##---##---##---##
--##---##---##---##---##---##---##---##---##---##---##---##---##---##---##---##---##---##---##---##-
#--#-#--#-#--#-#--#-#--#-#--#-#--#-#--#-#--#-#--#-#--#-#--#-#--#-#--#-#--#-#--#-#--#-#--#-#--#-#--#-
--------------------------------------------------------------------------------------------E-------
--#----#----#----#----#----#----#----#----#----#----#----#----#----#----#----#----#----#----#----#--
---##---##---##---##---##---##---##---##---##---##---##---##---##---##---##---##---##---##---##---##
--##---##---##---##---##---##---##---##---##---##---##---##---##---##---##---##---##---##---##---##-
#--#-#--#-#--#-#--#-#--#-#--#-#--#-#--#-#--#-#--#-#--#-#--#-#--#-#--#-#--#-#--#-#--#-#--#-#--#-#--#-
----------------------------------------------------------------------------------------------------
--#----#----#----#----#----#----#----#----#----#----#----#----#----#----#----#----#----#----#----#--
---##---##---##---##---##---##---##---##---##---##---##---##---##---##---##---##---##---##---##---##
--##---##---##---##---##---##---##---##---##---##---##---##---##---##---##---##---##---##---##---##-
#--#-#--#-#--#-#--#-#--#-#--#-#--#-#--#-#--#-#--#-#--#-#--#-#--#-#--#-#--#-#--#-#--#-#--#-#--#-#--#-
----------------------------------------------------------------------------------------------------
--#----#----#----#----#----#----#----#----#----#----#----#----#----#----#----#----#----#----#----#--
---##---##---##---##---##---##---##---##---##---##---##---##---##---##---##---##---##---##---##---##
--##---##---##---##---##---##---##---##---##---##---##---##---##---##---##---##---##---##---##---##-
#--#-#--#-#--#-#--#-#--#-#--#-#--#-#--#-#--#-#--#-#--#-#--#-#--#-#--#-#--#-#--#-#--#-#--#-#--#-#--#-
----------------------------------------------------------------------------------------------------
--#----#----#----#----#----#----#----#----#----#----#----#----#----#----#----#----#----#----#----#--
---##---##---##---##---##---##---##---##---##---##---##---##---##---##---##---##---##---##---##---##
--##---##---##---##---##---##---##---##---##---##---##---##---##---##---##---##---##---##---##---##-
#--#-#--#-#--#-#--#-#--#-#--#-#--#-#--#-#--#-#--#-#--#-#--#-#--#-#--#-#--#-#--#-#--#-#--#-#--#-#--#-
----------------------------------------------------------------------------------------------------
--#----#----#----#----#----#----#----#----#----#----#----#----#----#----#----#----#----#----#----#--
---##---##---##---##---##---##---##---##---##---##---##---##---##---##---##---##---##---##---##---##
--##---##---##---##---##---##---##---##---##---##---##---##---##---##---##---##---##---##---##---##-
#--#-#--#-#--#-#--#-#--#-#--#-#--#-#--#-#--#-#--#-#--#-#--#-#--#-#--#-#--#-#--#-#--#-#--#-#--#-#--#-
----------------------------------------------------------------------------------------------------
--#----#----#----#----#----#----#----#----#----#----#----#----#----#----#----#----#----#----#----#--
---##---##---##---##---##---##---##---##---##---##---##---##---##---##---##---##---##---##---##---##
--##---##---##---##---##---##---##---##---##---##---##---##---##---##---##---##---##---##---##---##-
#--#-#--#-#--#-#--#-#--#-#--#-#--#-#--#-#--#-#--#-#--#-#--#-#--#-#--#-#--#-#--#-#--#-#--#-#--#-#--#-
----------------------------------------------------------------------------------------------------
--#----#----#----#----#----#----#----#----#----#----#----#----#----#----#----#----#----#----#----#--
---##---##---##---##---##---##---##---##---##---##---##---##---##---##---##---##---##---##---##---##
--##---##---##---##---##---##---##---##---##---##---##---##---##---##---##---##---##---##---##---##-
#--#-#--#-#--#-#--#-#--#-#--#-#--#-#--#-#--#-#--#-#--#-#--#-#--#-#--#-#--#-#--#-#--#-#--#-#--#-#--#-
----------------------------------------------------------------------------------------------------
--#----#----#----#----#----#----#----#----#----#----#----#----#----#----#----#----#----#----#----#--
---##---##---##---##---##---##---##---##---##---##---##---##---##---##---##---##---##---##---##---##
--##---##---##---##---##---##---##---##---##---##---##---##---##---##---##---##---##---##---##---##-
#--#-#--#-#--#-#--#-#--#-#--#-#--#-#--#-#--#-#--#-#--#-#--#-#--#-#--#-#--#-#--#-#--#-#--#-#--#-#--#-
----------------------------------------------------------------------------------------------------
--#----#----#----#----#----#----#----#----#----#----#----#----#----#----#----#----#----#----#----#--
---##---##---##---##---##---##---##---##---##---##---##---##---##---##---##---##---##---##---##---##