?diagonal=IfAtMostOneObstacle;
----------------------------------------------------------------------------------------------------
--##---##---##---##---##---##---##---##---##---##---##---##---##---##---##---##---##---##---##---##-
----#----#----#----#----#----#----#----#----#----#----#----#----#----#----#----#----#----#----#----#
----#----#----#----#----#----#----#----#----#----#----#----#----#----#----#----#----#----#----#----#
#-##-#-##-#-##-#-##-#-##-#-##-#-##-#-##-#-##-#-##-#-##-#-##-#-##-#-##-#-##-#-##-#-##-#-##-#-##-#-##-
----------------------------------------------------------------------------------------------------
--##---##---##---##---##---##---##---##---##---##---##---##---##---##---##---##---##---##---##---##-
----#----#----#----#----#----#----#----#----#----#----#----#----#----#----#----#----#----#----#----#
----#----#----#----#----#----#----#----#----#----#----#----#----#----#----#----#----#----#----#----#
#-##-#-##-#-##-#-##-#-##-#-##-#-##-#-##-#-##-#-##-#-##-#-##-#-##-#-##-#-##-#-##-#-##-#-##-#-##-#-##-
----------------------------------------------------------------------------------------------------
--##---##---##---##---##---##---##---##---##---##---##---##---##---##---##---##---##---##---##---##-
----#----#----#----#----#----#----#----#----#----#----#----#----#----#----#----#----#----#----#----#
----#----#----#----#----#----#----#----#----#----#----#----#----#----#----#----#----#----#----#----#
#-##-#-##-#-##-#-##-#-##-#-##-#-##-#-##-#-##-#-##-#-##-#-##-#-##-#-##-#-##-#-##-#-##-#-##-#-##-#-##-
----------------------------------------------------------------------------------------------------
--##---##---##---##---##---##---##---##---##---##---##---##---##---##---##---##---##---##---##---##-
----#----#----#----#----#----#----#----#----#----#----#----#----#----#----#----#----#----#----#----#
----#----#----#----#----#----#----#----#----#----#----#----#----#----#----#----#----#----#----#----#
#-##-#-##-#-##-#-##-#-##-#-##-#-##-#-##-#-##-#-##-#-##-#-##-#-##-#-##-#-##-#-##-#-##-#-##-#-##-#-##-
----------------------------------------------------------------------------------------------------
--##---##---##---##---##---##---##---##---##---##---##---##---##---##---##---##---##---##---##---##-
----#----#----#----#----#----#----#----#----#----#----#----#----#----#----#----#----#----#----#----#
----#----#----#----#----#----#----#----#----#----#----#----#----#----#----#----#----#----#----#----#
#-##-#-##-#-##-#-##-#-##-#-##-#-##-#-##-#-##-#-##-#-##-#-##-#-##-#-##-#-##-#-##-#-##-#-##-#-##-#-##-
----------------------------------------------------------------------------------------------------
--##---##---##---##---##---##---##---##---##---##---##---##---##---##---##---##---##---##---##---##-
----#----#----#----#----#----#----#----#----#----#----#----#----#----#----#----#----#----#----#----#
----#----#----#----#----#----#----#----#----#----#----#----#----#----#----#----#----#----#----#----#
#-##-#-##-#-##-#-##-#-##-#-##-#-##-#-##-#-##-#-##-#-##-#-##-#-##-#-##-#-##-#-##-#-##-#-##-#-##-#-##-
---------------------------------------------------------S------------------------------------------
--##---##---##---##---##---##---##---##---##---##---##---##---##---##---##---##---##---##---##---##-
----#----#----#----#----#----#----#----#----#----#----#----#----#----#----#----#----#----#----#----#
----#----#----#----#----#----#----#----#----#----#----#----#----#----#----#----#----#----#----#----#
#-##-#-##-#-##-#-##-#-##-#-##-#-##-#-##-#-##-#-##-#-##-#-##-#-##-#-##-#-##-#-##-#-##-#-##-#-##-#-##-
----------------------------------------------------------------------------------------------------
--##---##---##---##---##---##---##---##---##---##---##---##---##---##---##---##---##---##---##---##-
----#----#----#----#----#----#----#----#----#----#----#----#----#----#----#----#----#----#----#----#
----#----#----#----#----#----#----#----#----#----#----#----#----#----#----#----#----#----#----#----#
#-##-#-##-#-##-#-##-#-##-#-##-#-##-#-##-#-##-#-##-#-##-#-##-#-##-#-##-#-##-#-##-#-##-#-##-#-##-#-##-
----------------------------------------------------------------------------------------------------
--##---##---##---##---##---##---##---##---##---##---##---##---##---##---##---##---##---##---##---##-
----#----#----#----#----#----#----#----#----#----#----#----#----#----#----#----#----#----#----#----#
----#----#----#----#----#----#----#----#----#----#----#----#----#----#----#----#----#----#----#----#
#-##-#-##-#-##-#-##-#-##-#-##-#-##-#-##-#-##-#-##-#-##-#-##-#-##-#-##-#-##-#-##-#-##-#-##-#-##-#-##-
----------------------------------------------------------------------------------------------------
--##---##---##---##---##---##---##---##---##---##---##---##---##---##---##---##---##---##---##---##-
----#----#----#----#----#----#----#----#----#----#----#----#----#----#----#----#----#----#----#----#
----#----#----#----#----#----#----#----#----#----#----#----#----#----#----#----#----#----#----#----#
#-##-#-##-#-##-#-##-#-##-#-##-#-##-#-##-#-##-#-##-#-##-#-##-#-##-#-##-#-##-#-##-#-##-#-##-#-##-#-##-
----------------------------------------------------------------------------------------------------
--##E--##---##---##---##---##---##---##---##---##---##---##---##---##---##---##---##---##---##---##-
----#----#----#----#----#----#----#----#----#----#----#----#----#----#----#----#----#----#----#----#
----#----#----#----#----#----#----#----#----#----#----#----#----#----#----#----#----#----#----#----#
#-##-#-##-#-##-#-##-#-##-#-##-#-##-#-##-#-##-#-##-#-##-#-##-#-##-#-##-#-##-#-##-#-##-#-##-#-##-#-##-
----------------------------------------------------------------------------------------------------
--##---##---##---##---##---##---##---##---##---##---##---##---##---##---##---##---##---##---##---##-
----#----#----#----#----#----#----#----#----#----#----#----#----#----#----#----#----#----#----#----#
----#----#----#----#----#----#----#----#----#----#----#----#----#----#----#----#----#----#----#----#
#-##-#-##-#-##-#-##-#-##-#-##-#-##-#-##-#-##-#-##-#-##-#-##-#-##-#-##-#-##-#-##-#-##-#-##-#-##-#-##-
----------------------------------------------------------------------------------------------------
--##---##---##---##---##---##---##---##---##---##---##---##---##---##---##---##---##---##---##---##-
----#----#----#----#----#----#----#----#----#----#----#----#----#----#----#----#----#----#----#----#
----#----#----#----#----#----#----#----#----#----#----#----#----#----#----#----#----#----#----#----#
#-##-#-##-#-##-#-##-#-##-#-##-#-##-#-##-#-##-#-##-#-##-#-##-#-##-#-##-#-##-#-##-#-##-#-##-#-##-#-##-
----------------------------------------------------------------------------------------------------
--##---##---##---##---##---##---##---##---##---##---##---##---##---##---##---##---##---##---##---##-
----#----#----#----#----#----#----#----#----#----#----#----#----#----#----#----#----#----#----#----#
----#----#----#----#----#----#----#----#----#----#----#----#----#----#----#----#----#----#----#----#
#-##-#-##-#-##-#-##-#-##-#-##-#-##-#-##-#-##-#-##-#-##-#-##-#-##-#-##-#-##-#-##-#-##-#-##-#-##-#-##-
----------------------------------------------------------------------------------------------------
--##---##---##---##---##---##---##---##---##---##---##---##---##---##---##---##---##---##---##---##-
----#----#----#----#----#----#----#----#----#----#----#----#----#----#----#----#----#----#----#----#
----#----#----#----#----#----#----#----#----#----#----#----#----#----#----#----#----#----#----#----#
#-##-#-##-#-##-#-##-#-##-#-##-#-##-#-##-#-##-#-##-#-##-#-##-#-##-#-##-#-##-#-##-#-##-#-##-#-##-#-##-
----------------------------------------------------------------------------------------------------
--##---##---##---##---##---##---##---##---##---##---##---##---##---##---##---##---##---##---##---##-
----#----#----#----#----#----#----#----#----#----#----#----#----#----#----#----#----#----#----#----#
----#----#----#----#----#----#----#----#----#----#----#----#----#----#----#----#----#----#----#----#
#-##-#-##-#-##-#-##-#-##-#-##-#-##-#-##-#-##-#-##-#-##-#-##-#-##-#-##-#-##-#-##-#-##-#-##-#-##-#-##-
----------------------------------------------------------------------------------------------------
--##---##---##---##---##---##---##---##---##---##---##---##---##---##---##---##---##---##---##---##-
----#----#----#----#----#----#----#----#----#----#----#----#----#----#----#----#----#----#----#----#
----#----#----#----#----#----#----#----#----#----#----#----#----#----#----#----#----#----#----#----#
#-##-#-##-#-##-#-##-#-##-#-##-#-##-#-##-#-##-#-##-#-##-#-##-#-##-#-##-#-##-#-##-#-##-#-##-#-##-#-##-
----------------------------------------------------------------------------------------------------
--##---##---##---##---##---##---##---##---##---##---##---##---##---##---##---##---##---##---##---##-
----#----#----#----#----#----#----#----#----#----#----#----#----#----#----#----#----#----#----#----#
----#----#----#----#----#----#----#----#----#----#----#----#----#----#----#----#----#----#----#----#
#-##-#-##-#-##-#-##-#-##-#-##-#-##-#-##-#-##-#-##-#-##-#-##-#-##-#-##-#-##-#-##-#-##-#-##-#-##-#-##-
----------------------------------------------------------------------------------------------------
--##---##---##---##---##---##---##---##---##---##---##---##---##---##---##---##---##---##---##---##-
----#----#----#----#----#----#----#----#----#----#----#----#----#----#----#----#----#----#----#----#
----#----#----#----#----#----#----#----#----#----#----#----#----#----#----#----#----#----#----#----#
#-##-#-##-#-##-#-##-#-##-#-##-#-##-#-##-#-##-#-##-#-##-#-##-#-##-#-##-#-##-#-##-#-##-#-##-#-##-#-##-
----------------------------------------------------------------------------------------------------
--##---##---##---##---##---##---##---##---##---##---##---##---##---##---##---##---##---##---##---##-
----#----#----#----#----#----#----#----#----#----#----#----#----#----#----#----#----#----#----#----#
----#----#----#----#----#----#----#----#----#----#----#----#----#----#----#----#----#----#----#----#
#-##-#-##-#-##-#-##-#-##-#-##-#-##-#-##-#-##-#-##-#-##-#-##-#-##-#-##-#-##-#-##-#-##-#-##-#-##-#-##-