?diagonal=IfAtMostOneObstacle;
----------------------------------------------------------------------------------------------------
---##---##---##---##S--##---##---##---##---##---##---##---##---##---##---##---##---##---##---##---##
----#----#----#----#----#----#----#----#----#----#----#----#----#----#----#----#----#----#----#----#
--#-#--#-#--#-#--#-#--#-#--#-#--#-#--#-#--#-#--#-#--#-#--#-#--#-#--#-#--#-#--#-#--#-#--#-#--#-#--#-#
--#-#--#-#--#-#--#-#--#-#--#-#--#-#--#-#--#-#--#-#--#-#--#-#--#-#--#-#--#-#--#-#--#-#--#-#--#-#--#-#
----------------------------------------------------------------------------------------------------
---##---##---##---##---##---##---##---##---##---##---##---##---##---##---##---##---##---##---##---##
----#----#----#----#----#----#----#----#----#----#----#----#----#----#----#----#----#----#----#----#
--#-#--#-#--#-#--#-#--#-#--#-#--#-#--#-#--#-#--#-#--#-#--#-#--#-#--#-#--#-#--#-#--#-#--#-#--#-#--#-#
--#-#--#-#--#-#--#-#--#-#--#-#--#-#--#-#--#-#--#-#--#-#--#-#--#-#--#-#--#-#--#-#--#-#--#-#--#-#--#-#
----------------------------------------------------------------------------------------------------
---##---##---##---##---##---##---##---##---##---##---##---##---##---##---##---##---##---##---##---##
----#----#----#----#----#----#----#----#----#----#----#----#----#----#----#----#----#----#----#----#
--#-#--#-#--#-#--#-#--#-#--#-#--#-#--#-#--#-#--#-#--#-#--#-#--#-#--#-#--#-#--#-#--#-#--#-#--#-#--#-#
--#-#--#-#--#-#--#-#--#-#--#-#--#-#--#-#--#-#--#-#--#-#--#-#--#-#--#-#--#-#--#-#--#-#--#-#--#-#--#-#
----------------------------------------------------------------------------------------------------
---##---##---##---##---##---##---##-E-##---##---##---##---##---##---##---##---##---##---##---##---##
----#----#----#----#----#----#----#----#----#----#----#----#----#----#----#----#----#----#----#----#
--#-#--#-#--#-#--#-#--#-#--#-#--#-#--#-#--#-#--#-#--#-#--#-#--#-#--#-#--#-#--#-#--#-#--#-#--#-#--#-#
--#-#--#-#--#-#--#-#--#-#--#-#--#-#--#-#--#-#--#-#--#-#--#-#--#-#--#-#--#-#--#-#--#-#--#-#--#-#--#-#
----------------------------------------------------------------------------------------------------
---##---##---##---##---##---##---##---##---##---##---##---##---##---##---##---##---##---##---##---##
----#----#----#----#----#----#----#----#----#----#----#----#----#----#----#----#----#----#----#----#
--#-#--#-#--#-#--#-#--#-#--#-#--#-#--#-#--#-#--#-#--#-#--#-#--#-#--#-#--#-#--#-#--#-#--#-#--#-#--#-#
--#-#--#-#--#-#--#-#--#-#--#-#--#-#--#-#--#-#--#-#--#-#--#-#--#-#--#-#--#-#--#-#--#-#--#-#--#-#--#-#
----------------------------------------------------------------------------------------------------
---##---##---##---##---##---##---##---##---##---##---##---##---##---##---##---##---##---##---##---##
----#----#----#----#----#----#----#----#----#----#----#----#----#----#----#----#----#----#----#----#
--#-#--#-#--#-#--#-#--#-#--#-#--#-#--#-#--#-#--#-#--#-#--#-#--#-#--#-#--#-#--#-#--#-#--#-#--#-#--#-#
--#-#--#-#--#-#--#-#--#-#--#-#--#-#--#-#--#-#--#-#--#-#--#-#--#-#--#-#--#-#--#-#--#-#--#-#--#-#--#-#
----------------------------------------------------------------------------------------------------
---##---##---##---##---##---##---##---##---##---##---##---##---##---##---##---##---##---##---##---##
----#----#----#----#----#----#----#----#----#----#----#----#----#----#----#----#----#----#----#----#
--#-#--#-#--#-#--#-#--#-#--#-#--#-#--#-#--#-#--#-#--#-#--#-#--#-#--#-#--#-#--#-#--#-#--#-#--#-#--#-#
--#-#--#-#--#-#--#-#--#-#--#-#--#-#--#-#--#-#--#-#--#-#--#-#--#-#--#-#--#-#--#-#--#-#--#-#--#-#--#-#
----------------------------------------------------------------------------------------------------
---##---##---##---##---##---##---##---##---##---##---##---##---##---##---##---##---##---##---##---##
----#----#----#----#----#----#----#----#----#----#----#----#----#----#----#----#----#----#----#----#
--#-#--#-#--#-#--#-#--#-#--#-#--#-#--#-#--#-#--#-#--#-#--#-#--#-#--#-#--#-#--#-#--#-#--#-#--#-#--#-#
--#-#--#-#--#-#--#-#--#-#--#-#--#-#--#-#--#-#--#-#--#-#--#-#--#-#--#-#--#-#--#-#--#-#--#-#--#-#--#-#
----------------------------------------------------------------------------------------------------
---##---##---##---##---##---##---##---##---##---##---##---##---##---##---##---##---##---##---##---##
----#----#----#----#----#----#----#----#----#----#----#----#----#----#----#----#----#----#----#----#
--#-#--#-#--#-#--#-#--#-#--#-#--#-#--#-#--#-#--#-#--#-#--#-#--#-#--#-#--#-#--#-#--#-#--#-#--#-#--#-#
--#-#--#-#--#-#--#-#--#-#--#-#--#-#--#-#--#-#--#-#--#-#--#-#--#-#--#-#--#-#--#-#--#-#--#-#--#-#--#-#
----------------------------------------------------------------------------------------------------
---##---##---##---##---##---##---##---##---##---##---##---##---##---##---##---##---##---##---##---##
----#----#----#----#----#----#----#----#----#----#----#----#----#----#----#----#----#----#----#----#
--#-#--#-#--#-#--#-#--#-#--#-#--#-#--#-#--#-#--#-#--#-#--#-#--#-#--#-#--#-#--#-#--#-#--#-#--#-#--#-#
--#-#--#-#--#-#--#-#--#-#--#-#--#-#--#-#--#-#--#-#--#-#--#-#--#-#--#-#--#-#--#-#--#-#--#-#--#-#--#-#
----------------------------------------------------------------------------------------------------
---##---##---##---##---##---##---##---##---##---##---##---##---##---##---##---##---##---##---##---##
----#----#----#----#----#----#----#----#----#----#----#----#----#----#----#----#----#----#----#----#
--#-#--#-#--#-#--#-#--#-#--#-#--#-#--#-#--#-#--#-#--#-#--#-#--#-#--#-#--#-#--#-#--#-#--#-#--#-#--#-#
--#-#--#-#--#-#--#-#--#-#--#-#--#-#--#-#--#-#--#-#--#-#--#-#--#-#--#-#--#-#--#-#--#-#--#-#--#-#--#-#
----------------------------------------------------------------------------------------------------
---##---##---##---##---##---##---##---##---##---##---##---##---##---##---##---##---##---##---##---##
----#----#----#----#----#----#----#----#----#----#----#----#----#----#----#----#----#----#----#----#
--#-#--#-#--#-#--#-#--#-#--#-#--#-#--#-#--#-#--#-#--#-#--#-#--#-#--#-#--#-#--#-#--#-#--#-#--#-#--#-#
--#-#--#-#--#-#--#-#--#-#--#-#--#-#--#-#--#-#--#-#--#-#--#-#--#-#--#-#--#-#--#-#--#-#--#-#--#-#--#-#
----------------------------------------------------------------------------------------------------
---##---##---##---##---##---##---##---##---##---##---##---##---##---##---##---##---##---##---##---##
----#----#----#----#----#----#----#----#----#----#----#----#----#----#----#----#----#----#----#----#
--#-#--#-#--#-#--#-#--#-#--#-#--#-#--#-#--#-#--#-#--#-#--#-#--#-#--#-#--#-#--#-#--#-#--#-#--#-#--#-#
--#-#--#-#--#-#--#-#--#-#--#-#--#-#--#-#--#-#--#-#--#-#--#-#--#-#--#-#--#-#--#-#--#-#--#-#--#-#--#-#
----------------------------------------------------------------------------------------------------
---##---##---##---##---##---##---##---##---##---##---##---##---##---##---##---##---##---##---##---##
----#----#----#----#----#----#----#----#----#----#----#----#----#----#----#----#----#----#----#----#
--#-#--#-#--#-#--#-#--#-#--#-#--#-#--#-#--#-#--#-#--#-#--#-#--#-#--#-#--#-#--#-#--#-#--#-#--#-#--#-#
--#-#--#-#--#-#--#-#--#-#--#-#--#-#--#-#--#-#--#-#--#-#--#-#--#-#--#-#--#-#--#-#--#-#--#-#--#-#--#-#
----------------------------------------------------------------------------------------------------
---##---##---##---##---##---##---##---##---##---##---##---##---##---##---##---##---##---##---##---##
----#----#----#----#----#----#----#----#----#----#----#----#----#----#----#----#----#----#----#----#
--#-#--#-#--#-#--#-#--#-#--#-#--#-#--#-#--#-#--#-#--#-#--#-#--#-#--#-#--#-#--#-#--#-#--#-#--#-#--#-#
--#-#--#-#--#-#--#-#--#-#--#-#--#-#--#-#--#-#--#-#--#-#--#-#--#-#--#-#--#-#--#-#--#-#--#-#--#-#--#-#
----------------------------------------------------------------------------------------------------
---##---##---##---##---##---##---##---##---##---##---##---##---##---##---##---##---##---##---##---##
----#----#----#----#----#----#----#----#----#----#----#----#----#----#----#----#----#----#----#----#
--#-#--#-#--#-#--#-#--#-#--#-#--#-#--#-#--#-#--#-#--#-#--#-#--#-#--#-#--#-#--#-#--#-#--#-#--#-#--#-#
--#-#--#-#--#-#--#-#--#-#--#-#--#-#--#-#--#-#--#-#--#-#--#-#--#-#--#-#--#-#--#-#--#-#--#-#--#-#--#-#
----------------------------------------------------------------------------------------------------
---##---##---##---##---##---##---##---##---##---##---##---##---##---##---##---##---##---##---##---##
----#----#----#----#----#----#----#----#----#----#----#----#----#----#----#----#----#----#----#----#
--#-#--#-#--#-#--#-#--#-#--#-#--#-#--#-#--#-#--#-#--#-#--#-#--#-#--#-#--#-#--#-#--#-#--#-#--#-#--#-#
--#-#--#-#--#-#--#-#--#-#--#-#--#-#--#-#--#-#--#-#--#-#--#-#--#-#--#-#--#-#--#-#--#-#--#-#--#-#--#-#
----------------------------------------------------------------------------------------------------
---##---##---##---##---##---##---##---##---##---##---##---##---##---##---##---##---##---##---##---##
----#----#----#----#----#----#----#----#----#----#----#----#----#----#----#----#----#----#----#----#
--#-#--#-#--#-#--#-#--#-#--#-#--#-#--#-#--#-#--#-#--#-#--#-#--#-#--#-#--#-#--#-#--#-#--#-#--#-#--#-#
--#-#--#-#--#-#--#-#--#-#--#-#--#-#--#-#--#-#--#-#--#-#--#-#--#-#--#-#--#-#--#-#--#-#--#-#--#-#--#-#
----------------------------------------------------------------------------------------------------
---##---##---##---##---##---##---##---##---##---##---##---##---##---##---##---##---##---##---##---##
----#----#----#----#----#----#----#----#----#----#----#----#----#----#----#----#----#----#----#----#
--#-#--#-#--#-#--#-#--#-#--#-#--#-#--#-#--#-#--#-#--#-#--#-#--#-#--#-#--#-#--#-#--#-#--#-#--#-#--#-#
--#-#--#-#--#-#--#-#--#-#--#-#--#-#--#-#--#-#--#-#--#-#--#-#--#-#--#-#--#-#--#-#--#-#--#-#--#-#--#-#
----------------------------------------------------------------------------------------------------
---##---##---##---##---##---##---##---##---##---##---##---##---##---##---##---##---##---##---##---##
----#----#----#----#----#----#----#----#----#----#----#----#----#----#----#----#----#----#----#----#
--#-#--#-#--#-#--#-#--#-#--#-#--#-#--#-#--#-#--#-#--#-#--#-#--#-#--#-#--#-#--#-#--#-#--#-#--#-#--#-#
--#-#--#-#--#-#--#-#--#-#--#-#--#-#--#-#--#-#--#-#--#-#--#-#--#-#--#-#--#-#--#-#--#-#--#-#--#-#--#-#