?diagonal=Never;
##----#-##---##--#--##-#---###------#-##--#-----##--###-#--##--##---#--#---#----##--#--#--#-----#---
##---#--#--#-###----#-#-----#--#---#--#---#-#-##--##-----##---###--####---#--#-----------#-----##---
###-#----##-#---#---#--#-----#--#--#-----------##--##--------#-----#-##---##---#-#-#--#--#-----###-#
---###---#----#-#--#-#-##-#---#-#--###-#-----##------#--####-#--##--------#------#---#-----#----#--#
---#-#-#-----#--##-------##--#-#----##--#--#-----#--#####-#--#------##-#--------#--------###-##----#
-----#-#-----##---------#-##----#-------##-##--#--#--------##--##---###---#---#----#---##-----------
---#--#-##--##---##---###----#--##-##---#-##---------#-#--#--#---#-#-##---#---#----#####---#--##--#-
-#--#-----###---#-------#--##---#-##--#----#-##------#------#----##-----#---#-#--#---##---#------###
-#-#-----#-#--##---#------#-------#--------##---#-###----#--#---#---#-----#---##------#---##--#----#
---##--##-##---#-----##-#-##-#-#---------#-------#--#-----#--------##-##--###-#-#-----------#---#--#
#-##-------#---##-#--##--#---#--------#---##-#-#---#--#------#-#------###---#----##------##-#--#--##
--#--#------#-------#---##----#----#-----#--#----#-----#---#-#----#-----#-----##-#-----##---##-#-###
##-------##-#---#----#-##-----#---#---##----##-#----#--#-----##----#--#---#-#------####--------#---#
-##---##------##--#--####-------#---#-----------##---##---#---#--#----#-------####-##-##-#####--#-#-
-#---#--------######-#-----#------#--------#-###--#-------###-----##-#--##--#------##-#-##----#-----
-#-##---###--#---#-#-#---###-#---###-#---##---#--#---#--#--#-#-###-#-----#----##----#---#---##---##-
------#-#-----#--#-#-##----#--#------###---#####-#-----------------#---#---##--#-------##--#-#------
--##--#-------------#----##---------#---#####----#----#-#--#--------#----#----##-#-#----#-----#---##
#---##-#-#----#---##-----#-------#--#-----------###-#--------#####-------#-####-##---##---##-#------
----##--#--#-##------#-------##-#----#--#-----#-#----#-###-----#-------#-----#---#-#---#--##-#--#---
-#-#--#--###--#-----#-----#--####--------------#-----###---#----------#--------#-----##-##------#---
----------#--#--#---#-#-----#-#-#----#---#-##-#-#----#----#-#-#----##--------##--#--##--------------
#####----#-------#-##--#-------#------------#-#---##-#-----###----###-##--#-#------##------#-##----#
---#---##--#-#---##-###-#--#-----##-#--#----#-###--------------#-#--##-#---#-----##----#----#--#--#-
------##---##-----##-#-#-#------#----###-------#--#----#--------#--#-#---#------#----#-------#-----#
-#---------#---#-#-----#--#-##---------####-#------------##-####-#---###-#-##----#----#-##-----#---#
---------#--------------##-##-#----#--#--#----------------#------#-#----##----#--#---------##---#--#
##-----##---##-##--#------------##---#-#-###----##-----#-----###-----###-#-#--#----#--###--#-----#--
#-#-----##--#----###---#----#--##-###------------#--#-##--#-#--#-#----------------#--------#-------#
-#-#---#--#----##-------#-----##-#----#---#-#------#--#--#-##---#-#--------------##-#-###-##-#####--
-#-#---#-------#-#-###--##---##--#-#--##-----#-----#--#------#-###----#-##-----#-#-##-#-------###---
---#--#----###--##---#-----##-----#-#-----#---#-##------#-#---#--#--#----#--------#-#---#-#-##------
---#-#-#---##-#---##-#-#----#--#-----####-----------#--#-#---####--#-#-#--#------#---#---#----##----
#--#-#-#----#--#-#####-#-----#--------###--###----##-----#--##--#-#--#---#-#----------------#-#---##
----#------#----------#---##------#---#----#----##------#---#--#----#-------####--###----##-#-----#-
--------#-#-#-##---#---#------#-#------#-#-#-#--#-###-#-#-##------###-#-#-----#---##-#-#-#--#---#-##
------#-#-##------##------##-#----#--#--#--###---------------#--------#----#-----#-##-###---#----#-#
-----#---#--###----#-#--#----#--#--------##---------#----#-#---##-----#---#####----#-#--#-#---#--##-
##-##---#----------#--#----#---##-----#--##--#---#--#-#---###---####-#-#----#---#-----#---#---------
-#---#-#---##-#-----#-#----#--#-#--#-#-#-------------#---------#--#-----#-------#-##---#----#-----##
----#---#-###--#-#--#-###-#-#-------##----##--####---##------#-----#-##------##-----#-------#---#-#-
#---##--#--###---##---##--##---#-##--#--##-------#-#---##---------#-##-----#----#-#-#---##-----#-#--
--##-#-----##--------#--#-------#--#-#--------###--#---#------#-##--#------####-#--#----#--#------#-
--------#--#-#------##-##-##-#---#-#------#-#----#------------#--#---#-------#-##-##--#-----#-###--#
----------#-----#--#--#-#-#---#-----##--#-----#--------###---##-#---------#--#--##---#-#-##---##--#-
----#----#---#--##---#--#-##-##---###---#---#-#--------#-###---#---------#------#-#---#--#----------
----#-#--#-#-##--###---#-----##-#--##-----------#--#---#---#--#--#-#-##-------##--#-----#--------#--
-#----#--#--#----####-#----#-------#--###-#-#-###---#--#--#--####----#----##-#--#------#--#---------
-----#---#-----#-#-#----#---#--#-----------#---#-#-----#-####---#-#-#----#-#-#-##-##------#--###-###
------#--###--#--#--##--#---#-#----##-----#-##-##----#---#----------#----##--#----##-------#----#---
#---#--------------#--#--##---#-----#------#---#-#-#--#----#---#---#-##--###------#-------#---#-###-
--###-#-----#------###---##--------#--#--#---##-----#----##----##-##--#---##-#-----#--##----#-------
#--##-#----#--#-#--#----#------###----##--------#-#------###---##----#------#--------###-#--#--#----
#---##---##---#-##--#--#--##----#----#-----##----#---######---------##--#------##-#---#-#-----#-#---
--#-----#-##-----##-##-#--##-#--##-#--##--------#----##----#-#-#-#--##-----#-##--###----#-----##----
---#---#---------#-----#-#--#-#--#---------#--##---------##-----###-#-##----####-##----##-##------##
-#--###---#---#----#--#----#-----#-#--#---##-#--#------------#-#--#-------#--##----##--#-#-#---#----
##-#---#------##---##-----##-#--#--#---###-------##--##----#####-------###-##----#-----##-###--#-#-#
-#---###-##-#-----#-#--------#-#--##--#---#------##----#----##-#------#----#---#--#---#-------------
--#--#--##----#-##---#--##----###---E#-##-#-#--#------------##------#---#--------##-##-#---#--#-#---
#-----###-#--#-----####--#-##-------#--###----#---#-----##----------#--#--#--#-----#---####---------
---####-##---#----#---##-##--##-#-#-------#----#--##----#-----#--##-#-##-#----#--#--#---#---------##
-------#----#--##-#----#-#####------#--#----##-----------##--#-------###---------#-#-#--####--#-----
-###---#--------##-#-----#---#-#-------###-#-----#--------#---#----------#--#-------##-#-#-#----#---
##-#-#--#------#-##--##---##-##-##-##-##-#------##----------#----###---##---#-#------##------------#
--##---##---#--##------------##--#--#--##-----------#-##--------#-#---#-------#-----#--#--#--##----#
---#---#-##------#----#------#-----#-#-#------###-------#-#--#-##--#-----#------#----#--------##----
#-----#-#-#-#-------#-##---#---#--##------#----##-#--##-#--#--#---#----#--#-#---#---##--##-#-#-#--#-
----##-------------------#---##-#---#--#---#----#-##---#---------######------#---#-#----###---#---#-
#--#---####-##---##----#---#---#-----##-#-##----#-#----------#--####--#----###-#-#--#----#--#-#--###
--###--#------------#---------------#-#-----------------#--##----#-#-##----------#-#----#---#---#---
##-#-----#-----#----------#-#----#-#-----#---##-#-#--##--###-#-##-#--------####-------##----#----#--
##-----#-----#---#------#----##---#----------#---#-#-----#-#--#---###----###-----#--#--#--#-#--#-###
##--------#-#----#--#--#-------------#----#--#-#--#-----#--##------#--####----#-##------##------#-#-
--------#--#--######--##-#-----------##-----##--#---#-----##---##--#----#----#-#--#------#----##---#
--###-#------------------#----#-##-#-#--#-#------#--##--#-#----#---#-----#----#---#-------#------#--
#--#----#--#-#-#-#--#-----##--#--#--####--##--#-#--#-#---#-------#----#------###--#--##----###--##--
--------##-#--#-#-#--#----##-----#---#-----####-#-#-#-------#-----###---#--##------#---#---##--##-#-
--#-------###-##--#--#-#---#-#-#----###--###-----------#--------#-#------#-#--###---#-#-#----------#
---#-##-#-#-#--#--#-#--#-#-#--###-#---#---#--#-#---------#---#----#---#----#-####--#--------#-#-----
-----#----#----#-#--#--#-#---#--#-##-#-####----#-#-------#--#--#-#--#-#-#---#--#-#---#-##-------#--#
------#--#-##-#------------#-------#----##--#-#-#-##-#---#---#---##---#--------#---#---#---#------#-
--#--#-#-----#---##--#---##--#-#--#---#-#-###----#-------#---#--##----##S#-###-#-#-------###--##-#--
-----------#-#------------#---#---#--------#-##----####--#--##----##-#---##-#-##-##--##-###-#--#---#
#--#-#----#-##--#-#---###-#--##----#--------#---###---#-----#------#-----##--##-#-#-#-##----#--#-##-
-------##-#-#--#---#-#-----##---#-#---#-#---#-------------#---#---#--#----#-#---#---#--##--------###
-#------#------####---#---#----#----#--#-----##-##----#--#-##-#--#---#-##----##-----#-------#-------
-###----#-##---#--#--#--#--#----#####---#--###-##----##----#-#--------##-#-##--##----#----#-###-----
--#-------##------#--------------#----#-----###-#-##-#-#---------##-----#-----------##--------#--#--
-------##--#-#--------#-##--##--------------------#-#--#------##--#--#-##------------#--#-#--#------
#-#--#--##----##--------#--###-#--#-------#-#-#--#--------#-#-#----#-#-#--#---#--#--#----#--------#-
--------#--#-----#-##-----#-##-##-#--#-#-#---##--###-#----#-#--------#-#----------##-------#--------
##-#------#---#----#--#-#-##--------#--#---#--------#-#--------#-###--##----#-#---#-##----##--#--#--
---###-----------#-#----#---##--###---#-#-#--#####-#-------#-------#-#-----------#-----#----#---#-##
#-###----#-#----##------------#-#-##---#----#--#-------#--##-#--##-----#------#----##--#-#---#------
###--#----#------#-##-##---------#--######---#--------#--#--#---#----###-#------------##-----##-#---
------#--------#-##-#-#--##-#-----##-----#----#----------#------#--#-##----#-#-----#---#----##-----#
--##-##--#-------#-----#--###----------####-#----##------#--##----------#----#--------#-------------
#--##-##-----#-#--#------#-----#--#-#---------###--#---####-##--#---#-----##-#-----#----##----#-#---
---#---#---##-#---#-----###--#---#-#----##--------##-#####----#--#----#--#--#---###-##--#-#----##---