?diagonal=Never;
----#------#--#----#-#--#--#--#-#-###-#--#----#------#--#-----#--#------##--#--#---------##-----#---
-#--##-##-------##---##-----#-#--#-----#-#-##-#-#---#-#-#------#---##-----#--#-----##-#-----##-#----
#--###----##--#------#--------#-####-----##-----#----#--#-#--#------#-#-##----------#----##--#------
--#--#--#-#-----#---#-------------###-#---##----#---#--#-----##---###--#-#--------#--#--##-----##-#-
#-#----#-#---#--#------#----#--#----#---------#--#-###-#--------####--#-##-#-##--------#------------
--###------#-----###-------------------#--#--#--###----#---##-##-#----------#--#-#--------#---#--#--
-##----------#-----#-#-#-#-----#-------##---------###-----#----##----#--#----#-#-#--#--------------#
#-#-----#-#-#---##-----##--#-###--####---#--#-##----#--##---#------------------###---#---#-#--#----#
--#-----###----#-#-###-----#----#-----#-#--#-#----##---#-#---#--#---#---##-----##------#-#--------#-
------#-#-------##-###--#-#---#---------#-----#-#-------#---#---#-----#----###-#--##-#------#-#-#---
-#----#---#--###------------#-##-#-#####-#-##---#-#-###--#-------#----#-#-----#----##--#--#-#-#---#-
---#-##------------------#------------#-##---##--##-#-###----#-#---##--#----#--#-#----#---#--#----#-
---#------#------#-#--#----##--###--#-----#------------#-#-#---##-------##-#-#-#---##-------#-----##
####--#-#----#-----#-#----#-#-##--#-#----##---##-#-#-----------#-----#---####-------#---#--#--#-#-#-
---#----#--#-#-#-#------#--##-#-#-------#---##-#----##-----#--#-----##-#------#-###--#--#-----#-#---
--#-#---###---#-----#-----#-######--#-#--#--#---#-#------##--#-----------#-#---#--#-----#-#-##-----#
##----#---#-----#-#---#-#----##--#--#--------#-----#-#-#--#--#-##--------#-------------#-#---------#
--#---#--#-----#-----#----#--#--------#--#-----#--###-----#--#--##-#--##-#-##-------#-#----#-#-##--#
#-----#--#-#----##--##-##------#--------#-#-#-##--#----#------#-####--#-#--#---#-#--#-#--#-#-#--##--
-#----#-#-----#---#----#---#----##--#-#--#-##-#--#--#-----#-----#-----##--##---#----#-#---#-#-##----
#####--##-#--#---#-----#---#--##--#-#-#----#---#---#----#----#------#-#---#------##-#---#-##-#------
#-#--------#-----#--###-------##-#-#---#--#--#---####-------#----#------#-#--##-#-#----##----##---#-
------###-#-----##--------#####--##--#------#--#---#-#----#-#--##--------#-##--######---##-#----#---
#-#---#--#-##-----#---#-#---##------#--##---#------#--#-#-----###-#--#----#-#--#--#-----#-----#----#
##--#-##---#-#--#-##------------#--#####----##-----#--------##------#####--###----##-------#--###-#-
---###-#-----#--###---#------#-#--#-----#--------------###-#-#----#---#------------#-#---#-#---#----
-#--#-#-#-##---------#------#-----#---##----#-#--#-#---##-----#---#-#----#------##------#-##-#-----#
#--####-----#-----###------#-#---######-----#--#--#-#-----------#----#----------#--#----##----#--#--
-#--#-----------#---##--------#------##----#-----#---#--##-----##-----#------#-#-#-#---#-#---##----#
#----#----##------#---------#-------##--#--------#-#---#---#-##-#-#-#---#--###-####-##------#--#-#--
--#---##----###----#--#------#--#--#------#--#----#--##---#----#---#--#--#------#-#-------#--##---#-
#--------#-##-----#-----##-#----#--###-----#-#---#------#------###----#--#-----##-----#----#----#---
----#------#-#-###-----#---##----#-----#--#---#-------#----#---#--#----##--##-#--#----#-----##------
----#-------#---#--#-#---#-----#--##----#---------###-##---###----#---------------#-#-#-#--#-----##-
#---##-##---#-----#-----#--------#--##--#--#-#-#-------#--#-------#---#--#----#-#--#------##--#--#--
##---#----#------#----#---#---#--#----#-----------#-##-#-##------#-----#-#-----#-------#--#-#-#####-
--##-####-#----#-#-#-##----------#--#---#------##----###---##---##----##-#---#-#--------#-#-#--#-##-
##-#--##----------#---####--------######-###--#---------#------##----####-##---#-#---#-#-##-#---#---
#-#--#---#----#-----#----##-------#----#-----#------#-----#-----#-##----#-#------#--#-#-#-#---#-----
#-#-----#---#-#-#-#------#--#---#---#-----#-#--###--#-#----##----#---#---#----##-#-----##--#---#----
-------#-------#-----###-##-##--#---##-#-##-#---#----#-------#-#----#------#-----#--------#-#-----##
-####--###---#------##------#---####-#----#--#-----#-##----#-#-##--#--#-------##---#--##-###-#-###-#
-#-#####--#--#----##--#----#-#---#--------#--#-#---#--####----#-----##-#--#####-----##---#----------
#--#-#-#------#-------#-#--#---#--#--#----#-------#--#--#--###---##---#-#--#------#---#---------##--
#--#--####--#-----#--#--#--------##-#-#----#----#---#-#-------#--#--#------#---#-#-#-##-#-----#--#-#
#----#----#-#--#--#-#####-#-----##-----##----#-----#----##----#-##-##---#-----#---##----###----##---
---###-----##--#-#----#-----#---#----#--#---#-#-#---#----------####---#-----#-#------#-##---###--##-
-----#-#--#--#------#--##-#---#-#--#-#-------#-#---#--#------------#-------#----#--#-##---##-----#--
#---####-#---###-###------#-#-###---##------#----##--###-----###------##-#----#---------#-#-#-------
#-#-##------##-#-##--#-#---#--#----#--#-#---#----#----#--##--#-#--#----#---------##---#-#--#-#------
---#--##------#-#------#----#-----#---#-----##-#-#--#--#-#--###-------#---#--#--#--------#-#-#-#---#
--#--------###---##-#---#----##-----##-------#---#------####-#---------##--------#--#--##-------#-##
##------#-##--###----#---#--#----###----#------##-#-#------##--#---#---#--#-####--#--#-###-----##--#
-#--##--#--#---#---#--#-##-##-#------#-##----#-#--------#-#-###----#-#--------#-#-#-------#---#-##--
###-#-#-----#-#-------------##----#--##-###---#-##-###-#-##--#-----#---------#-#-----#------#------#
-#-----#----##-------#---#---#-----###--#-##-#-#-#-#----#---##--#-------###--#-----###-#-#--------#-
-----#-------##-#-#-#-##-----###--#------#-------------#-------#--#---#--------------#-----#----##--
--#-#-#---#-##-##--##---##-----##------##----#--#----#--#------#-#---#-##-----#---##------#----#-##-
--#-#---#-----#--##-#--#--#-#-#----#-##-#----##--#---#-##------####----##-----##--#-----##--#-#-#--#
-----###--#--#--#--##-------#---##------#-------#------------------#-#-###-###--#-#-#------------##-
----##---#---#-##--#--#------#--#-#-#---#--#---##---##--##---#--##---------------#------#-#-------#-
-##--------------##------##-#---##---##--##--##----#------##--#---##-##---------#---#-------#---#---
---------#----#-##----------##-#--##--##-#------#--##-###--###------##------#---##--#-----#---------
--#---#----#-#---#---#-#-#-#--#------#-#-#----#------##-#--#----------#--#--#--#---------#--#-------
#---#--###---#-#--#---#--##--##----#-#----#----##---------#----##--#--#-----#-#-#--------#--#--###-#
------##-###--##-----##----#---#-##------#----##-#-###---#-----#-#-###-#-#------###---#-------------
#-###---#-----#--#-#----##--#--------#--#-#-----#----#----------##-#-#------------#----------------#
-#-#-------#-##-##----#----#-----#--#---#--------#---#--#-#----#--##-##-----#-#--#----#--#---#--#---
--#---------------#-----####-#----#-##-##---#----#-##--##--###----#--###------#-##--#-###------##---
----#--#-#-#-------##--###--------###----#-------#-##--##-#----##-#----##----#-#---#-#--#--#--#--#--
----#---#-#---#------##--##---#---#----##-------#----##-#----#--#--#-##--#---##--------#---#----###-
#-#---#-#---#-----#-----##-#-#--#---#-#-#-----##----#-#----#--#------#-###-###---#----#--#--#----##-
---------#--#----#-#----#---#-#---------#---#--#-##-##-###---#--#-#-#----#-----##---#----#-----#----
###--###--#-##-------##-####---#-##----#-----##---------##--#---#----#----###-#--#-----#---#-----#--
-#-###---##---#--###--##---------#---##-#-#-##----##--##-#---#--##-#---#-#-#-#---#-##--#--#---------
#---#--#---##----#--#-##--###E------##---#--#----#--##----##-----#---#-#-#-##-------------#-#-#-----
----##------#-----#-#--#-###----#-----##---#-------#------#--#--##--##-##--#---###-#-----------###-#
#----#-#------#------#-----#-#---#--##-#--#-#-#-------#--#--#-#-#-#---#--#---#--#-----#--#---#------
#-----#-----#-#-------------------##-#-------####-##---#--#-#--###-#-----###--#----###--###------#--
-#--#--####---####-#-#---#----#-##-----#-#-#---#-----####--#-#----#-----#-#-------#-###--###-#-#----
#-----###------##-------##---#-----------##-----#--#--#-#-#-------#---#---##-#---#-#---#-----#------
-#-#----#--#-----------#--#-----#--------#---#-------##-#--#####-----#-#--#-##--##----#----#-#---#--
#-#-##-#--#--------#-------#-####----#--#------###---#-#--------##---######--##-#---##-#----------#-
-----------#--#---#----------#--#-----#--#####---------##---#--##-#----#--#-------#----##-####--#-#-
-#----#-------#----##-#-#-###-#-#----##---#-###---#--#-------------#----#-#-#-#-#-##--#--###-#--##--
#--#-------#-#-#-#-----#-#-----#----#-##--##------#--#-#--#-##-#-------###-##--#---##--#-#---#------
---##-#-#----#--#--###---#-------------#--#---##--#----##--###---#-#--#-#---####--------##------#---
--#------#--#--#----###-#--#------#-------##-####-#-----#-##---#--------------#--#-#--#-###------#--
#--#-#--##---#-#-#--#----#--#---#--##---#-#--#--#---#-##-#------#-#-##---------#--###----#---#-##---
#-----#--#--#--#--------#-###-#--#-###-#---#--#-----#----#-----------#----#-----#-#-#-------###-#--#
--#--#--------#---#--#---###---#-----###----#---##---##---#--#---#----------#-#---##-#-#-----#-#--#-
--#-----###--#-#-#----#----##-#-#-##-#--####-#-#-###---#---###---------##------#-#----------------#-
--#--#-#------##--#--#---#--##-##-#--#-#-##----##--#---##-#----##----#-##--#---#-#--#-#----#----#---
-#--#-----##---##-##-------#--##------##--#--#-------#----#--#-------------#--------#-------###-#-#-
------------#--#--#-----------#----#-###--#--#---##---#--##----#---#------##-#----#---#----------##-
-#-#-----##-#-#-###---#--#--#--#---#--#--#--###---#------#-----#--####----#-----#-#####----------#--
-#---##-#-#-###--#---#--#--#----##---#---------##-#---#-----##--#---##--#-#-#---###---#-#-#-------##
##-####--##------#--##------#---##-###----------#---##---#-#-#--##-----#----##---------#--#-##---#--
#---###----#---##---#----#-----#--#-#----#---#---#-#-#--------#---#-##------------##-##-----#-#--##-
##-S###---------#-----##-####--------#-----##---##--------#----##------#---##---------#--##----#--#-