?diagonal=Never;
----#----#--#----#--#-##-#---#----####----#-#--#-###---#--#-#-#--#---#--#------#---#--####--#--#----
#---------#####--##-#--#----#-#-#--#------#-#-#-###----#-#-------#----#-###----#---#-#-#------#-----
-------#--#----#-#--#-----#-#-##-#----##-#--#-#-##--##----#-###------##-------#----#-#-----#-###----
#--##---#-###---#-#-#----#-#-#----#-#-###--#---#-#--------##--###-#-#-------------#--#-----------#-#
#-#-#--#-##-#-#-----#-----##-#--#----------##--#-#--------##------------#--#---------#-#--#-##----#-
-------#---#---#--#-#-----#-###----#--#---##-##-#--###-#----#####-####------#-#--#---#-------##-----
#-#-####--------#-----#####------#----#-----#-----#-----###---#------###--#-#-##--#----##----#----#-
-#------#--#-#-#--#--#-###---#--##-----##----##---##-###--###--##--###--#-#---##-#----#--#----#--##-
-#---##--#-----#--#-------#-#----#---#--#------#----#-----##------#-#--###-#-----##---#--#---#--####
#--##--#-#---######---#-----#-#---##-#--#----#----------##--#----------#---###----#-----#--##-#-----
-#-####-###---##-------##---#---------#-##---#------------#----##---#---#---#-#-------###--------#--
--#-#-----------------#-------##--------#--##--##-#--#----------##-##------#---------#---#--#--#----
##----#-------#---##------------#--#-----#-#-#-#--##---##--#-##--#-#--##----##-#--#---##---#--------
----#-###---#--#----------###---#--#--#--#----------#--#-------###--#-#--#----###-------#--#----#---
-----##---##-#--##---#--##------#----#--#----###--#---#---######--#------#-##-#---##---------------#
-#---------##-#---#---##--#---###------#---#---#-#-#-----###---#----------#---#--#-##----#--#####---
#--#-#----##--##-----#----#-##--#-##----#-##-----###--#####-#-#--#-#-----##--##--------#----#---#---
#-#----#---------------#-#---#----#--#------------#---#--#-#---#--#----##---#-----##-##-#-##-----#-#
-----##-#--#--##------#----#------#-#----#------#------------#----#--##-#-#----#-----#----#-##---#--
-#---#-#--------#--###-##---#------#-##---#----#---#---#---##--#-##-##-##---#-#----#-#-#-#-----#---#
--###------------#-#---#---#-#-#---#---------#--#--#--#-#--------------------##-#-#---##------#--##-
-#--##--#---#--#--#---#--#----#---#-#---------------#-#--#-#--#---#--#----###----#-#----#-#----##-#-
-----#-###---#--#-###-----#--#--##-#--#---#-------#-##---#---##----#--#-#-#--#----##-#---#--####-#--
----##--#-#-#--##-#---#-##--#----------#--#####-###-#---#--------#--#-###--##--#------#------#------
--#------#----#--#-#-#-##--#-#----#------#----#-#--##----##-#-#-#--##-#-----###--#--#-------#----##-
---#-#------##--#--##----##-##-##-#-----#-----------#--#--#------#-----###-----##--###-----#-#---#--
#----#---#--#--#---#-#--#----#--#----#-#------------------###---###----###-#--#---#-##----#-----#-##
-------#---#--#-----#-####-------##------#--#----#--##---#-----#---#--#------##---###--#-#----------
----------#-###--#-----#-#-----#------#--###------##--------------------###--#----#----###----------
-----#---#-###------##-#-----#--##-#-#---#-------#---##--#--#-##---##-#-----#-##---------##----#-#--
-##-----#-----#--##--------#------#---#--#--#----#----#-#---#---####-------#-------#--##-#-#--------
--------#--###-#--#-#-----#-#-#-----#--###-----#---#---###-##-------------#-----#-------##---#----#-
#---#---#--#-#-##-#----#--###--#------------#--#-##-----#----------#---#-----#--#------#---#-----#--
--------#----#-#--#--#-#--------###-#-----#------#-#-#----#----##-###--#------#-##--------#-##--#-#-
--#-----##-#---------##-#----#-###-##---#--#---#-#-##----#-##--#-#--#-#--#-----------------#----#---
-###---#-----------##--#--#--###------#----#--##-#------#--#-###-------##--#---##--#--#---------#--#
#-------#-#---#----#-----#-----##-#-#-#---------------#---#-----###-#----------#-----#------##-----#
---#----#--##-#------##-#-#---------#-----#--#----------#---#-#-#-#--##---#-#------#------#--#---#--
--------##---#--#-----#------###-#--#-#----##-----##---#---------#--#---##--#--#---#-#-#--#---#--#-#
#---#---#----####---##-##-#---#-----#---###--##-###-##------###--#----#--###------##-##--#-#---##--#
###-##-#-##--###--###----#---#-#-#--##----#---#------##------#---------##----#-------#--#-##--#-----
-------#----###-#---#--####---#--#-#-#-#----#-#---#--#-##-#-----------#-#---##-----#---#---##----#-S
--#---#-#-#-##-------#--##--#-##---##------#-###------#----##-#----#-#--##--------#-#-##-#----------
#--##--#####----##--#--#--#---#--#------#---##----###-#-####---#-#--##-----#---#-#---#-----#---#---#
-#--#--#-----#----##-#-#-#----##----##-###------#---#-#--------#--#----#-#--#---#--#--#--##-#--#-#--
----#--#-#-----------#-#----#--#-------#-#-#-##------#--#-----###---#-#------#--##---#--#--##-#--##-
-##------#---#-------###-##--#-#-#-----------##---#----------------##-----------#---#-#--#-#--------
#--#--------#----#----#-------#####-----#-#-#-------#-----#-#---#--#--#----#--#-##--##----#-----#-#-
##-------#------##--#--#------##---------#--##--#-----#--------###----###----#-#-#--------#-------#-
#---------##-#--#--#----#--#----#-----#----#------#------##------#---#--------#--------##------#--##
---#-#---#--#--#--##-#---------------------#--#--#--#-----#-#--#--#--##-#-----##---#---###-##-------
#----#----#-------#-----------------------#---------#-#------#--##--##-#-------#-#-----###--#-###--#
--###-#----#---#-#---#------------#----#--#--#------#-#--#--#-##-#####------#---#--#-##-##-#---##-##
----#--##--#-#-----------#---#--#-----#-####-##-#-#-----#--#-##-#-------#-----#------##-------####--
#-#-------#-E--#----#--#----#--#-------#-##-#-------------###------#-#--#-#------#-------#-#---#----
--#---##-------#--#--#--#---#-#-#-##--#-------#--#----#-#-#---#----##---#####----##-#-##----#------#
----------#---#-#-##--#--##--#-#------#-------#-------##--##-----###-------#-----#-#----###-----#-#-
#-------------------#-----#------##--------#--#---#--##--#--#####------------#-#-----#-------##-##-#
-#---#--------#-#--------#--#-#--#-###--###---#----#---#-----#-----##-#-------#----#---###-#---#-##-
##--##--##-----#---#----##---#----#-----#-----##--##---#-#-#---#-###-----#-##-#-------###-----##-##-
----#---#----#-#-##-##---#-#-----------##------###--##-#-----#-##-#-#-##--#---##--#-#-#-#------###-#
----##-#-----#-#-#----###----#--##-##----#--#-----##-----##--##----####-------###-##-----###--#-###-
--##-#-####----#--#-----#--------------#----#---###-----##---#-----###-----------#-#####-#----##----
#--###---##---#---##-#----###---#------##--#-#--#----------#---#-----#-#------#------#-----#-#---#--
--##--#-#---------####---#-------#----#---#-#--#-#------#-#---#-#----#-#------##-----#-###------#-#-
###--------#---------#-##-#----##-#--#--#--#-#--##---#-#--###-----#--#--#--#-####--#--#-#--#-----#--
--##--####---##----#---##----#---##--------#-----#-###-------------#--#--##--#---#--#-##--------##--
#-##---#------#-#----------------##-#---#-##---#---##----#--#----#-----#--#-#----------#--#-#---#--#
--#-#-##-----##-------#-#-----#----#-------#-#--#-----#--#####---#----#--#---#-----##----##---#---#-
-----#--##---#-#-#----------#--#-##-#-----##--------#--###-----#--------#---------------###----#---#
---##----###----#-#-##------##----#---#----#-#---#---#-------#--#-----#--#----------#-#--##-#-##--#-
-----###--#--###-#------------##--#--##-####-#-#------#-#---###-#-##---##----#--#--------#-----#---#
##-----#-------#-#---##-------------#------#--------#----#-#---##-#--####---##---#---##------#--##--
----------#-#---#----#-#-#---#----#------##-#---####--#-#-#-###-----##--#---------#-#----------#---#
#---#--###-##-#---##-------#---#--#-----#--#------------------------#-#------###-#--#---###-----#-##
#-#--#-----#-#------####-#-#---#------####--#-----#--#-#--------###--#-##--###--#--#--#-#------#--#-
--##----##-#---#----#-----#-#-----##--#------------#-------#----##--#-###--#-#--##-#--#---##--#-----
#-#---------------#-##--##-------##-----#-------#-----#----------#-----#------#----###---###--#-#-#-
---##--#--#--#---#-----###-#--#---#-----###-##-#-#---#---#-##----###-----#-#-#--#---------#---#--#--
-##---###--#-#--#-#-#--#---#-#--#-##--##--#---#----###-----------##-#-####-#-#---#-#---##--#---###--
#-----#####-#-----#--#-##--#-#--#-#------#-----#--##---#------###---#------#---#-##--#-----#-#-----#
####----#-#---#------#--------#--#-##-#--#-#-#-#####----#----#----#--#---#-------#--#--#-----#---#--
---#-#----#---------#---#-----#-##-------#-----###-----###-###--##----#-----###-#-------#-----------
-#----##----#----#----#------#-##---#--##-#--#-###----------#-----##--#------#------##-#-----##-----
-##--#-#--#-----##-##--#---------#----#--###--#-----##-#---#-##-----#-#-#-#--#----##-####--##-----#-
----##--#--###-#---#--#----#-###---------#--##---#-#-#-----#---###---##-#---##-#---#-#--#-###---##--
-#----##----##-##---#---#-##-##-#-#-#------#---#-#--------#-#-#-#----#-#-#--###--#------#-#-------##
-------#---------##--#--##-#-#--#--#--------#-###--#-###-#-#--#-##--#---##----##-------#---#--#-----
----##---##-----##------#-#-#----#--#--#---#-#-##-##--#--#-##-----#----#-----#------#--#----#--#----
#-#####-#-----###-##--#--#-----#-------#---##-#--#--#-##-#--#-#---##-#--#-#------##---#---#----##-#-
#--------#-#--##---##--#--#-#-----#----#-----#--##----##-#----------##--#--#---##-#---#--#-----##-#-
------#-####------#---#------#--#------##-----#-##-#---------#-#-##-#-#-----#----#--#####---##-#-#-#
##----##------#-#-#-----#---#-##---#--#--##-#--------------#----##-#----#--##---#--#-----###--#--#--
--#---#--#-#-##-##-----##-#---##-----#--#-#-#--##----#-##---#-#-------#--##--##-----###----###---#--
--##-#---#-##---##----##--##--#-#---------#---##--------------###----#-#-####--#--------##-#------#-
#----------#-#-##-#--##--#-----#--------#----#--------#-#--#----------##-####----##----------------#
#--#------#------##-#---##-------#-##--####--#-------------#-------------#--#---##-----##---#-------
#-----#-##-------#--##----##-###-#-###-#-###--#-------###-#--#--#-##--#------#----#---####--##-#--#-
--------#---#--#--#-----##--####--#---------#---#---##-#-#--##--#--#------------#-----#-----##--#---
--#-#----------###--#---#-#----#-#-##---##-#----#-#-------------#-##-#--------##---#-#---------#---#