?diagonal=Never;
-----#----#-------#------#---#-#-#-##------#---#--------#--##----------#-#-----#--#--------------#-#
-#-----#----##------#---#-#--###-#--##------#------#---#-#------#--#----#---#-##--#--###--#----#-#-#
-#-----------------#-#----------#---##-#------#-##---#--#-----#----##--#-#-#--##--#-#---##------#--#
--#-##---####-------#-#-#--#----#-###------------#--------#----##----------#-#-##----#--##-#-##----#
--#-#--#--#----#-#------#--#-#-#---##--#--------------#------##--#--#-------####--##-#-##-##----#---
-#-##-#-#-#--#----#----------#-#---------#-##-#------##-##-#----#----#--#-----##-#---#-----##--#----
#--#----##-#-#------#---#--#-#------####--#---#--#-#-#-##--##-------#-----#-###--------#-----##-----
---#-#####--#-###-#-###--#---#----###--#----#-##----##-#---##--#-#--#--##---##-##-##-#----#---#-----
-------------##----##--#--------#---##-#----#-------#----#-------##-----#-#--##----##-#---#-#-#---#-
---#---#####----#-----###-#------#--#-###-#---####------#---##------------#----#----#---#---#-####--
##-#-------##-##-##-----###-----##---#-#-###----#-#-#-----------##---------#--##-#-----#--###--##-#-
#-------##-----#--##-#-###--##--##---##----------#-#---###-#--#---##-S--#------#---#--##--#---------
--#-#-#---#-#-----##----#-------#-#--#-##--#-----#----#----##---#----##-#-#-#--#----#---##--#-#-#--#
----#------#-----------##-#-##-#-###---##---#-----###--##--------##----------#-#--##-##---##-#--#---
###-----##-#----#-####-#--##-----#-------#-##---#-#--#--#-#-#---#---#---#---##--#-#--#---------#-#--
--#-#--#-#--#--#-#--#-----------#-----##---##---#--#----#--------------#-###-#-###---##----#------##
---###-#-#-#####--------##--#-----#--#------#---##----#----#--##-#------##--#---##-----#----#------#
##--#-##------------#------------#-##-----------##-#-##-----#-#-##--#---------#---#--##--#--#--##--#
-#-#--#---#-##----##-#----#--#--------##-###-#---##--#-----------#--#-----------#---#-----##--##--##
------##---#---#----#-#--#-#-#-----###------#-----#-##----#---#---##---#----###-#-#---#-#-###---#---
--##---#--##-#--#-#----#-##-----#--#--###----#--#-------------#--#-#-------#--#------#-#-#----#-----
#----#--#------------#-#-------#----#-##------#-----####-#-###--#--#-#---###------##------#-#---#--#
#------#-#-----#--#-##-----#----#--#--##-#-#-#---####----#--#---#-##---------##-#-#-------###--#--#-
-#-#-##--#-#--##-#-----#-##-----#--#-#--###----##---#--#-##-##---#-----#-------#-##-#-----###-#---#-
----#--#---#---#---#--##-#----#-##---#---#-----####--#--##--####----##--#-##-#--##---#-#------------
--------##-###-----#-#-#------------##-#-----#--#---------##---#----#-#-#-##--#---##---#--#---------
-##--#-#-#-----##------##--#----#-#-#-#----#---#-#-#-#----------#-##---------#-##---#---#-----##-#-#
-------#-#-##-----------#-----#------#-#--###---##---##---------#-###-------------#--#-#-#--#--#--#-
-#-----##--##---#####-##--#--------#--#-###-#--------#----##-#-------------#-##--#--#---#----#-#---#
#--#---#-#-----#-#-##----#-###----#-#----##-------#---#####--#--###---#--------#----#--#-------##---
##--#------E-###-#---#----#----###-#-#----------###-------#---#-#--#-#--#-###-#---###-##--#-##---#-#
-#-#-#------#-----#----###--####-#-#-----#----#------#--#-#-###-#----##-------#######-#-------------
#-------#---------##-####---#---#---#-#----#----##-#--#----#------#-#---#----##---------#-##-------#
##-------#------------#------##--#----#---#-----#----#-----------#-##---#--#---#---#----------#----#
##-#----------#---#------#---#-#####------##----#--###-#---#-##-#---#---------#---#-#-------#--#--#-
-----#----##-#-#-----#-#----#---####---#---#--#---#--------#-#---#-#-#--###---#---#-#-------#--##---
-###----#---#---##-#-#--------##-#---#------##-###---------#-----#-##-------#--##--#----#--#-#----#-
---###-#-#--#---#-###--#---#--##------#-#-###------##----#-------#-----##-----##--#-#-------#-----##
#----#---#--#---#-#-###-#---##------##--####--------###-------#---#--#---------#---------#----------
--##--##-#----##--#----#-----#------#--#-----#---#--#---#-##-#-----#-#-#-#--##--#---#---#--------##-
--#---#--#--------##-##----#------##---------###----#-#---#-#-----------#-#-------#-#-------#-##----
--###-#---#---#--##--##--#--#--#------##---#-----------#-#-----#---#--#-#-##--#---#-#-#--#--------#-
#---#----------##-#-------#-#-#-#-##---#--#-----#-#--#---------------#--#---####-#-##--#-#--#---#---
-----#-#----#-######--#-----#--#-#--##-#-#--#---#####-##-#--#-#---------#------------------##--##---
---#------##-#-#------#-#--#---#-------#-##--##-----#--#--#--#----##--#-#---##---#-#-#-----------##-
#-#-#-#------#-----#------#-##--------##---#-#----###--##-----#-----#---------##---#----##--#--##-#-
---#------###---##-##------#--#-----#--##-##-----####-#---#------##------#-#---#-----#--###--#------
-#--##----#------------#------#-######-#-----#--##-----#--#---------#-----##-##-----##-#-#--##--#--#
#-----#----#-#--#####-#--------#-##--##--#----#-#-#------#-##---##---------#--#---------#-##--#-----
##-#-#---#--##----------------------#-#--#--#-#-----#-------##-#----####---####-##---##-----#---#---
--#-##---------------##--#----#---#-----##---#-----#-##----------#--#--#--##------##-##---------##--
-#-------------#-#-#-#--#------##---#--####--#-##---###-##-----#-#---#-#-----###-------#---##-##-#--
#-----##---##----#-----------###--##--##---------#-#-----#---#----#---#--#--##---##--#------#---#-#-
#------##-----------#-#-##--####------#-#-#---#-#----#-##--#-###-#-----#-#----#------###--#-#-------
-##-#----#----##----##--##-######--####-##-----##---#--------#---#-----#--#-#----#-#--#---##----###-
--#-----#---#-#--#-#---#----#--#--#--#---##--#------#--#----------##-#--#-#-#--#---#----#-----##-#--
-#--#---###-#------#----#------#--##--#---##---#----##---#--#-#-------#--#-##-#-#--#---###----------
-#-###----#---####-#---##--#---#-#----#--##---#-###-##---#---#------###--#-#----#--#-----#--##-#--#-
---#-##----#--#--#-#-#--------------------#----#---##----------#-------------#####-#-------##--#-###
-##--#----#-##------#--##-#-#--#--#--##---#--#---#--##---#--####-##--#-------##----#---------#------
--#------#---##--#-#--#--#----------###-#-----##--------#---------#--#-##----#-#-#--##--#-#-----#---
###----##-#--#-#-#--#-----###----##------------##--#-###---##---#-----#-##--#------#--##-#-#-#------
---#--------------#----##---------#----##-------#-#---------#-#--------##------##--------#----------
---#-#-----##------#----#---#---#---#------##-#-#-#-#-###--#-----##--###-----#--------##-----#-#-#--
---##------#---#-##---##--##-#--------#-----##--#-##--##---#--##-##--#----------#-##-#-#--##-##--#--
--##-------#---#-------#------###---##-#--#-#-####--#-#-##---------#-##----------######---#--###-##-
---##----#---#-#---###---#-#-#----#---#--#-#---#----#-----#-#-#---------#-#-#-#-#------#----#-----##
-#---#-##-#------#-----#----#--#--###----#---#--#-##-#---#--###--#------##-----#----##-#-----#------
-#---------#-#----#----#-#--------------#----#-#---#------#---##--#----#---#--#-#-#----#----#-#-----
##-#----##-##------#---##----###----#--##-#-###-#---#------#----###-#-------#---------#---#--#-#---#
-#---##-#---#--#---------#-#-------#------##----#----#----#--#----------#---#-#--#--#--#---------#--
##-------#-##-----####----###-##--##--#-----#-######-#-#-#-----#-------#------#------#--##-------#--
------#---#-#-#-----##-#---#----#---#--###--#-----##-#-----###-#-#----#--#----------##-#---#---#--#-
#-----#-#-#-##---#---##-#----#-##-----#------#---#---#--#-#------####------##-----#-----#-#-##----##
--#-#-#-#---#--#---#---#--###-#-----#-----#---###-#------#----##-##---#---#----#--------#--#--#-#---
--------#-#---------------#-----##-##---#-#---#---#-----------#-##--#--#---#---------#----##------##
----#----#-----#--#---##-#-##-###---##-----#---####-#-------#---#-#-----#----#--#-#----#--##--#---#-
--##---###---##----------#--#---#----------#--------##-##---#-------##--#-------#-----##----####---#
-###--###--#--------------#-#---#--##--#--#------------------##------#--####------####--#----#---#-#
-#--##-#---#---#-----#---#--------#--------#--##--##---#-####-###----#-------#-----#--#---#---#-----
---#---------#-#---#----#-----#----#---####-#--#---##--#-----#--#-#---#-#-#----##--------#------#---
-##----#--###----#-------------#-####------#---------##----##-------#--#-###-##-##--#------------##-
#---##-#-##-#--#-###---#---#---##----#-----#-------#----------#---#--#--#--#----##-#---#-####--#----
-##-----###--#-----#--#---#----#-------------#-#-##---##---#-----###------#-----------#-#--#-##---#-
#----------##-###---#----#------#--#---#--------#-#----#------#-#-------#----#-#-----#---#------#--#
#---#--------##-#-#--#------#---------#--#--##-#--##-----##-----#--------#---#--#-##--#-#-----#--#--
---#-#-##---#-#----#-------#-----#-#------#-##--#-#---#----###-------#-#----#--#---#--##-#-----#---#
---#-#--#-#-#---#-----##---#-------------#---##-#--##----#####--#-----#--#---###--##-#-----#----#---
--#---#---#--------#--------#----#--------##-#----------#--#-#---#-##----#--##-#---###--#-#---#----#
--#-#--#-#---#-#-##--######-#------##--#---###-------###----##---#----#--#-##-----#-----##-----#-#-#
-#--#--#-#-----#####--##-----#-#--#----#--#-#--####--#--#-#-#---------#----#------#--#----##--#---#-
----------#-##-----#------###-#-------##---#####-##-#-#---##---#---###--------#-#-#-----#----#-##---
--#-#---##--#-#---#-#----#----#-#-##--#-##--#---##------#---#--------#-#-#---#-#-###-----#---#--#---
--##-----##-#-#-------#--##-#------##---#-#--#------##---##-----#-#-----##--#--------#--##-##-#-##--
------##---#-#-#----##-#---##-#-##--##---#-#----###--#------###--#----#----------#-#----#--#####----
-######--#------###------##------#--##--#---#-#-####----#---#------#-----###---------#--#--#-#-#---#
--------##--#--#---#--#--#--#--#--#---#-#--#-----#--#-#-#--#-##-----#--------##---#----###-----#----
------##--#---#-#--#----#---#-#---#-#---##----#-#---#-#--#--##-----##-------##--#-----#-----##-----#
----#----#--#-#--##--#--##--------#-#------###----#--#-#---#-#---#---#--##---#-#-------##-#------#--
---#-------------#-----##----#-----####--##-----#------#---#-#####-#--###-#####--#----#-#-----#--#--