?diagonal=Never;
####-#------#-----#-###-###--#---#-#----#--##------------#----##-#---#---#-------#-##---##-#--#-----
-#-#---#-----------#-#-#--------------##---#-#-##-------#--##--##---#--------##-###-#---#--#-#----#-
-----#-----##--#---#----------####--#------#---##-----##----#-#-#----------#----#--#-##-#---#--#---#
--#--#--------#--#-------------##----#-----#--------###-----------#--#---##-###-#-------#---#--#---#
--##-#-----#-#--#--------------#-----#---#-#-#--###--#-###-------###-------##----#-##-###--#-#------
-###-#-----#------#--##---###-##-----#------##--#------------##---------#--#-##-#--#---#----#-#-####
-#-----##--##-#--#----#----##---------#-#-##--------###---#-#----#-#---#-#--#---#--####----------###
-----##--#---#---#-#--##---#--#-###-#-#----###-#-#-#--#---#-----##---##-##-------#------#-#-#----###
-------#-------###---#--#---##----##-##------#-------###--#----##-#-#-----#-##------##------------#-
--#--###---##---#-----#-----------#-------#--#--##-##---#-#-------#---#---##--#-#-##--###--#--#--#--
---##--####--#--------#---#--#---#--#-#---#-------#----#--#-------#-#---##--##--###--#-###-#--###-#-
---##-##--#-------#-#-#------#---#----##-#--#--#------#--#-#####----#--###-####-------##------#--#--
#--#--##-#-##----#---#-#-#-#---#---#----#--#-#-###-----#------#--#---#--#----#--#-##------#------#-#
-#---------#-----#---##---------#--#-##-#---##-#----##----#--#####--#------##----#-#---#--###-----#-
#----#-------#---#-------###-----#--##----#--#--##---------#---#-----#-#-#-#---#------#--#-#--#---#-
--#---#---###----##-------------#---#------#-#--#-#--##---#-##--#------##----#--##--#---#---##------
----###--#---#---#---#-------#---#-###----####----#---###--#------###-#---#--#-#-------#-----#--##-#
#--#--##-#-#-#-#-----------#---##---#--------#--##---##-#-----#------#--#----#----#------#---#---#--
---##---###-----------##----#----#--#-------###--#---#--#------#-#--#--#--#--#-#---##-----##-#-#----
-##-----#-------##--#-#--#------###-#-#-----##-##---###-##----#-----#-##--##-#--###-#---###-##----#-
-#-------#-#-----------#---#--------#---##-----#-------#-------#-#--------#-#---#-----#-##---#--##--
-----#-###-##-#---#----#--###--##--#--##--#---#--#---#--------#-------##-##-----#--#-#----#--##-----
-##----#----------#--------#--#-----#--#--#--#---#----#--#-#--#---#----#-#--###--------##--#--------
----------------##---#-#--#--------###--------##--####-------#-----#-------##---------#-----##---##-
----#-##-##-##-###-#--#---##-------#-##--##-##-----#--##-----##------##----####-----#--##--#--------
----------------#-#--#-----#--##-----#-#--#------#-#--#---#---#----------#----#-#-----#-#-------#-#-
-#-------#-#---------#---#---------#-#--###-----##-#----#--#-###------#----------#-#-#-#----#--##---
-#----#-##--#-----###--#-#------#----####-##--##-#---#-#----#----##-#---####--#-#---#-#--#--#--#----
----#-------###--##-#-------#----###-##---#--#---------#--------#--#-#---###---------------###------
#-##--##-#-------##--#------------#-----##--------##-------###----###-#-#--##-------#---##--#-##----
-#---#-------##--#------#--------##-#-####---#-#-----#--#---#-----------#---------#----###-#---##---
-#-#-#--#--###---#-#--#--#---#-----##--------##-#----#---##-----------#---#-----#------#---#---####-
---#------------#---------#-----#----#-----#--#-###--###----#---###--##--#-#-#--#-#-###----##-----#-
#----#----##----#---#-###-#--#--#-###---#----###----#----#-##--#----#---#---------##---###-##-#-#--#
---#------##--#####---#--------#-#--#---#---##------#-##-###-----#--##---#-#-----#--#---#----##---##
#-----##----#-#-##------###----------#---#--##----#--#--##--##---##-#-----#--#-##--#####---#---##---
--##-#-#---#-------#---##---##---#----#--##-#--###-#-##----#-----##--###------#--#------#----#---#--
-#----#--#------#---#-#-#------#-#--#--#--##-###---#-#--#-#--------#-#--#--###--#-#------#-#----#---
--------##---##------------#---#----------#-#-#------------###-----##----#---###---#---###-#----#---
#-#----##-#----#------#---#-###-------#------##------#--#-#-##--##-#---###-#-#------##---------#--##
-#----#-----###-##-#-#----#---###--#--#---#------###-------#--#-##--##-----#-#-#-#-#----#-##----#---
--------#-----#-#--#-#-##------------#-----#------#--#-#-#-#-#-#------##---#-#----##-##-#----#-##---
----#----###-####--#--#-------#-###-----#--------#----#----#--#-----##--------#--##---#---#####---#-
#----#---##------#-----------##-#----#-####--#---##---#-#-##--##---#-----------#------------#-##-##-
---##-##-----#-###---#----####-#------#-#-#---##------#--------#-#-#------#---------------------###-
#---#--#---#-----#-----###-#-#---##-##--#-#-----##--#-#------##---#---#-----#------------#---#---#--
--#--#-##-----#----#---#-##----####---#####-##-----#-#-#----#-#--#------##-##--#-#--#---##------##--
-----#---------#-#----#---------#-----------#-#--------#-#---#---#---#-#----#--#-----#---#---#----#-
--#-#--#-##---#--#--------#####--###-#----------#--------##-#--------##-----#-#---#---#-#---#-###-#-
#--###-----#------#--#---#--#--#-#-------#---#----##-#-##-------#--##---###-----#-####----##-##---#-
---##------#--#---#-#--#-#---------##-####---#-#-------#--#----#-#------#-#--------#-#--#-#--##-----
---#--#-#-------#----#####----##--###-#-#----------###--####------#---#----#---#-#-###-###-#---#-###
#--------##---#-#-#--#----------#--#-#-----##--##-##-#--#--##-----#------#----#---------#-#-#-----##
#-#----#-----#--#-----##----##-#-##-----#------#--#-#---------#-#---##--#-#---#--#---#--#####----##-
-----------#---#----#-----#-###---------#--#---#--##------#-----#------#-##--#-#--------#------#----
--#-#--#---#-#-#--####-#------#---#-#---#----#--#-#-#---#-----#------##-#--#--#-#-#-#-#-#---##------
#---##--#------#-----#--------#-#-#--#-#-#-----##-----####-#-#-----#--#------#--#-##-##--##-----#---
#-------##-#---#--###-#-#--#--#-----#---##----##---#---------#--S#------##-------#--#-#-##--#-----#-
-##--###-----#---#-##-##-#---#-#-#--#----#----#----###--#---#-#----####--##-#---#---#----##----#----
#---#-##---###--##-#-###--#-#--#-----##----##-###--#-#--###----#--------#-#####-#--##---#-#---###-#-
----------#--##---------#-#--###-#----#---#---##-#---------#-##-#-#--#--#-###---#----#-----#--------
--#----###--###---##-#-#----#----#--#-###-##------##-##--#--###---#-#-----------------##------#-#---
---##-----------##---#--#-##-##-#-##--#--#--#--##-##--##---#--------#-#-#--#---#----#----#-----##--#
##---#--#------#-----#-#-#--#-#-#----#-##-#------------#-##---#------#-------#--#-#---#-#--###------
-##------#--------#--#---#-#----#------#-#-----#-###---#-###------------#-------#---###-#--###----##
--#-##--#---------#-#-##-----#---#------#---##---#-----###--------##----##----#-##------##-#-#-#--##
#-#-----#-###-#----#-#-#-##---#----#---###----#---#---#---#--#------#--------#-#-----#-----#-###-#--
-#-#---#-#-#-#--##-###-#---#----##--##-#-#--#----##-------#----##---####--###--------#-----#---###--
#--#------##------#-###---##---#---###--###-----E#----#-------#####------###--#----#----#------#---#
##-------##---#-----##----##-##---#--##-######-----#---##--------####---#--#--#-----#-#-------------
----------##-#-----#--##-####--##-----##-#---#---###--#-#---#---##---#-#-#---#------#--##-##--------
#-----------#----###----##--#----#---------#--##------------###-####-----#-------#------##----#-----
------#---#-----#----###----####-#-#--#-##----#-##------#--#-#----#----##------#------------#-#----#
--#-#####------##-#-----##-------##-#-##-#----#---#----#-#-----##----###---###---##-#----#-#-#-----#
-----##--##--##--##-###--#--###-#-##--#-#---##-#--#---#------##-###-------#-----#---#---#---#------#
--#-#-#---#-#-#----#-----------------------------###----#----##--------##-#--#---#----#-#-#-#-----##
-#--#----##--##-#--#-#-----#----##----#-----------#--###----#-----####---#------#-#-##--#-----#-#---
---------#-----##----#--#-#--------------#------#-------#----------##--##--#----#------------#-#----
-#-#--------##--------#--###-#--##----#-#-##-#----#----#---#-#####----##-#-------#-#----##---#------
##---#---#-#--#-#--#-##----------#--#-----------#--#-#------------#----##----###-###----#-----##-#-#
-----#-#------------#----#----###----------#--##----#---##---#-#--##-#---------------------------#-#
-#----##---#-#-#--#---###-----#-#-#--#-#-#---###----#--#--#--##-#--#----##--##---#-----#-#----#--#--
---#-#-#--------#----#-----#-#-##-##-#-------------#-------#--##-#-###--------###-##----#--##----#--
---#----#-#-----##--------##----#---#--##------##--#---#-##---#-#-##--##---------##-#----#-#-#---###
-----#-##---#-#-##-#-#----##-#--------#-----#----###--###---##--#--#--#--##-#--#---###--------##-#--
-#---#--#-###----###--#--------#-#------##---#-####--#----#-----#-#------#-#-##-----##----#-#--##---
---###----#--#------#-#--#-------------#-#-##-#-##-----------#--#####----#-------------#-#----#-#--#
---#--##----------####-----------#-----#---------##--------#---#-#---#####------#-------#--#-#-##--#
---##--#-----------#--###-----#-----#---#--#-#----#----#-#---------##--#------#---#####-------#----#
----#-----#--##--#--##------#------##-###----#---#--##-##--#-##-#-#--#----------#-#-#-#-----#-----##
-----#-----##-#--###---------#--#-#----##-#---#---#------#---##---#-###---#----#----#---------##----
#-#----------#--#--#-#-#----##-----##--###-#----#--##-##----##---##-#----#-##-#---------#-------#---
#-#-------------#--#--#-----#--#-#--#-#---#--#--##--#--#-#---#-#-####------#----#------#--#---------
#-#-##--##-------##---#-#-#--#-----##-----##-#--#---###-#--#---#-#--#--#----#-----##--#--#-###------
-#-----#-#---#---------#--###----#----#-##-#-----#-##--#------#-------#---------#---#-#-##--#-#--#-#
--#-#-#--#-#--####-#----#-#-#--##--#--#----#--#----------#-#-------#-#----#------##--#--#-----------
#-##-##------##---#----#------------#-##----#--#---##--#---##---#---#-#-##-------#-----#-#-#--##---#
--------#----#---#-------#--#------------#--###--#---------#----##-------#--#--#--------#-----------
-----##-#--------#-#-------#---#---#-#---##-#-------##-#-------#---#-###-#---#-###--#---#---####----
---#----##-#---#-----##-#-#-#--#-#-#---#------#-#---#--#----##--#-#--#--#--#--##-#--#---#-#---#--#--