?diagonal=Never;
-#-----#-#--#-----#-##-----#-----#-###----------#-------#-##---##--###----####-##--###-##--#--###--#
##-#-##-##-#------#--##------------#-##----#-##-#-##--##--##---#-##-#--#-###-#-----#------#-#-----#-
---##--##---#---#--##-#-#-#-#--##---###---#---#-##--#-#-###----#---#--#--#---#--##---##-#--#-#----#-
-----###---###----------------#-----#--------------##-#--#-##---##-----#--#-##-#-------#--##---#----
-#---##----###-----##------------#-##---------#-------#--#--#----#--#---##------#----#--#----#-#-#--
---#-------##-#-#----#-#---##-##-##---------######-#---###----#-#####-#----##--#-##----####------#--
--#-#--#------#-----#-##--#-##----#---#-------------#----#---#-#----##-#-----#-#---##----##---------
#----##----#-##--#--##--##------#-#---##---#--#-#---#------#---#----#----#-------#-#-#---#----#----#
-------------#-----#--#-#-#---#-##---##-##-#-##-----#--#----#---##-###-------#----------#----------#
--#-#---##-#----##--#-------------##---#--##-#-#-----#-#-------#------##--#---##---##--#---------##-
-#---##----#---------#---------##--###-#-#-------##---------#--#---#--#-##-##-#-##--#-##---------#--
--###---####---#-------##-----#--#---#--------#-----#--###----------#-#--#-##--###----#-#----#--#-#-
-#-#--#####--#-----#--#-#---#----####-##-#----#-##-##--#-------#---#-#--------###--##---#--##--#----
---#-#--#---#--#---##-----#-----#--##---#-##------#-#--#-------#---####-##-------#-##-#--#--#--#-#--
--#----#--#-----##-#---#-#--#--#---------#-#-#-#---#-#-##-#-#---#-----------###--#-#--##--#-#-###---
###-##-#-##-------#----#---##-----#-----------#--#------#---#-#--------##-###----#--#---#---##--###-
---#---------------##------###------#-#------##-#------#--#--#-#-##-------#--###-##-#---##------#--#
---#---#--#----####--####----#---##--#----##---#-----#--#---#--#----#-#---#-#------#-#-#---------##-
-#-##------##--#--#--#--------#---------#-###---#--------------#--#--#--------#-#------#--#----##-#-
---#---------#--#-#-#-----#------###---##-##-##--##---#-----#-#-#-#-#-#-####--#----#----------###---
-----#--###---#--#------#----##----#--#------------#----#-#-###----#---#--------#--####----###---#--
-#--#---#--------###-#-##-#-----#------------###-##----#-#--##-----##--#------##--------#----#--##--
--##----#---##-----#--##-------------#-----#-----#-----#-##--#-#--#-#--#-#-----##--#-------#-----#--
#------##----#--#---##------#------#----#-----#-----#-#---------#-------#--#----#---##-#-##-#-#--#--
#----------#-#--#-#--##-#---#---------##---##---#-#---#--##-#---#-##-----####-----#----##-#--#---#--
-#----#---#-----------##--#---##-----#--------#-----##----###-##---#-----#--####-#-#--#---###-------
##-----------------#-##-----#--#-#-#-###---#---###--#--##------##-###------------#-#-#-----##-#-#---
-----#----------###-----#-#-#-#---####---#-##--------#-#---#----#-#---#-------#-#--##---#-----#-----
-----#--#-----##-##----#-------##--###-#-----##-#------#-----#-----#------------#------#--#-#---#-#-
#-----###-##-----##-#-###--##-----#------##-#--#-#-#-----##--#---#-#--#--##---#-------------#-##----
-#---##------###-------------------#---#-----------##-#-----#--#----------#---##-#---#---#---------#
-#-------#-------------------####-----#-#---###--#--#----#-#---------#--#----#---#--#--#--#-#-#----#
---#-#----#-#--#----##---###-#-####--#-------###--------##------#-------#------##--#-##--#####-#---#
-##-#---###-#-#--#------##-#---------#---##------#--##-###-----##--#-#---#---#-#--#-----#-#-#-###---
---#-#-##---##--------##---#---#---#--#--------#---#---#---#-----------#-###----#-------#----#----#-
##-##----------#--#-#--------#--#----#-#----#--#--##------##-#-#--------#------##--##-#-----#-------
------------##-#----#------#----#-----#-#-#-------#-----##--##-#-----######-#-##-------#-----#--#--#
-----#----##-#-----#-#-#-------#-#-#--#-###-#-#---#---###------#----#-----#-#----###-#-#--#----####-
----#--#---#--#--#-#-#--#-#----#-###---#-----##-#---#--------##--#-#-##-----##------------#---------
--##--######--#-##-#--##--#--#---#---#-----#--##-------##------#---##--#--###--#-##-#--#---##-#--#--
--##--#------#---#---#--#-##-#-------------#----#-#-#--#-###-----#-#-#-###------------#--#-#---#----
-#-#--------------#-----#--#-##-##-----#-----###---#---------#--------###--#-##-----#---##---#--##-#
-##----#-----#---###-#---------#---#-###--#----#--##-##-#-#-------#-#----#-#--##----------#-----##--
#-#------#-###-##-----#---#-#--#-#-#----##--------------------------##-#---##-#-#----#-#--#--#-##-#-
-#---------####------##---#---#------###-------#---#--##--E#-##-#------#----#----#--#----#-#--##--#-
#----#--#---------------#--------##-###--------##------#--#----#-##---#--####----###----#-##----#-#-
-##-#--------##----#-----#------###----#----##-------##-##---------#---#-##-----#-----##-#-----#---#
----#-####---------#----#-##---#--#----##-#-----------#-#--##--#-##--#---#------#----#--#--------##-
#----#----#-#--#-##--####-#-----#------#-------###-#--#-----#---#----#-##--#-#--##---#-#-#-#---#----
-#--#--#---#-###---###--#-##----#-#----------#-#-#----#-----##---#--#---#--#--#-#---------#-#--##---
###--#----##-#----##-#------#-------------#----#-----#------#--#---------##--#--#--##-#---#--##-----
##-##---------------#-----#---##-----#--#----#--#-##-----------##-#--###-#--#------#---#--#---#----#
-#--#------#--------#--##-#-----##--#---#-##-##-------#-----#-#---#--------#--###----#-#--#-###---##
####-#--#-#-#-####---#-----##-----#------###---#----#--##--#-####---#--##---#--------#-#--##-----#-#
###------------#------#--##--###-#-#--#-###----#--#---###-#-#-#--------##-#---##-##-----#--##-##-#--
#-#-#---#-##-#----#-------#--#-#-##------#-#---#--#--#-------#----#-#--------#------------#--##-----
-#---#---#--#----##-----#------##-###-#--#####---##---##------#--#-------#---##--#--------#---------
--#--#---#-#---#--#-#----#---#-------#-#--------#---#----##------#-##---#------###---#---#----#-##-#
#--##----#--###------#--#---------#-------#------------#-----#--#--#---##--#-#-----------------#--#-
-#-#-----#---##---#------##----------#-----##-#--##-##--##-----#--#--------#-#--##-------###--##-#--
--#-#-----#--#-#-##------#-#-#-#------##------##-#-#-#-#---##--##--#--#-#--#-##--#-#-------#--#-#---
#-------##---##--#-#----#---#-#--#----#---#---##--#---#-------------#---#--#--#---#---#-----#-##----
----##------##--#-#---#--##-#--##-----------------##--#-##-#--#---#--#----#--------##-S#----#----##-
--##----#--#-##--###-----##----#---###-#--------#--#----##-#-#-#---------#-----#--#-----#--#--#-####
----------#-#--#-----#---#---#--######--#--#-##---------##-----#---##--#-##--#----------#----------#
------#-----#--#----#---#--#----#-------#-#-----#-----------##--###---------------##---------#----##
---#-##------#---#--------#-#-----#---#---#---#---------##-#---#-----##--#---#-##-#-#---#----#----##
#--------#--#--#--##---##-#--###-##-#--##-----#--#-#-#----###----#-##---###----###---#-#--#----#---#
-#----##-------#----#-#--#--#--#--------#--#---##---#-----##-#----#-#-------##---#-#--------#-------
----#--##----#----------##--------#---##--------##-#-#---#---#--##-----#-###-#--#----#-#-#-#-##-##--
##---#---#--#--##-----#----#---##-------#-##-##-----##-###-#-#--#----#-#-#---#--##--#-------##---#--
-------#---##-#--#----#-###-#-----#----#-#-#-#---------##---#--#--------#------##------###-#--------
--##----#--#---#--#---###----#--##--#--###--##--##--##-#--#####---#--#-#---##--#--------#--#---##--#
-#----#-#---#--#-------##-#-------##----#--#--------####--##--#-#-#--#----#--#----#----##--##--#-##-
-#---##---#---#-#---#---#--##------#-----#--#---#####-----#--##--------##--###----#-----#-#--#-----#
#-#-#--------------##--###----#---#-----#######----#-------#--#------------------#------###--#-#-#-#
-#---#-#---#----##------#-#--#-------##-----#--#---###-#--#---#-#-##------#--##------#-##-------#-##
-##--#---##-#---##--------#---#-###-#----#-#--##--#-#-#----#-#-#--#-##--#-----###-#-##--#-#--#-#---#
#-#####---#------##--#---#--#-#---#--###---#---#----#----#-#-#-##-#-#----#--#--#------#-#-##-#-##---
##-#-----#-######--#---#------##-#-#-#-#--------####-#-###-#-#--------------#--#-#-###----#-#-##--#-
#--##-#---------#---#---------#-#---#-#---------#-#---#-#--#-#--#-------#####-#-#-#--##-----#--#----
--------##-#-----###--#-#-#-#-----#----#---#------#---#-###-------###----#-#-------##---#------###--
---##--#----#--#--#-##---#-#---#--#--#-----#-------#-##--##-#----------#---#---#--#-----#-----------
---#--#--#--##-##--#--#-----#--#--##-#---#-#####-------#---###-#--#---##---#-----#-##-#----#-----#--
-#--##---#---##-----------##-#-----#-##----------##--###---------#---#------------#----##--###-#-#-#
-#---#----##--##-##--##-----#------##-#----#-#-----##----###-------#----#---#-#--#-#-##-##-##-#-#--#
-----#------#-#--#---#--------#---------#-####-#####-----#----#----##---##-#-#-#-#---#----##--#--#-#
#----------##-----##--------#--#-##-#-#---##-----#---------###----#------#--#---##-#-----#------##--
------#--------##--#---#---#-----#-#-----##----#----------#--#---#-#--#--#-#------#-#--#--##--#-#---
----#--##-#-#----###-----#-#-#-#--------#-----#-#--#----#-#---#------####--##---------###-----#-#---
-#-##-#-----#-#--##-----#---##--#--#-#---#-#--#-#--#------##--##-#--#-------#-#-###-#----#-#--#----#
##-----##----#--------#--#----####---------#-#####--##-##--#---#--##---#--#-##----------##--#----###
-##--#-##-##-#-#-##---#-##--#--#---####---------#####----##----------#---#----##-#-----#---#-##-#---
------######---#-###-----------------#-#---#-----#--#--#---------##-#----#-------##-#--#-----#-#----
-#-#---#-#-------##-----#-##---#---##-#---#---#---#--##-#---#---#----------##------#---#--#-###----#
-#---##-#----#--#-####--#---#-#---#-------##---#---#--#------------####--#--#-##-----###---#--#--#-#
-------#--------#-----##----------#--------#--#--#------#--------##--#---#-#-#---#------##-#-#-----#
---#--#----#-#--#--#---##-#--#-#---#--#--------------#--#--#--#-#---#---#---#---------#-------------
-#-#----#--#----#--#----#--#---#-----------##-#---#--##-----#--------#--#-------#-#------##--#--#--#
-##--#-##----#--#---#----###-----#-##-#--##--##-#-#-#--#-###----#-#-----------#--------####---#-----