?diagonal=Never;
------------#--####--###---#-#------#--#-##-------#-###--#------#------#---------#---#-##------#-#--
------#----#----#----#-####-------#-------#--#--#------##-#---#----#----##-#--#------#-#---------#--
#-------------##-#--##-----#-----##-#-------##----#-##-#----#--#--------####--#---##----#-#-#-##-#--
------##-#-#----#-#--##--#----#--#-#-------#--#-----###-----#---------------#-##---#--##----##------
---#---#-----##----#--##-#-#--##----#--------#---#----#---##----##---#----#-##-#---#---#----#-#--##-
#-#-###-----------#------#------#------#----#--#---#----#-#-#-------#-###-#-#--#--------###---#-#---
----###-----#----#-###--#--#-------#-#-----#---#----##-#----#------##-#---##------#----#-#---#-#----
#######-#------#---------#-##-#----#-###-#-#---#------#--#-#------#----------###--#-##----##----#---
#-----------#---##-----####--##-------------#------#-----#----------##-#-#--#------#----#----#-#----
--------#----####-#---------#-#-#----#-##-#-#--------#-#--#-#----###---#-#-#---#---#-#---####--#--#-
-------------#---#-#-#-----------------#-#-#--#-------##----#--#--#------##-##-#--#---------#---##--
-------#-##-#--#----######-------#------#-#-#---#-#-#-------####-----#----#----#--#----#-#-#-#------
----#--------#--#-----#---###---###--#---#-#---##-------#-----####-----#---#---#--#------#---#------
###--#--------#---------#--#-##----#-#--#-##-#----#--###-##-#-------##-----#-#----#---#---#----#-#-#
#-##--##----#---------#-----#-###------#-#----#---#--##-#-------#-#-##-#----#--#-#-----#-#-----#-#-#
-#-#----------#-#-#----####-##--##-----##-#-#------##-#-----------#--##---------#----#-----------#-#
---####--#----#------##---#-#------##-#------#-------##-#---------#-#-###-#-------#-#--##--#-------#
-----##--#-----#-#--#-#--#----#-----#--#---------------------#-#--##-#-#------##------#--##---------
#-###--#--#-#--##---#-#--#--###-#-##--##--------#---####---#---###-##-#----#-#------------------#---
#-#-#-#--#--##--#--#--#-#-####-----##--------#-#-##---##-##-#--###---##---###-#-------------##-----#
#---##---#--#-#-#----#---#---#--#-##-#-#-#-----##----##-#-#-#---#----#----#-#-#----#-##------#--#-#-
------#-#-----##----#---##-#-##----------#-----#-##---------#----#--##-#-------------#---#--#---##--
#---#-#-----##------------#----###-##---#-##------#---#--#----###--#----------#---###-#-#-#--#----#-
--#-#---#-#--#--#--#---##-#----#----#----##-#--#---#-##---#-#-#-#---###-####----#-#-#---#-#-#----#--
-----#-#--#--#--#-###-#--##-------------#----##--##-------------------#-----#-#--#-#-#-----#--##---#
---#-#---------#--##---##---#---#----#--###-##-#-#--#---##----#-#------#---#--#----##------#--------
###--#--#--#------------#----------------##--#--##-----#-------------#--#-------#---#--##----#------
#-#---#--#----#---#--##---#--#-##-#--#-#-#----#-----------###-#---#------#-##-#-##--#-------#-----#-
#--#--##-#----------##-#-#-#--##---#--------#-------#--#--#----#------##--#-#-----------#---#---#--#
#--#----#---##-#-##-####-###--##-------#--##------#-------#----#-###-##--###-------#-###-##-----##--
--#-#-#--#---------------#-#-#--#-----##----#-##---##--------#-####-#-###-#---#--#-#----------------
---#-----#------###-#----##---#-----#--------##-##---#---#-----#----#-----#--#----------#--##-------
---#-----#---#---#------#-#--------##---#-#--#-#-##-#-#-----##---#-#-------##-----##----####-#------
#-----#-#--------#-#-#----#--#---######----#-----#----##--#-----#------#-##--##--##--#---#---------#
----##-----------#--#--#---------#-###-#-#---#-#---#--#-------###------##-#-##--##---#-#----#---##--
----#-#--------##-#----#--#-#-##-------######---##-----#--------#---#--#-##--#--##----------#---##--
-###---#---#----#---#-##----##-------##----#---#-#---------#-#-#-------#--#--#-----#-##-#-#--#--#--#
--#-#---#------##--#----###--#-###-##-#-#--##-#----##-#-###----#------#--######---#-------#--##-----
-----------#---#------------#-#---#-#-##-------#-#----------#--#---#--#-#---##-----#-----#-#-#--#---
#--#------#---------#----#---#------#-#-#-##-#-##--#--#--#--#--##-----#-------#-#---#-#-#-#------#--
---##-#----------#---##---####----###------##---####--#--------#---###-#---#--#-#----#--#----------#
#-------#---#-##------##----#--##-#---#--#---#--###---###--#---##-----#-#--#----#--##-##-##--#------
#---------------##--##---##-##------#-##-#-#---#-#----##----#-#--#-#-##-#-#-#----#-------##-####----
#-##------#-------#--#-##--#--####------#---#----##-#-#--#-#--#--##-------##-##-#----#---#-#----#--#
---##-#---#--------#-##--#-#-###---#----#-----#-##----##--#---#------------------##-#-##----------#-
--#-###-----##--##-----#-------#-#----#-#-##---#------#-#--#-------##--#---------------#-#-#----##-#
---##----#-----------#-#-#-#--#---#-----#-#-#---#--#--#------##---------#--##-#----#------#-##----#-
-#----#--#---##---###--#----#-#--#---#-----#--#--#--#---####-------###-----#-#-------##------#------
#-#---------#--##-#----#-#-#--##-------#------##------####-###---#--------#----#---------##--#-#-#--
-------##--##---#-----------#-------#-#-#-#---#---#--#--#---##--------#-#--#---#-----#-#-#-#-#----##
#----#-#-------#----#--------------#--#----##-#------#-----#------#-------#---##-----#-------------#
#-#---------#--##-#---##---#-#-#------#----------------#----#---#-###-#-#-#--------#----#-##--------
#-#------#-#-----##---#---####-##--#---##--#-#-----#--#-#-##---#-##-#-----##-###----#----------#-#--
#--#------###-##-#---##------#-#-#--##-####-----#----------#------#--###-----------#-----##--#----##
---------#---#---#---#-----#--###---#----#-#---#--##--#-----##--#--##-##------------#-------##------
--------#-#-#------#---#---#---##-#----#-##-----#------#----#---######-#--#--###--####--#--#--###---
----------#-------------#-#-##------###----#------#E#-#-###-#--#-##-#-#-#--#-#---#-##-#-#-----##---#
--##-#--##---#--###-##-----#---##----##----#-#---#-###---###---#-#----#---#--##-#--#-##---##-#-----#
##-#-#------#--#-#-##--#-#---##----#-----###-#-#--####-#-#-#----#--#-#--##---#-#--------##-##--#-##-
-------#--#---##-##---#-#----#--#-#---##---#-#---####----#-----#-#-#-#-#-#--#-----#--#-#---#-#--#-##
--------######-##---#--#-#-##-##--------#-#-----#-----#---#-####--##-----###-#-----#---#--#---#-#-##
-#----------##-#----#-----#----#------##--------###----##-##-#-----##-----#--###---##-#-------#-##--
-#-#--#-#---#---##--#---###-----#-----#---#----#---#---------##--#--#-----##--#-###-------###---##--
-###----#---#------#-#--#--#---#------------#-###-----#-#------#-##---##-#--#--#----####-#-----##---
#-#-#------##--####-#------#----#-#--#------#-#--#-------------#-#--#--##-###--##-#----------#------
---#-#--##-#--#-###-##-------##--#---#-#-#------####------#------#----##--###--##-#-#-#----###------
#--##---#----###----#--#---#---#---#-#-#-##--#-###-##--#---#---#---#-----------#-#--#--#------#---#-
#---#--##------#-----#----###--#--#-----#--------##-##-###--##---#-#---#-#---#----#-----#--##---##-#
-----#--#----#--#----#-----##--#--#------#-##---------##----#-#---#--#---#-##----#-------#--------#-
-#--#--#-#---##-##-#--###----#-------#--#---#---#-##-##-------#-#-###-----#-##--#-#----#---#---#--##
--#-###------##--#--#----###-#-#-##--------#-#-#-#------#---#----------##--#-#-#-#--##--#----#-##---
------#--#---#------##--#--#--#####------##-#-##---##--#--##--##-###-#-----###-#--#---####--------#-
---#-#-----#-----#---#-------#-----#-##---------#--####---#----#-#--#-#------#--#------##---##---#--
--#---#-##-----#----##------------#--#-#-##-----#-###-----##--#------####-----##-###-------#--#--#--
#--#-#-##-##---#----##---##--##---#--#--#-#-#----#-##---#---#----##-----#---#--#--#-------##-----#--
###-------#----#-----##----###--#--#--#---#----#--##--#-#--#--#--------###-##------#---#----##---###
----#------#--#-##---#--#-#--#--#---####----#---#-#---####--#-----#-#-----------#-----------------##
--#-##--##-#----------#-#--##---#-------#-#-#--------#-------#---##------#------#-###--#-----#----#-
------------#--##--#------#---####-----#--#---##---#-#---#------##-----#-#-#-------#----###-------##
---------#----#---#-------#-----##------##--#-##-#--####-------------##--#---#---#--#-#---#--##-----
-##--###-##-#-----------#-###----##----#--#-----##---#--#-##----#----##-----##--#---#-----###--##---
---#-#####------#------#-#------#--#-----#--#-------#---#--#------#--###--#---#---------#---------#-
----#-#-##--#---#----------------#---#-#-#---###-----#--#--#--#-###--------##-#----#-##-#-#--#------
-###-#--#---#--##-#----#-----#-----------#--#-##-#--##---#----#-###-------#--#---##--#----#-----##-#
-#--#----#--#-##-#-##-#-#-#--#---##------#-#---#----#----#---#----#--#--##-#-----#-#---#-##-#----#-#
#-----#------##--#---##-###--#-###-#-#-#--#--#------------#---#-##-###-##--#--------#--#--##----#-#-
#--#-----#---##--#---###----#-#--##-##--#---#------#---##----#----####-#--#--------#-#----#-#---#--#
#------###-#-#-#-------#----#--#---#---###-##--##----##--#-#--#---#-#------#--#--#--##----#--####---
#-#-#----###-##-#--#-------##-----#--------#--##-#---------#--#---###-------#-----#------##-#-##-#--
--#-#-----#---##----#-###---#--#----------#----#####-----#-----##-#----#-###--#-##-#--#-#-----------
##---#-#-##-#---##-#-#------##---#---##-#---#---------#-##----##--#------###-#-----#-#----#--#-#----
#-#-----##-----#---#------#--------####----#-###--#----------#--#---------#----###---#----##--------
-#-##-#-#-#--##-#-#--#-#--##--##-#-----#----##--#----#-#-#--#---#-#---#----#-------#--------#-------
---##--##-#-###--#-----#-#--##-#---#-##-#-##-#--#---#-#--#--#-------#--#-----#---#----###-####-----#
-------#---#---####-----#--------#-#-----------#--##--#--#-#--#-#----#------#--##---##---#-------#--
------#---#--#------#--------------#--#---##------#-------##------#----#----#-#---##-###-#-#-#---##-
#-##-----##--------#---#-------##------#-#-------##----#-#--##----#-#-#-#-----#----#-#--#-#-#-#--#--
---#---###-###--#--##-----###----#-#-#----#--#-#-##-------#--#-#--#---#------------#-#---#---------#
#------------#--#------##---##-----#--#-#----#-----#----#-####-#--##-##-#--#--#----##-----#-----#--S
#-#-#--#---#--#-------#-#-#----##--#--#----------#-#-#-#-#-####---#---##-#--------#----#-----##-----