?diagonal=Never;
##----##------#-----#-#--#---##-#-#-#-#--#---##---###-#-#-----##-#--#--##--------#-#--------------#-
-###-#--###--#--#-##--#----#---#--#---#--###----#--------##---#--#--##---------#-#--#-#----#--------
#------####-----#-----#--#----#----#------#---##--------#-----###-#--#-##-------#---##---#-#-#-----#
-----#----###--------##--#-------#---##---------#--#-----#--##--#-#--###--##--------#-#--#-----##--#
##--#---##-##--##---#----#--#--##----#----#-#-#-------#-------#-----####----#-#----#-----#---##---#-
###----#####---#--#--#-------#--#-#---##-#-#--------#-#---#-------##--#---#--#--#-#------##--#-----#
--#----###--##--#-#----#---###----#-#-----#-##--#---#---#-##-##------#---#----#--#####-#-###---#-#--
-#------##--##---##-##-------#-#-#-##-#-#--###----#--#---#--#--#--#-#-##-#-##------#-##--#----###---
##------#--#--##-#-#--#----#--##-----##-##--#--##-###--------------------#-#----------#---------##-#
--###-#----##------------#---##----------#--##--#---########--------#----#-##--#------#--#-#---#----
---#--#-##------#-#-#--#--------#-##-----#--###-#----##-##------#-#----#-###----#-#-###---#---#-----
#-----------####--#-#---#-###---##---##-#-#---#--##---#---####----#------##---#-#--#-------#-#-#----
###--#---#-#-#-----#-#--#-----#---#-#-----#----#-----#--#-----#----#------#-#--###-----#----##--#--#
--#-#-------#------#--#-#--#-#--#----#-----------------#--#----------------#-#--#---#--------#--##--
----#-#-#----#-#--------#-----------#--------####----##-#--#-#--------##--------------#---###----#--
#----------#####---#-#-------#--#-##----------##----##--##----#---###-#-#----##--##---#-#-----##--#-
----#------#-#---------#-#-#-#--#-#-##--#---E-----###----#---###---##--#-----##--#----##---##-###---
------#---#------#--#------#-#-------#-##--------#--#-#-#-###--#-##--#--#---#--------#--------#----#
----#--##-------#--#------###-----##---##-----#-#-#-----#----#-------####----#-#-#####---##-----#--#
#--#-----##--##---------#----###---#-----#----##--#---#---###----------#-#-------#----##-------####-
#-#--##--------#--#---------#----#-#-#--##-----#---#--##-----#---#-###------##--------#-###-#-#---#-
-----##-##--#-#----#--#--#-##--##---#--####-------#-----------#---#-#---#---###----###----#----##-#-
----#---#----#------#-#--#-#-##--#--#----#-------#---#-#--###-##------#-#-----##--##-------#--#--##-
##---#---#-----##-----#--###---#--#--#--#-#-#----##--#------#-----#--#--#-----#----#-#--#-------####
--#-##------#-#---#--#-#--#-#--##---###--#--------------##-#--#---#-#-#-----#---#-#-----#-----------
-----#----##--------##---###-#--#----#-##--#---#---##----#--###--#--#-###--###---###------#---------
---------#-------#------#---#--#----#---------#--#-#-#-#--#----#--#--###-##--#------##------#-----#-
-----##-#--#--#--#-#---##--#--#---#--------#-##--#-----#----#-#--#--#---#----#--------###--##-#-####
-###----------###------#-#-#------#-#--#--#-#--#-#--###--#-------#-#-#-#--#--S----####---#-#---#-#--
------#---#----###---##-#--#---#---------#-------#--#--#---#---##-#-----#--#--#-##--####------####-#
-#--#--###--#-##-#-#-----#----------#---#----#-#-------#-##---------##-#-#---##--#-----------#-#####
######-------------#---#-------------##------#--##--###---#-##----#---#-#-------------#------#----##
--#---##-#-----####-------#--#####------#----------##--##------##---#####---#---#---#--#--#----##-#-
--#--##----#-------###-#------------#-#-------##-##----##----#---#####------------#--#----###-#-##--
----#------#--------###----#-###--#--#----#-----#--#---#-----------#--------#-----##----###-#-----#-
-##-#--##---#-----##-#---#-----#-###-#--------###-----#-###-#-----###-#-##---##---#-#---#---------#-
--#------#----#----#--#-#-#-----##-#-#-###-------#-------#--#-------#----#------#-##-------#-##-#---
---------#-##----#--#-#------#---#-----#--#-#--------#---#--#---#------#-#-##-------##-####---#-#-#-
----#-#-----#-----#-#-#--#-#-#-#--#---#-#------------#---#--#--------#-#----------------#--##---##-#
--------#----#-##-##--####----#------##------#--#--#-#-#---#-----#---------#------####-#-#-#-----#--
###-----#-#----#---#--#----###-----------#---##-#-#--#--#--#-#---#-#--#--####-----#-----#---#--#---#
--##-#--#-#--#-#--#-----#-#---##----#--##---##---#---#--##--#-#-#-#-##----#----#----#--##-####-####-
--#-#---------#-------##----------####----#-#-----####-----###---#----#--##-#---##-#--#----#------#-
#---#---#-#----#----####-----##-#--##-------##--###-###------#-#------#-#---#----##-----##--#----#-#
-#------##---#---#-##--#-#---##-#-#---#-----#-------##-----###---#-----#----#--#------####-#--------
---#####------##---#--#---#-#---##----#----#-----##-##----#-------#--#----#--#-###---#--##--###-----
#-#---#-------#------------##------#-#--###--#-####------#--##------#-##-----#-------##--##-#--#----
-#-#-###--#---#-#---##---##----#-#----#---#----#-###-##--##-#--#----#------#-#-----###-##---##-----#
-###--#-##-------##--#--###-----------#-#------##--#--#--#-#-#--#------#---------#---------#-#------
-###----#----###-------------##--###--#--------#--#--#----#-#-----#----##-----#-----#-##-#-###-#--#-
-#--##-----#--#----#-------------#-#---##----------#-------------#-#--##------------#-------###--#--
------#-###-#--------------#--#-####-------------#-#----#-----##----#------#---------#-#--###-----##
#--###-#--###-###-###-#-###-#--##-----------##-----#-------##--###---#--#---##-----#----##-----##-##
#----#----------#---#--#-----###-##-#----#----#-----#-##--##---##---#----###----#----------#------#-
#-#------#-----#-###----#####-#---#------####-###-##---##-------#--------###---##----##------#-#-#--
###--#-#-#---##------##--#---##-----#-#--#--#-#----#-----#-###--#--------#-#-----#-#--#-#-#----#-#--
--#--###--##--#--#--#-##----##----#--#----#----#--##----##-------##--#-------###---###--#-##--------
-----#-------##---#----###--------------#-##-#-#--#---#----###---##------##-#-##-----#-------##--#-#
-#-----------#-#--#-----#---#-##-------#---#-#---###---#-#--#---#--#-###-#------#----##------#-----#
-##-#-#-#----#-#-##---#-#-#-##--##---------##----#--------#----#----#--#-##-#----#-#--##--#---------
#------#-##-#--#--------#------#-#--#-----##---#--##--#-#-----#--##---#-#--###-----#----#------#--#-
-----#---##-#--#-#---#-##-#-##-##-----------#-##--#--#-#--#--#--#-#-#---##-#-#--#----------###--####
-##-#--#---##---##-#--##---------#-#-#---####-###----##---###-----##-#---#-------#-#-##---#-#-#-----
-----###---##--#----#-###----#---#------#-##----------#----##-#-#--##---#-----#-#--#---#-#---##-----
#-----------#-------#-#------###--##--#--#--------#-#--#--#--#-------#-------###-#--##-#------##--#-
-------#---#--#-##--###-#--#-#-#----#--#-----#-----##--#--###--#-#---##--#---------#----##-#-----##-
--#--##----#--#---#--#-------------######-#------#-#-#--#---#-------#-#--#--#-##------#---#--#-#----
##--------#------#--#-#----#-#------###-#-----------#-----#------#--#---####--###----#-#-#--##-#---#
-#-#-#----##-###-##-#---#----##---#----#--#-##-#--#-#---#---###-#-#----##--------#--###-#--#----#---
-#----#-##---##-#-#-------#----#--##-#--#-###--------####-----------#--#--------##---#--#---#-----#-
--#----#---##-##-----#---####--##--#---##-##-----##--#-#----##-------#-----#-----#---##---#--#------
--#------#-----##-------##--#-------##--#--#--------#-#-------#-##--#---#-#-------#--#-#----#---#---
-----###-#--###-----#---#-----#-#---#--#------#--#--#--#-###---#---#-----#-------#--------#-#-#--#--
---#---##------#--#-#---#--#--##-------------------#-----###-###---#-##-----#----#-#--##----#-------
---###--#-##---#-#-##-##----##---#--###---#-#-------#---#---#-#---###----#--------#----#-####-----#-
#-#---#--#---------#-#---#-##------##---##-----#------#----###----#-----#----#--#--#----#--##----#--
--#----#---#---##-----#---#--#-------##----#----#--#--##-#-#-#------#-----##----#--#--##-#----------
#-------#-#----#--####--####----#--##---##---#--##---##-#--##-------#--#-#--##-#--#---#--##-##----#-
------#--#---#--#-###-##---###-----#---##-#---#-----##--#---#--#--#-------#-#-------#--------#-###--
-----##---------#----#------#----##-##--#---#-------##-##-##--------#-##-------#-#--#-#------#-#----
-----------#--#--#------#--#------#---#####-------#------#---------####--#-###-------------#-#-#-#--
------#--##-----------#-#---#--#-----------#------##--###-#--------##-#------#--------####-#-----#--
---#--##---#---##----------------#----##---#-#--#---#-#-------##-#--------#----#-------##-----##----
-#-###------------#--#---#-#---#---#---------#-#--#---------##-##-#-----##----------##---#-##-##-##-
----------#--#---#-#--#-#--#----#----#------------#-#-----#-#------------#--##----#--#----------#--#
------#-------#-----##--#-#--#--##-----###-----##-------#-----#--#--#-#---#--#-#---##--#-###-#-#----
--#-------#-#-------##-##----#-----------#--#-##--#-##---#------###---##----------###-----#-##-##--#
-#--#------#--#--#---#-----#--#--###----#-#--#-#---------------------##-##-#-------#---------#--###-
#-#--#--##--#---#--##--##----#-#-#--##-#---#-----#--##--#---#-#--#--##-----##--#---#-#--###--#----#-
--#--#------###----###-#--#-##---##----#-#-----#---#-##--------#----#---##-#----##-#------------#-#-
-####----#---------#----#-----#-#----##------##-#-#--#---------#-##----#---#-#-----#-#----##--#####-
##-#--#-####---#------#-#------------#---#-----##-----###-----------------##-#-#--#--------#-#------
#--##---#-----#-#-#-#----------#----#-#---#-#-----------#--------#-------------#-#-#-----#-#--------
-#----#----#--##--#-#--#--###-##-#----###--#--#-------------#--#-#----##---#----------##-#---##-----
#------##----##-----#--#-#-----#--##----###--#-####--#--#-#----------###--#-----####------#----###-#
###--------#--##---#-#----#----####-##--------#---#----###---#---------#-#-#-##-#-#-#--------------#
---------#-#-------#-----#-#-#--------#-###-#---#-#-#---#-----#------------##-##--#----#-------#-##-
#-#-#-#-#---##--------#--###--#-#####----#---#--#---#--#-----#---##-#####-####-#-##-#---#----------#
----#--#--#--##----#-----#----##-##-###-#-#-#----#-#-------##----#-#--#-#--#-##---##----##--##-----#
-#---##--#------#-----#-#-#----#--#----####-----#-##----#---#-#------#-#-----###----#--#--#--#---#--