?diagonal=Never;
--#-----#--#----#--#---#--#---#--#-----#----#--#---##------##-#-#-#-#-###-###-----------#-##-###----
-----#----------##-##------------#-#----#--#---##-----##-#-#-#--####-##--#--#--#------#-#-#----#----
--##----##-##---#------#-#----#-S#----#----#------####-----##--#----#-#----#--###-#------#---#-###--
--#--#-#---------#---#------------------####-#-##---##--#--#---#-##--------##-#-#--#-----------#-##-
#------#-##-#------#--#-#-#---#----#-#---------#-----#--------#-#----#--#--##-#-##----###-----###---
---###--#-#------#-#---#-#-#-----###---#-##--##-##----#----#-----------#-#----#--###-----##---------
-#-##------#--#-#--#--#----#-#---#---#----####--#----#-----##---#-#-----##-#-#------###-#--#------#-
#--#-#----#---##--#---#-#---#--------------------#--##-####-#--##-#-##--##-#-----#----#-----######--
-----#-##-----#---#-#-#---#--#---###-#-#----#------#-#------#-##----#-----------#-----##-#--###-----
#-------##--------###-#---#---#--#---#-----#--##-#--------#-#--------###-------#------#-----#---###-
----#-##---###----##----#----------#----#------##-#-###---------#---------#-#-#-------#-#--#-#-#--#-
--#-#--#-#--------#---##-#------#-#----#-----####----#--#####-#-##-----------#-------#-----##------#
---------#-#---#-----#---#----#---##------##----#----------##----------#---#---##---#-----#------#--
-----#-##--#--#-##----###--#-#-#----#-##-#-----#---#--##--#--#####---#-#-----#---#----#--#-----##---
##-----##---#-#-#---##--#-#--------#--###-#--#-####---#--------#-#--##----#-----##-#----#-#-###--#--
#-##--#--------#-----------#---#-------#------###--#---#-----#----##---#-#---#-#--#--#-#--#-----#---
-#---#----##---------##----#-----------##----#-------#-----#---------#-##---#--#---##--##-###--##-#-
--#-###-####-----##-----###-#-#--#--#--##---#--#-#----------##-------#-------------#-#--#--###-##---
---##-----#-#----####---#-----##----#---#---#------#---#----#----#--#-#----##--#--#-------#-####-#-#
#---#-#-#--------#-------------#---------#---##--###-#-#------#####-#-----#--#-#-##-##-#--##-----#--
------##-##-----------##-#-##----#-----##-##-#----#---#########--##-#---#---###--####----##-#--#-#-#
----------#------------#--#---#--##----#-----##-#------#--#--#-#--##-#--#-----#-#-##-###---------#--
-------##--------#####---------#---#-----#---#--#----##------##-#-#--#---#---#---##---#----#---#-###
---#--#---#--##--#--#---##-------------###-#--#-----#--------#--#-#-##---------#-#----------##-#----
#----##------####-#-#---#-#--#-#-#-##-##-###---#-#-----#--##-##-#--#----#--#--#--##-#---#-------#---
###----##-----###---#-#----#------##---#---#--#-##-----#--#---#-----#----#---###---------#---##--#--
------#-----###-#-##---##----#----#----#-------##-##--#-----#------##--##--#-#---###-------#-----#--
---##-#--##--#---#-#-#--#-#----##--#----#---#-#------#----#-----#-#---#--##----#-#--#----##-#----#--
-------###-#-#--##-#-------------#----#-#-#--#-----#--#--##-#-##-----##-#--------##------#----#-#---
----#------#--#--##-#--#-#-#-------#---##---#---###---#-----#--#-#----##-#--#---##----------#-#--##-
-#----##---##-##---------#-###-#-##------#--#--#----#----#---##---##-#-----#----#-#---#-##-------##-
-#--##--------#------##--------##-----#---##-----#######---##--#------#--------##--#--------#-#-##--
#---#-#---#--------#---###-#---#--#----------#-#--#------#--#-##-##---##-###---#-###-------#-###----
-##-###-##-##--#---##-------#--#--#-###----#---#-----#------#--##-#-#---#--#-#--#-----#-----#-------
----#-#----#-#-#--#--#---#----##-##--#--##---##---------#---##-###---####---#-#-#--#-#--#---------#-
#-----##----------#--------#--##------##-#-#-----#-##-----#-----------#-------#---#-##-----#----#---
-###-#--------#-#--#-#--#-----#--#---#--#-----#---##-----##---#-#--##------#-------###------#--#---#
-#--#--#---##--#--------#--##-##--###-#-----#------#----#-#-------##------#-##--#--#--#-##-#-#-#--##
--#-##------#----#--#----------#---#-----##---##-#-#----#-###--##-##----------##--#-#--#------#-----
#-#------#----#---#-#-------#--##-#-##-#-------#-#-#----##-##----#------#--##-#--#-#-#-#---#---#----
#---###-----#---#-#-###-----#---#----#-####----#-##-##--#--#--#---#---#-##----#---###---#----#-----#
#----##--#--##---#####--#--#--##----####-----#-#--#---#------------#-##-#----##--#-----------#------
-###-#--###---#---#-#-#-#-#-##-#-##-###--#--#-----#-#--------###-------#--###---##--------###------#
-#--#------#----#-----#--##-------#-#-----##---#---#--------#-#-###---#-----##-#-#-----------#--#-#-
--#---------#-##-###---#-----#-##-#----#---------#-#----#-##-#---##---#--------#----#-#--##--#--#-#-
---###---###--##-#----#--#----------#-#---------#---#-------#--#-#-#--##--##--#----#--#--##---##-##-
--------#--####-##-----##------------#------#--#--#---#-#-------#--##-#---------#-#-#------#-##-#-#-
-#--------##--###----###---#-#-----#-#----#---#----#--#---#------###-###---------#-#---#---#-----#--
#--#-#--##-##-#--#-#----##-----#-#-#---##---###-------#----#-#------#-##-#--##----####-----#-----##-
#---#--##-----#---##-#------##-#--------#-#--#---##--##-###---#-#--------#----#--##------#---#------
-#----------#-#-#---#-#--#------#--#------#-#------#---#--#-----#-------#--####---#-------##----#---
---##--#--#--#---#------#-----#----##----#-#---#-----#-#-----#-----#----##---------#-----#-##-----#-
-------------##--##-#-#-#--#-#-##-##----##-----#---##---##--##--------#--#----#-##----#---#---#----#
-##-##-#-------##-#-------#--#---#----------#-----##-#-##-#-#-#--#--#----#-#--------#-###-----------
##-##-#-#-------------##-----#----###-------##--##--#--#-----##---###-##-###----###-------#---#-##--
#--###-#-##----#---#---##------#-----#-------------#-#---#-##---------##--###----##-#--###-##-#-----
#---------#---##---#--#----#-#---###-#-##-#-#-----#--#-#-----#--#-#-##-#--#----##---#-#-------------
--------#-#--#---#---##---#-###-#---------##-------#-#--------###-----#-----###--#--##----#---#-----
------------###--#--###---#-#-#--------#-##---##---#------#-##---##---------#----#---#--#--#--#---##
----##-#-###--#---#-#-##---#---#---###-#---------##----#----#-#--##----------#--##-#--#-#-##--------
----#-------#-#------#----#-----#-#---#-----------#------###------#-#--#-##-#--##---------#--#--#---
-#-###-------#--------#-#--#-----#---#----##--#---#---##-#-##-#--#---#--##---#-#-##----#--#-#--#---#
---####--------#---#--##--#--#----#-#--###--##--#-#--#------#---##---#------#-#------------#---##---
#---##-#---#----#-#--#-##--#----#-----#-#---#-##------#-------#-----#-#-#--------#-----#-##-------#-
#-------#-##-##---#-##--##---#----#-#--##--#----#--##----#-###-##-####--##----------#--------#------
---#-##--#--#-----#----#------#--#-#-#-#-#-------#-##--#--#-#-#-#--##---##-------##--##-#------#-#--
----#-###-#-#-##---##---#-#--#-#----#####--#-#--#----#----#-------------#---#-##-#--##-------#------
#------#-------#--##-#--###--#---##-#--####--##----##--#---------------#-######-----###--#----------
--#----#####-##--#------#-------###-----##---#----#---#--#---##--#-#--#---------#####-#-#-#--------#
#-##--#---##-#---##--------#-----###-#-#----#-##-#---#-#----#--#--#-#---#-----------------#--##--#--
-#-#----###-#----#-##-##--#----#---#-##-#-----------##--#----#---#--------#-----##-#-----##--###-##-
--#-#-#-##--####-----#-###-----------##------#-#-#--#----##----#----##--###---------#--##-#-#----#--
-----##----#--#-----#---#--------###------------#------#---##-#------###---#----#---#---##-##-#----#
---------------#-#----#-#----#--#---##-----##---#--#-#-----#-----#-#-#--#---##--------#-------#---#-
-#---#-#---#####-#--#--#-#-#-----##-##-#-----#----#--#-#---###-#-##--#-#-#-----##------#---#--#--#--
-#--#-----#-#-#--------###---#---#-#--#---------------#--#-##--#-----#-##---#--------#-##-##-#-##---
#---#--###----#-----#--#---#--####-#----##--#------#-#--#-#-#--##-----####-----#----#----#-#-------#
#-#------#-----#----#-#--#---#----##---#-#-#---#----#-#---##--#--------###---#-------##---###-----#-
#-#-###--##-----#-#-##------###-------#-###---#--#---#-##--#-#-#---#-----#-#-------#---##-------##--
#----##---------#--##------------#------#-----#----##------##--##---#----#-##----#--##--#--###-#----
##---#------#---------#---------#-#----------#----#---------#--#------##----##---#------##-#--#-----
#------##-##-#--#----------#-----#------#---#---#-##--###-#----##-----#---##--##----##------#-##--#-
---##------#--##--##------------#-#--#--#----#--#--#-##--------#-#-#----------#-###-#------#--#-##--
---#--#-#---#-----###--##--###--#-#-#-##--#--##-#-----#E-----------#-##-----#------###-#-#--##-----#
#--#----##----#---##-----#-#---#--#---#--##-#--#---#---------#---#------------##-#--#-#-----#---#--#
-#---------------###-#----#-#-#-#--#--------#--#--#----#--#-##--###-#------#--#-###----##-----#--##-
----------#-------#----####-----#-##-#----#----##--##-------------------------#---#-#---##---#-#--#-
--------#-#-#-#-#-###-#--#----###------#--##-#----#----------#----#--#--#--###--##----#-#--#-#-#----
-#---#-#-##---------#-#---###---#-----##-#-----#---###--###-#--##----------#---##---##-#---#-----#--
--##--#-#---#-------##--##-#--##--#---#----#-----#-#-###--#----#-----#------#--#---###-#-##------#--
-#-#---##--#--#--#------#----------------#-###---#---####-#-##----##--#----#-#-##-#--##--##---------
#--------###--------##-#--------#-#--#######-------------#---------#-#-#-#-----###--#----#-----##--#
#-----------#--#-#------##--##--#------#-#--##--#-#--##---##--###-------#--#--#---##----------------
-#-------------##------#--##---#---###----##-##--#-#---#--##-----#--#--#-##---#-#-#-#-#-------#----#
--#--#--##----#-#------##---------------#-#--#-----------##-###----#-##---##--#-#-#-----##-##-#---#-
####-#--#--#--##-------#-------------##----#-##--##--#----#--------#--#-#-----#-#--##-----#--#--##--
--#-#-----##-------#---##-##----#----#---##--##------#----#-#------###-#-#---#--#---------#-#---##--
#--#---##----#--#----##-#--#--#----#---------#-----#------#--##--#--#-----#-#-#-----#--#----#-###---
#-#----#-#-------##-----#--#--#-#--#-##--###--#------#------#-##--#--##------#-----#------##-------#
#--------#---#-#---#---#-#--###---#---#------#-----#-###--------#---#--------##------#----#-#-------