?diagonal=Never;
--#--#-----#--###---#---#--#--#--#-#-##------#--#--#-###-----#--#-----#---#---#---##---#----#-------
-#---------------##-------#-#----##-------#-------#---#--####--#---------#---#---#--#-#-----####-#--
-----#-####--#-#------#---#-----#-###---#---#-#----#---#-##-#-------#-#---##--#----#--###---##------
---###-#-##--------------###---------##----##---#--#-#------#--#--#--#---##------##-###-##------#--#
----------#####-#--#------------##-#----###-#-#-##---#--#--##---#------#-#-----#----#---##----#--##-
##--#-#------#-###--#-#--##--#-----#--#-----------#-#-#-#--#----###---###---#--#------------------#-
#-#-#-----#--#-------#---#-----#-------##---#-#------#-------#----#------###------##-#---#-------#--
##--------#---#--#------#-#-#--###--##------#-----#----#--###------#-------#---#-#-----#--###-##-#--
-#---#------#-------#--##------####------#--#----#----------#-#--#--##-#-#------##--#--#--#--##--##-
-#---##--####--#--#---#--#-#-----##----#------#---#----##--#-#---#-#----####--#--------#--#-#-------
--####----#---------------#-#-----#-----##--#---#-##--#--#-###-#--#-#------####----##--##-----------
----#-#-#---#--#---------##--#--#--#-----------------#-#--#-#----##---------#-##--------------#-#---
-###-------#----#--#--##--#-#-#--##---------#-#-#-#---#-#-##--------#--#-#--#--#--###--#--##-----##-
-##-#-----#-#-----------#-#---#-##------#-###-----------#--#-##-------------#--##---##---#-#-##-#---
-------#----#-----##---##---#----#------#-#--##------##---###-#-#####-##-###-#--##-##--#---#---##-##
--#----##--------#--------#------#--#--#-##-##-#-----#-##--#-#--##---##-#-------#--#-##---##-##-#---
#-#--#--##-####--##-#------#---#---#-#---#----##---#-#----------#-------#-------#---#------#--#-----
-#----###---##--------#-##-###-#--##----------###--#-------##----#-#---#-----#-##-#-------#-----#-#-
------#-##-#-#--#--#--##--#--#--##-#--------------#-----#-##--#----#-----##----##---#----#-#-----##-
#---------#-#####------#------##-###-#-#-##--#-----##----#-#---##-#---#---##-----------###-##-###---
-##-#-##-#---#-##-#--###--##-----#####---#----##--##-#-#-E---------#---#-###-##--##-#-#--#--#-------
----#----#-----##-------#---#--#---#-#--#----#---##-----#------##--##-#-##-----#---#--####-----#--#-
--##-#-#--#--#--##-###---##----#----##--#----#--###-##-#-----#--##------------------#---------#--#--
-#--#-###-#----------#--#---#-#-----##------------##--#--##--#---#-----#----#----#--#-#-#-----#--#--
##-#---#---###------#-----#-------#----#---#----#-##----#-----####-#---#---#---------####---##-----#
---#-#---##--#------#---#----#--#-----#---#-##-#----#--#---#----#-#-####----##--#-------------##--#-
--#---#---#-#--#--#-----##---------#-#---#---##--#-##-#------#---#-#-#---##-#-#------#---##-#-----##
--------#---#-------#-----#--#####-##--#--------#---#------#-#---#---##-#------------##----##---#---
-#-###--##------#----##--#---#--------#--#--##---#-----#-----#----#-#-#----#----#--##-####-#--#-#---
--#--#-##---###--##-#---------#-#---##----#-###-#-#----##--#--#-#-#-#----#---##--#-#---#--#-------#-
#-#---------##---##-#-#----#-#---#----------##----#-#----#---#-##-------#--##---#--#-##------#--#--#
--#----#--#--#-----#--#--#-----#-----##---#-------#--#--------#--#-#--##-####--#-#---#-##-#----#----
--#----##-----##-#----#---#---#------##-------#-------#-----##----#-----##--#----##-------#---##----
-#--###----###--#-------------###---#--#-#-------------##----#---#-##-----#-#------#--###-#----#-#-#
---#-----##----#-##-#--#-----#-#----#----##---#---#------##-#----------#--##-#--##-##--------------#
-----------#-#-##-------#-###---#-#---#------##--###-#---#-----#-------#-#--###-#---#--#-#---#---#--
-#-#----#---###------#-----------#---#------###-#--#----#--#--#--#------#---###-----###-#------#--#-
#--#--------#-#------##---#-#----#-------#-----#-----##-##--##-##-----#-----#---------###--##---##--
-###--#-#-----#--##------##----------------#-#-------###-#-#--------#---#--#-#--##-#--------#----#--
#--#----#-------###--#-#####------#--#-------------#-----#--#---##--#-#####--#--#-#------#------#-#-
#--------###-##---#-#--------------##--#---#--#----#-#------------#-#--##--##------#-#------#-#-----
----#---#-#--#-#----------------#--#-#-----#---##-------#------##----------#-------#-#-#-#--##------
##-------##-#------###-#-#-#--#---##--#-####-#--#-#--##--#--#------#----##-###--#--###---#-----#---#
---------##-##----#------------####--#---------###----#-##--#-#-#-----------#-##--#-#------#---#-#--
#--##-#-#--#--#-------##-#-----#--##---#--#----#------#---------##------#--#---##--#-#--#-#--#------
---##--#---###--#-##----#--#--#--###------#####--##-#-##-##-#-----#--##-----#---#--##-#---#-----##-#
--#-#---##---##-#------#--#---#-#-------###--##-##----#-----#---#-#---#------#--#-#--#----###-----#-
----#----#-----#-###--#-#-#-#---#-##--#-#-------------#--##---##--------##-#---#-----##-#----#----#-
--##----#----#--#--##-#---##----#---#-######-#----##-#-#-#-#-------#-#--#----#-------#-#-#-----#-#--
-#-----#---#----#-####-----#-#-#--##--#--#--#---##-----#####-----#------------#-#---#-#---##----#-#-
----------###-##-----#------##-##-##-#--##--##--##---------#--####-------####--#--#--#----##--#--#-#
---##-------#--##---#--##--#-#-#--##-#------#-----#-----#---###-#--###------#-------#------#---#--##
-------#-------------#---#-----#-----##--#-----#--------##-#----#-#-#-#--#------#-#--##------#####--
-#--#-#-------#------#--------------#--#-#---#--#-#------#----#-##--#--#----#---#------------#-###-#
---###---#----#----##--##---------#---#-----##--#-------#----------------#------##--##--##-#---#---#
#--------------------##--##---#-------#-#----##----------#----#---#--###--#--#---#-#-##-#-##--------
#-##-#--##--###-----##--#---------####----#-#-##-#----###----###---##-----###-#----#----#---------#-
---#--#---#--##--#--#---#------#----#-----#----##--#-###-#--------#--####--###----#-------#----###-#
-###------#-----##-#-----##--#-##-#---#-###-##---##-#---#-----#-#----#-#-#-##-##---#------#----#----
#-------##-#-#--#-#-#-#-##----##---------#-#-##---#---#------#-----##-#--##---------##-----#---#--##
--#--#--##--#-----##--------#-#-#-#--##-#-#--###-#----###---##-----##--#-----#------##--##-#--#-----
------#-##----#----####--##-#-##-------##------------#--##-------#-----#----##------#----#-###-##-#-
---##-#-------##---#--------#-------------##-----#---------#--------#-----##-#-----#---#--#---------
----##--#-#---#--------###-###---##---#----##---#---#--#-----------#-----#-#------#--##----------##-
#--##---#-##----------##---#-#---#------#-#-#---###--#---#---#-##----#-----#-----#--#----#-#------#-
----###--##-###----###-###--##---#-----#-#-----##--#---#-#----##-------##---#-#-#----##--#--#--#-#--
--#--#----#-----#--#---##-#-#-#--------###-#-#--#--####--#-------------#--#-------###-#-----#--#----
#--#----##-----#----------##---#---------#---#-----#-----#---##-----##-----#-#---#--####-#--##-----#
---#------#--#-----------#--###------#--#-----#----#------#---#-##---#-#-##---#---------#--####-#---
#-------#-#-#-----#----#----##---------##--------#-----#-#-#-------#---#--#----###-#-#--#-------#-#-
#---#-#---#-#----###-##-#-#------#---#----#------#------#-#------###---#-#---#----##---#---#----##--
----#-----------#-#-#-#-#--###-#-#----#-----#---#---#-----#---##-----##-----#-----#-#-#----#----#--#
---##-----#---##--------##--#---------------#-##--##-#-##-#-----#--####--#--##-------#---#----------
---#-##-------##--#-----#-#-#-#----##-#--------###----#-----#--#-#-##--##--##---##--#--###------#-#-
--#----#---#----#-#-##----#-----#---#-##-##-##-###--------#-#--#---#---#-------#-#---#-#--#-##------
----##----##---------------#--#---------#-########---#--##-------#-#--#-----#----#--##-------#-#----
---#-#---#------##---##--#---###---#--#--------##--------##-###-#-###-#-#---##-------##------#--#---
-##---#----#####---#--##-#-----#-#----#------#-##---------#--###---##-----##----##--#------#-#-----#
#----#-----#-#----------#--##---##--#--------#--------#-#--###----#---#-###--#-#---#-##------------#
-##-#-#-###-##---#-----#--------#--#--#-#-#--#---#---#----##-#---#-----#---#---#--#-----###---#-----
-----#----#-#-----#####-#---------#-#---#---#---#-#-#---#---#----#------##-###-----------#-##---#--#
#-###------##-#----------#-#----##---------#-##-------#-###-#---#--#----#--#-#-----##---#-###--#--##
##----#--------#-#---###-#-#--#--##------#-####--##-##----------#---##-##---####--######----#-------
#-#------#-#------##----#---#------#----##-##--#---#--#--##-----##-#---#-##-##-##------------##-----
----#----##-###-#---##--#----#-#--#-----##-#-------##-##--#--#--#-#------###------#--#-##--#----#-##
-##--#---####-----#---#-#--#-#-##---##--#-----#--##--#---##-#-#----#-#---#---#--#---##----#--------#
--###--###------##-----#-#---#-##--##-#---##-----###----#-#-----##-#---#--#--#----#------##-##-#-#--
-##--#-#------###-------#---###--#----#--------#-####--#-#--#-------##--###----#-#-----------#------
--####-----#---#----#--#-#---#---##-#-##--##--#--#--###-------#-##--##-#-------#---####-------#-#--#
---------------------#----#----#--#-#---#----#------#------##---#-#----#-------#---##-------------##
#----##--#--##---#--#------##-#-##-###-#--#-------####----#--#--#--##-------#--#------#----#-#----##
-##----------##--#--#----#-##-#-#---#---##-----#-#-#--#-#-#--#----------###--------#-#-#-##------#--
-#------##S----------#---#----#---#####--##-#---##-----##-#-#---------#--#####-#----#--#---#-#----#-
--##---#--##---#--####-##-------#--#----#--------##--##----#--#----------#---#-##-###---##-#--------
---##-#-#--#-#---#--##---#-----------#-#-------##-#-##--#-#-#---##---##--#--#-##--#-##---#--#-##--#-
#--#-#--#-#--##---------###---------#---------##-##-#-#--###-#----#---#----##-----###-#--#-#------#-
--#-##-----#--#----#---##-#------#---#-#-#-#--#--------#----#--###-----##---##-##----------#-----##-
-#-###-----#-#-#--#--#------------#--###-----#-----#-##--#-#-##-#---------#-------#--------#----#-#-
--#----#-##----#----#----------#--#------######--#--####----#-#---#--------#-#---#-#----#----#----#-
-#---#-----#-#-#--#----#------#----#--#-----###--##----#-#--#--#--#----##----#---#-###--#-#------#--