?diagonal=Never;
---#--#---#-#---##-----#-###----#----#----#-#--#---#--------#----#-----#-##-----###---#-##-##------#
------#---#---#-----------------##--#-#-#--#-#--###-##----#--##---------#-###---##-----#------------
##-###--##---#----#---#----------##-##-----#--#-#-###-----------##-----#--#-#-##-#-#--#--#----#-----
---------#-##----###--#------#--#-#-#-----#------#-#-----#---##---#--#------#--------#-#-#-#S-----#-
----#-#-##--#----#-##-#####-#-------#---##--###-----##-#----#-----#-#----#-----#-#----####-----###--
--#-#---#-##-##--#-##-------#-------#--------#----#-----#----#----#----##---####-#---------###------
---------------#--#--#------###-----#---##-#--##-------#---##----##-------##--#--#---#------###-#---
-#-----------##-------#--###----#---##-##------#---#--##----#-#---#-#--##----#-------#------#-#---#-
---#-#---#--#-#----##---##----#-#-#------#---#---##----####-#----##-#---#---###------#------#--#-#-#
--#-#---##--#---#--------#-#--###---#-#-##-------#--#-----###---#----##-----#----##----#-----##--##-
-----#-#-#-------######-----------##-#-#---##--#-####-#---#---#---#-#--#-----#-###------#-----------
-##----#-#--#-###-###--------#-#--#---#-#-----#---#-#---#----#-----#------#-##--------#-#--#-#--#-#-
#---------#-----##--------#------#--#-###----#-###---#---#----#-###-#-#-------#-##---#--#-###-------
-#--#---##--#-##-##-#--#-#-----#---#--##-#-#---#-###--###--###----##--#-----------#-----#-----------
#-----#----#-#----#-------#-#--#---##-#--#---------##-----#-----#---##--#-----#--#----#---#-##--#--#
----#-#-#--#---------#----##-##--#-#-#---#--#---------#-#----#--#--#--###-------#-#----------##----#
-#--####---#--#--------##-----#-----#-----#--##--#-----##------####--##-##---#-#---#-----#-#--#---#-
-##------#---------###---#-#-#-----#--#-#--#--#--#-#-------#-----#---#-##-----#---#---#-#-----#-####
-------###-------#---#--#-#-#--##---#-------#---#--#--#---#---#-#-#-----#------##---###----#--------
-#-##-----#--#--#-------#---#--#--##-#---##-##--#------#-------#-------#--------#-#-##---------##--#
------#----#-----#----#-###-#--#-----#-#-----##---#-#---#--#---##---##-#--#--#-#----#-#--#-----##--#
#---#-#-#-#--##-#---#----------#------------#-----#-#-----------##---#--##---##-#----#--#--#-##-#-#-
-#-----##----#-----#---##---#--#---##-#-----#-##-------##---#------##----####-#-##-##----#------#-#-
-#--#------#--##--##--#-#-#-------#-#-#----#---#---##----#---##-###-#---###--#---#--##--##--##------
--------#---#####----#------------#---#--#-##--#----####-#----####-###----###-#-#-###---####-#--#---
---#-#-#-#-#--#--#-#--#-##--#----#---#--##-#---##--#-----#-#--##-#--#---#-##----#---#--------#-----#
#-#-#---#--#------#--#----------#-#-#-#-##-----#-----#--#--#-##-#--##-#-#---#--#---------#--#---#---
##----#-#-----#--#------------#---#-#----#----#-#------#--##-----------#---#----------#--#-----#--#-
##-#-----#--###--#-#---#-##--##-#-#-----#-###--##-##----###--#-#--------#----####-#----#-#-##-##----
------------##----#--#-#-#-#-#---##---#-##----##-----#--#-#####-#-#--#---#----#-#-----#-#--##-----#-
#---#-#---##--#--#--#-##--##----#-##-#-------#-#----#----####----#---#--#------#--#----##----#---#--
--#--------#---#-#-----##-##--#-----#-#------#-----#-------#-----#-###----#----#-#---##------##-----
-#----#---#----#-##-#--#--##--#---#--##--#--###--#------#--------#-####---##---#----#-----#---#-----
-----#-----#-##------#-----#--#--#--##--#---#----#------##-##-----#-----#----##--####-----#-----##-#
---###---##-######---##--#-----------#--##-#-#----#--###--##-----#-#-----#---#----#-##------##-----#
-##-#--#--#####-#----##---####--#--##--#------#-#----#---#----##-#-##-#-----#-#--#-#--##----#----#--
---#-#-----#----#---#-#-#---#-##--#-#-----E-#-----#----#--------------##---#----#-#-#--#-#--####-#-#
##--#-#-#--##-----#-#---#-#-#---#-----##----#------#--#-#####--##--##---------#--#-#--#-#------##--#
--##-#-##----#----#-----#-#--#--#--#--##---#-#------#----#--#-----#--#---#------#####---#-#-----#---
------#-##----##--#-#####-#-####--#---------#-##-#--#--###-##-#-#-----#----###---##--------#--#-----
--------------#--#----#-##-#--##----#--#------------#-----##---#--#-#--#--------------#------#-----#
#-----###----------------##----#----#-###-#-#-##-#-------##--#-#----#----##--#----##-#----##-#-#-#--
----#-##--##-#-###----#---#------#----------##--#-----#-----#--##-#-#-#---#---#--#---#--#----#---#--
#----##---#----##--#---#-#--#-##---##--#-#-##---------##-##-##-#---###-#-----#-##--------#----##--#-
------#-#---#-#----#-#--#----#--#---------#-----#--##-------#---#------------#----##-##-#-#---------
#---#--#---####---#--#-#---------#-#--####------#---#--#-#-------------##----#-#-#--#-###----#------
-----------##------------#---###---#----#-##---#-##-#-#--#-#-----#-#-#------#-------###-#--#---#-#--
-##------##-#-#--#--#--###-#--######--#-#----#-##--#-#---#---#-#--#----#----#--#-------#---------#--
#--#--#---####-#-#-#---#-#-##-#---#----#--#-------#------#--##----#-#--##------###-#-#-####--#---#--
-#---#-#------##-#--#---#--#---#---##-----#-------##--------#----###---#--##----####-------##------#
----#--------#---#----#--#-#---#-----#-##------#--#----#----#-#---#-#-------------------#---------#-
--#-------#--#------------#--##---#--#-#-#----###----#-#-#--#---##---#-#-##------#--#-#--------#---#
-#-#---#-----#-#-#-###----#--------#-##----------#--###--------#-------##-#--##-#####---#-----##--##
----#---#-#----#-#-----#--#--##-#-#--#--#--------###-#-------#-#---#-------##-#---#-##---#-----#----
--##-##---#----###--#------------#-##-------#-----------#---#----#------------#-#---##--###-#-###---
----#-####-----##-#-----#-#-----#---------#------###----#--#--#--------#-----####-#--#---#-#------#-
--##--#--#-##-----#-#--##-------#---#------#-##-#----#-###----#---#--------#---#---##-##--#-#---###-
----#-#-#-##--##---#--------#-#-------------##--##-#--##-#-#--##-----#---#------#-#-#-----#--#------
-#--#-------##---#---#----##--------------##-#-##------#------##-#--##----#-------#-#-#--##-#------#
----#--#---#-###-#------#-------##---#-------#----#-###--#---#-#----#-#----##--#--##----##----####--
--------#-####-#-----#-#-------#---##--#----#-#-#-----#-##--#---#----#-----#--#---##------#-----####
----##----#----------#-#--#-----#-------#--#-#--#-------##--#----#---#------###-#---##-#---#---##---
-##-###---##--##--##--#---#--#---#--#--##--#--##-------##---------#---------##----#---#-#--#---#-#-#
-##---#---#-#---##-#--#---####-#----##---##------------#------###---#-#--#--------###-#-#--#-####-##
#----#----##-##-##-####--###---------##-----------#--#-#-#-#-----#---#----#------##--#--------#-----
-#-###--#--#----#--------#-#-#-------##----#-#-#-------------##--#--#--------###-------#--#----##--#
---------#--##---#-#------------#--#-##----#--#---##-##------#----##----#--#-#--#-#----------#-----#
-----##----#-------##----------##-#----##--#-----##--#--#----#-----##--------#-------##--#--#-------
#------------####-#-#--##---------##----###--#-###-#------#-#-----------------#-##-----------#------
#--#-#-#----#------#-#-#--#------#--------#----#-#----------#-----#-----------#----#-#----###-#---##
--##--#--#----##----##-##------##----##----------#--------#--#-----###-#----#-#-#--------#--#----#-#
#------#-#-------#---##---#-###-#---------#-#---###-##-#-##--#--#---###---#-------#-#--#--##-###--#-
---##---##-#---#-#-####------####--------#-----#---###---#------##-##----#-##----##-#--#---##--#--#-
####----##--##---------#-#----##--##---#--##--#---#---#---#--##---#--#-#----#---#---##---------##---
---##--------##---#---#-#-#-#-#----#-#-#--##-##--#---###-##-----#-------#------##-#---------#-----#-
---#---#--------#------#--------##----#-####--#-#----##---##--#---#---#--##--------#--#--##---#--##-
#--##--##---####---##---##-#---#-####---####--#--#-------#---#-----#--#-#-#---------#---#--#----#--#
#--#---###-#-###-------##--#--------#------##----#--#-----------------##--#--#-#-#----#------#-----#
--#----------#--#-#-#------#-#-#-#--##-----##--##-----#--#-------###--#-#----###-#------#-----#-----
#-##--##----##-##--##---##------#----#####-#-#-#---#-----------------#-#-#--#-----------------###---
-##-#-------#--##--#----#####---#-####--#----###--###-#--##---#-----#--#---------#-#--#---#-#--#----
#-#--#--##-###---------#-----#-#-#----##----#----------#-----#---#-----#-##--#-#-#--#---------------
#---#-#----##--------#-#--###-#--#--#----##-#---##-------------##--#---#-----##-###--#---##-#------#
-------#--#--#------#------#-#-----#---#-----##-#####--#--------#-#----#--##---#---#--##-#----#----#
---#-#--#-##---#--#---#--------##--------#--##---#---#-----#-##-#--#-#---------#--#-#--#---##-#-#---
-#-##-#-#----#---#-----##------##--#-----#-##-###-#-#-##-----#-----#---#-#--#-------#-####---------#
-------#---##------##-#-##-----#-##---###-##-#--#-#------#-#-----#---####-#-#----###-#---##---#--#--
---#-#----#--#--##----#----#-----#----#-#--#--###-----#------#-#------##-----#----#-----###-----#--#
##----#--------#-###--------###-#-------##-------###----##---#------#----##---#-----##--#-#--#-##---
#--#--#------##-##----#----#----#----#-----###-----#------#-##-###-#---#--------------##-##----##--#
#---#-##-#--#--##-#--#-#--##----#-#--------------#--------#-#-###-#------#--------#--#---#---#------
-#--#--------#----##---##------------##------#----#---#------##-#------#--#-#-##-#-----#-----###--##
--#--#-----###---#------#----#-#---#-------##--#-------#------#-------#-----#--###-#------#--#-#-#-#
--#-#------#------#-------------#--#-#-#--#---#--#-#-#------##----#--#-##--#---#-------##-------#-#-
-###-#-#--#---###----#-#-----#---------#---#------##-#--#------##-------#----#------------####---#-#
---#--#-##-#-#----##---###--#--#---#--#--#-#-####---#---------#---##---#---------##---#---##-#------
-#-#---##-#--#---##-#----#---#-#-#####-------#-#----#-#--------------###-#-------------###-####-#-#-
-##-##-##----##---#---#-----##-#-#-------#-#-----##--#-------------#------####---#----##-#--#--#--##
-##--##--##--#-##--------##----#----#-#---##-------#---#--------#####---#----#-####---##----#-#-####
#-------##-##---#--#--------#-##-#-------#---------##---#--#--------#-------#----##--#---##--####---