?diagonal=Never;
----#-#---#----####---#-##----##-#------###--##----#-##---#-####-#--------##--##----#---#-#-##-#----
------#-----##---###---#-#--#--##---##-#------#----##-#-#--------##----#--------------------#-------
-----#----#---------#------#-####-#--#-#---#-#-----------#--###--------#-#--##------#-###-#---------
--#-####---#-####-#--#---#---------#----##-----#---#-##-##-#-------#-#-------#-----------------##---
--###--###-----##-------#-----#-----#-##-#---#------#-------------#--##--###-#----#-##----#-#-#--#--
-###------#-#--##-#--#---#--#----#-#----####-----#-----#-#-#-##----##----#-------#--------#----##---
--#-----#---#-##---#----#--------------##-##------------###-#----------#---#--------#--#-#--#--#-#-#
----#--#----#--#----##--#-#-##------##------#---###----#-------#--#-------#----#---#--##------#-#---
-----#--#--------#-#-###----#-#--##-----#----##--------#-#-##-###--###-###----##----#----------#--#-
----##---#--#----#-#---#--------##-#-##-#-#--#-##--#--------##---#----##--#-#-----------#-###-#---#-
###-##-#---##--#-#--###-#------##-#----#-##--##---##--##-####----#####--#---##--#---#---#----------#
-#-------#-------###--##-#--#---#----##-----##-----##---##-------##-#-------##------------#-#--###--
-##--###-##---##----------#--#-##--#--#---#----#--#--#--##-------###----------#--#-------#-#-#-#---#
----#--####-#-##-#---#-#-#--##-#------###-##-------#------------#####------------#----#------#---#--
---------#---#------------####-##-#---#-#---#-----###-----#----------#-#---#--#--###---##---------##
--#-#-#-#---#-----#---##-----#-----#--##----#----#--##-------##-#--#---#-##--#-#----##--------------
-#----##----#-------##------#------#-##--##---#----#--#-#--------##-#----##---#--#--#-##--------#--#
-#-#---#--------##-------#-#-#-#--##--#-##--##-###-------##--###-#------#---#----#-----#-###---#-#--
--#--#-#-##----#--------#--------#-----#---------#--#-#--#-##---#--#-#-#----#-#-###---#--#---#-----#
----#-##--####-----#--#--------#-------####-####--#-#-#---##-#----##----###--##-####-----#----#-----
##---#---#----#-#----------#-----#--#--#---#-#-##--#-#----#-#--#-#--#-###-----###------------##-#---
----###------#-------#------#-###-#-##-#-#-------#----##--##------#--#-#-##-#-----#--#---#----#-###-
------#-----------#-#-#--##-------#------#----#-------#---------#---------#-##---#---#--#----##----#
--#-----#--#-#-#--##--#----------#----##--#---#--------##-------#-#-------#-------#-###----#-####---
--#--#-##--#----####--#-##-##--##--##----##--#-#---##---#-##----#--##-##--#------#-#-------#--#-----
----#--##---#--#-#-#-#-##------------------#-----##--#-##--#--#-#--#--##--#-----#--#-###----#--#----
###-##--#-#----#---##-#-----------##---#-##-#--##--#--------###------------------#-#---#--#-------#-
#----------#-#-------------##-----##-##--#---##-#-------##------#--#-##-#----#--###----#-#---#-----#
-###------##-##--------#-#-#-#--#----##--------####---#-#--#--------###---##-##----##---#---#-#-----
#------#------#---#-##-####-#--#--#---##--#-##---##-##----#-#---#--##---#----#-----#-##------##--#--
#-#-----#-#-----##-----###--##-#-#-#---#---##-####-#--#-#-#------#####--#---#--###---#----##------##
---#------#---#---#-----#--#-#--#--#----#-#--#------#-----###--#----##-#----------------#--#--##----
-------#---#----#---------#-#---#-#--#---#---#--##-----------#-----##-#--------##-----#----#---#----
#-------#--#-#------#-#--##--#-#---##---#--#----#--#-----#--------#-##---#-------------#--#----#----
##-----#---#---#----#---##--#--------#--------#---#--#--#-#---#---------###--#-#-##--------#---#---#
#-#-#---#-----##------#----#-#--#-------#------#--#--#--------###---#-##-#--##---#------##--#-#-----
#----###-#-#-#--------##-##-##-#-######---#--##-#-#--#---#---------#-----#-------#-#----###--#-#---#
---####-#-##------#--###-#--#----#------#-----------##---#----##----#-----#-#-#---#--------#--#-##--
-##--------##----------##---###--#----##-#--------##--#---#---###------##--##-------##---#----#####-
--##-#--#----##--##-----##----#-#-##-##---#--##--------##--##---#--#-#-#--#--#------##----#-#-#-----
--#-------#-#---###-#-#-###-----------##-#--#-#--##-----#---##------#---#-#-#-#-----------------#---
#--#---##-------------------------#--#------#-#--##-----------#-##---------#---#-###-###--###---####
---###--------#-----###---##--#--#-##-###-----##-##-#--##-#--##-----#----#--#---------#------#------
#------------##--#-#----------#--####-#--###-#--#--#-#--###-----#-----------#----------##--#-#---#-#
----#-------#-##---#-----------#-----#-----#----#----##-#-#---###--#-------#------#--###---###-#-#--
-###--#--#-###-#-#--------#--##--#-#--#-#--###-------##---#--#-------###-------#---#-#----#-#---####
#--#--#--------#---###-##---#--------#-------#-##--#------##-#---#---#--#-#-#----#--#----#--------##
---##---#-###---#----##----------##-#-#----#-#--#--#------#-###------#---##-#-##--#--#-#---#--##--#-
-#---#---#-----#---#---##--#####---##---##--#-#---##-----#-#-#-----#-----#---##---#--#---##---#--#--
#--#--------#------#------##-------#---#----------#-----#---#-#-#------#------#--###--##---------###
-#--#-##-###----------###-#####--##--##------#-#---##--###-#--------####--#-#------#----##-##--#---#
#-##--#--#----####------------#--#---##--------#---#--#--###------####--#----##---#-#--------#--#---
#---#-#--#-#---#-#--##-#---#-###---#-#----#-----###-##---##-###---##-#--#-----#-#-#------##-#---#-#-
##--------##-#----#------##---#-#--##------#---#------##--------#--#-----#-----##-----#---##---##-##
---#--##---#------#-#---##--#------##--##------##-#------##-----##------#-------#----------#---##---
##------#-##--#----###-#-#-##--#----##------##--#------#---#----###-----------------#----#-#----#---
##----#--##---#-##--#-##--#--#--#-#---#----#-----#-------#----#----##-##----##--####-------------#--
-----##------##--------#-##----#--#--#---##-#-#---#-#--#--#----#---#----#--------------###-#--#-#--#
##-#--#-##-----#---#----##--#----#------#----##-#--##-#-------#-##--#-#--#-##----#####-#---###-----#
-#--#-#---#--#--##---#----#----##-#---###------#-#-----#-##---#----------#-#--#-#-#-#-----#-----#--#
-------#------#---#-#--###-------##--------###--#----####------------##--#-#---#-#---#-------------#
-###--#--###--#----##-##------#--#------#-###---#---#---------#-#-#----#---#-#----#-#-----#-----##--
-#---#-#----#--##--#----#---#-#-------##---#-#---#--------#-#-#--#-#--#--#---#----##--#-#--##------#
------#-----##----#--#-###--#-#-##--#---#-##-------#-#-#--#----#-#--##----#----#----#------#--#-----
--##------#--------#----#---##-#-#-#-#------#-#--------#---#-----#----##-#-##----#----#--##-#----#-#
#--------#---##-----#--#--#----------#---#--#-----#-#####---------#-----##-##-#-#-#-#----#----#-#---
##--#---------#--------------##-#---###--#---#-###----##--#-#-#-##----##-#----#-##--#------#-------#
#--#-#---##----#-#----#-#--#-----##----#--------#-----##----#--##--#---#----#-#-----#----#----#####-
-----#---#-#--#----###--#--#-------##-##-#------#-##------------#--------##---#-#-#----#---#------##
-#-----###--------##-#-#-----##----#-#-------###----#-#-###----#--##-----##---#-###----#-----##-#---
--#--#-##------###--#-----#####---#----#-#-#---#####---#-#---------#---#----#--#-##--#----------#---
-#-----#-#-------#-##-#-#--##------#---#-#-#--##-#--------##------#----#---#---##----------#----#-#-
##--#-----##-#----##---#-#-----#--#----#-#----------#--#-------##--##-#--##----###---#---#----##----
#-#-#-#--#-#------##----#---#---#----#---#--####------------#--#--##-#----#-###-----#---##--##---#--
#---#-#---##-#--#--##---#---#-#---------###----#----#-----#--#----#-##---#--#---#--#--#-#----#------
-#---#--###--------#--##-#-----#--##-#----#-#----#------#-###-#----#---#----#-#-##-#-####-#-----##--
---####-##-----###----#--##-##--##-#-------##-#-------#-------#--#--#-#--#-##--#--------#---E-----#-
---------------##-----------###-#--------#--###--#--#---##---#-##------#--#--##-#--##-------##---#--
-##-#-#------#---###-#-#--------#---#--#-#-#-###---##--#----#---#--##-##---##--#----#-#-#-------#---
#-#---###-------#-----##-#-##-#---##-#--#####------##---#-#-####-------#-#-------#------#-##-#----#-
#---#--#-####-#--#-##----#-#---------###--------##----####--#-----##----##-#--------###-----#--##---
-#---##-----###-----#--#---#-##---###-#------##---#--#---#---#----#----#-#---#-##-####---#--------#-
###---------#--#----------#------#--#---##--#-#-#-----#-#-#-----#--------##--#-#-#--#--------###----
--###------#--#---##-------------##--####-###-##--###------#-----##----#----#--##--#----#-#-----#---
---#--##------#---##---##---------##---------S#--#---------#-##-----#-----------#-#--##------#------
--#-##-#---------#--#--#-#------#-##-#--#--#---##-#---#--#--#------#------##--#---##--------#-----#-
-#-###--#---###-#---#---#-----#--##-----###---#--##------#---#--#-----------------##--#-##----###---
-----#-----#--------#------####--#---#-#--#------##--###-#--##-----#------#----------#-#---#-#----##
--#-#-#--#------#---#--------#-#-------#--##-#-#---#-----##----------#--#--##-----#----#-#---#-#---#
-#--#-##----#----##-##-#----#----#---#--#--#--#----#-##-##--#------#----#-###---#-##-#####---##--##-
-##-#----#--#-#-#----#-##---#-----#--#-##-#---------##-----#-------------------------#-#---#--#--##-
##-##--#-#-----#-----##----#---#-###----#---------#-#-#--#---#---#--#---#----#-#-##-##--------##----
#--------##-##-#-#--##-----#--------#------#-#--#----#-##---#-#-##--#-####-------#-#--#--###-####---
#-###---------##----##--#---##---#-#------##-##----#-----#-----#-----###---##---------#----#---##---
--------#-#-------#--#----######-#-----------------##--###--#-#-#----#-#---#-#--#---#----#--#-------
#-----##---#---#-----#----#--##--#--#---------##-----#----#-##--##---##--##-#-#------------###-#-#--
----##-#----#---#---#----#--#---####------#----#----###-----#-#-#---#--#-#---#---------#--#----#---#
--##--#-###--##---#---#---#-#----###---#-##----#-#-#-------#--#------##---##------#--##--#---#-#-##-
-----#---##-##------------#----#-#---#----#---#-----#-##-----#----##-#-#-----##---##----#----#-#----
#------#--------#--#--#--#-----------------#---#--#-##-#---##-#------#-----#----###----#---#--#--#-#