?diagonal=Never;
---#-----#----------#-#----#-#--#-#--##-#-----#-##-#-#-#----##--##---#---##----#---#-#--#-----#-###-
---------#####---#----#----#--#----#-----#-------#-------##----#----#-#-#-#-#-##---#------#-#-#-#---
##-----##--#-##-#-#-----#-----####-##--#-----------#-#---##-#-#--##-#-####--#-#-#----#-------#-#-#--
-##--#-----#------#--###-###----#-##-----#--#-#-#------##---#--#---------#-##--------#-#-##--#-##---
-#--#---#-#---#-----#---------#------##--##-------#--##-#-#--------##---------#----#-----#---##-###-
-#--------#-#-#--#-##------#----------#-#----#-------###------##----##----#---##-----#-#----#-------
---##---#-#----#####-#-#----#-#--#--##---###----#--#---------#---#---#--#--##---##--#-#----#--#----#
-#-#------#--#---#---#---###--#----#--#-#-#--#-#-#-##-#------##-------#--#-----###---#-#------##--##
--##-##-----#---#-#-#----#-----#--##-#----#-#-#-##--#----#---#---#--#-----##----#--#---#----#--#-#--
-#--#------#--------#-#---#-#-----#----#-#----#--###-----#-----#-#-----#--------#---------#--#------
-----#-###----#-----#--#--#-#-##----#-##-##--#--##--#---#-#-#----#--#---#-----------------#-------##
-#--------#####--#-----##-#####-#-#---##-#---#-----#---#-----#-------#---#---#---#-#--------#----#-#
---#--------#-------------###--##----#-#--##--#-#------###---#-##-#------#--------##--#------##--#--
-----#--#-------#----#-------------###---#---#----#-##-------#---#----#####-#--##----#--#-#--##----#
--#------#-#--#-##-----#-----#-----#--#---#------#---##-###-###-----#---#---#-#------#---------#----
-#--###--#-##----#---#----#----#------#-------#--#-------##--#--#----#----##----#-#-#----#---#--#---
-#-#---##----------#--#-#-----#------##--#----#---##--#---#--##---#-#-#---#--#-#--------#-##----#---
#-------------#-#-##--#--#-#----#----#-#--#----#----##----####-##----#-----#--##--##------------#---
-----#--#----#--#----------#-##--#------#-##-###-#-##-##----#----#-#-##--##-##-##-#--------#--##----
-#--------#----#---###-##--#---#---##-#---##---#-##---#--##-##--#-------#-###---#-#-#-#-#-------#---
---##------###---###------#-------#---##--#--#----#-----#----------##-#----#--##-#--------#---##--#-
##-#-----##-#--#--##-#####-#--#-#--#--#----##--------#-###------###-#------#---#--#---------#-#-#-##
----##-#--#------------#----##---#--#---##---------##-----#-----##-##-------#--#--------#-###-------
-#------#--#------#----###-----#-#----#---#-##----#-#------###--#--#--------#-#-#--##-----#-#--#-#--
#-##---#--#---#--##--#--##-#-##-----##-###--##-----#----###------#-#---#-#-#---#--#-#-#-##----##---#
#####---####-#---##--##----#--##--#--------##-#---#-#---#-####-####------#---##--###-#----###---#--#
----##-#--##--###-------------#-#--#--------##----##---#--#----#-#-#-------#-##-#-----------------##
-###-----#-----#-##---#-#-----#-------#------#-----#-#-#--#--##---##--------#-------------#-##---#--
--#-###-#--#---#-##---#-----#-##----#-###--##-###--#----##-----#--##-#-#-------------#----#-----#---
#-#-#--------#-#--#-##--#----###---#-#--#-------#--#--#--###-#-######--#-#---#--##----#-#----#--#-##
--#-#-#--#----#------#-#-#--##---##-#-#----#-##---#-##-----#-#----###---------S##-----##----#----#-#
---##--##--#-#----#--##--#---#---#-----#---#-##------##-##-##-#--#---#--#-#-###-----#----##---##----
#---##-------#----#---##--#---#-#-#---##-#--#-#-#####----------##-###-##-##-#----##-#----#--#---###-
-#---#-#--#--##-#--#-----#-----####-----#---###---#--#--------#--##-------#-------#-------------#---
#--#--------##-----#---------#-----#--#---#------#-#----##----#--#--------------#-----######----#---
-##------#-#-#-#--#----#-#-#-#---##----------#--##------###-----##--------#--#--##---#---#---#-#-#-#
--#--#---#---#------##------#--#--#---#----##-#----#-#-#----#-#-----#---###--#---------##-#--------#
##--#-------#--#-##----#---#--#--#-----#-----------#-#####----#---#---#--##---#-----##------#-------
#--#---#-#--#-#-#-##----------#------##--##--##-----#--#--##--##-###-----#----##-----##-#-#--#---#-#
----#---#-###----##-#---#-----#--#--##---#-#---##-###------#-----##--------#---###-#--#---------#---
-#--------#---#--#--------##--#-----#-#-----#-#-#-#-#-----##--##---##---#-#-----#---#------#--------
-#------#---##-----##--#-#-####-####--------##-#-#--#---#-----###---#-#----###-##--#----#-------#--#
----------#-----------------#--#-#-##-------#-#-#--#-#--#---####-----#----##--------#-#-------#-----
------#--#---##-#-#----#-#--#---###----#---#-#-#----------##-#--#--#-##-##-##---------####------#--#
---------#--#-----------#-##---##--#----##---#---#-#--##------#----------###---------##---##---#-#--
##--------#--#--##---#----#---###----##-##--#--###----#-#-#---#--###------#---#----##---##-#-------#
----#-#-----------#--#-#--#-#-#--#-#------###--#----#--##--#-#--------##------####---#-----#-#-#-##-
#---#-#--#-------#-#----#--#-#--####----------------###-#----#-##-------#-#---#----#-##-#----##-#---
----#-#--#-##--#------##---#------####-#---#-###-----#-##----##-----#-##------##---##-----#--##--#--
###----##-#------#---##-#------------#-#--###---##--#-#--#-##---#-##-##---#--#--#--####--##---#-###-
--#-#---##-#-#####-#######--#-#--##-------##--##--#-#----#--##-#--###---#-##----##-#--##-##-#----#-#
#-##----##---##----###-#---------##---#-----#-###--#--#------#--#---###--#-----####------------##--#
-#--------#-#----#---#-#-------#-##-----#----------#-###---#------#-#-#-##----#---#-##-#-##---###-#-
----###-#--###-###----#-----#-#---#-#-##--#-#-#------------##--#----#--------##---##--#-------####--
##--#-#----#--###-#-##-##--#-#-#---#--###---#-------------#---##--#----#----#--##-#---#-#--##-------
-#---#--#-#----#---####------#---#--#-#---#--#---#--###----#-#---#----#-----#--#-##------#--#---#--#
#---------#--##---#-#--#-------#----#-#-#-#---#---#-##-#-#--##---#------#----------#----#-------###-
--#---#-#-----#-----------#---#------###---------#--#--#---###---#-#-####---#-#--#--##-#---#--#-#---
-####-#--#-----##-##--------###-###---#-#-----#--##-#-#----#----##---#------#-----#---#-#-##-#---#-#
-#-#----------##--#---#-------#-#------------#---#-##---##---#--#----#----------##-#-----##--##-----
-##------#--#--#-----#-##--#--#------#-#------#---#-----#-#--####-##----#-#--------##----#---#-##-#-
----------#-#--#-#####----#---##-----#----#---##-----##---###-#-----#-#-###-#-----#----#------------
----##--#-#-#-#-----#-#-----##--#--#---####----###-#--#---#---#---##-###-#------#--------#------#---
#----#---#-###---##-----#-------#-#----###--#-#------#---###--#--###------#----#--------#-----#-#-##
###--#---#-##-----#--###----#-----##---#-#-----#--#--------#--#---#------------#--------#--##-------
##---#-#----#------###--------##-----#-#-#-##----##-----#-------#---##-#----#---#-#---#-----##-#-#-#
-##-#--#--------###------------#----#---------#------##--#----##--------#-----##--##---#-----#-----#
#-#-----#-----###-----##-#----#-----#-#-##-------###-#-##---#---#-#-####--####-#-##--#---------#--##
----#--##--#---------##-#--#-----#----#--#----##-#-#------------#--#--#--##---#---#-#--#------#-----
-------#----#---------#----------#-##----#--#-###--##--#---------##----------#-##----##-#-#-#---#---
--#-#---##---------------#-#----##-----#-##-#-#-##-----##----#----#---#-#--#-#----#--#------#-###-##
--#-#----##--###-#-#-#----------###------#--##-##--##--##--##-###----#--#-#---#-#--##----####-------
----#-#--#-#-#------#--#--#------#---#---##--####--#----------#----#----#--#-----#------------------
--------#---------#---###--##----##--#---#-##----#----#-##-#-##----#--#-#-#--#----#-###--##-##-####-
----#-#----------#--##---##---#-#-#---###---##--#--#--#---#--##----#------##------#---#---#-------#-
--#---###----#-------##-----------#-###-###-----#--##---------#------#---#----####-####------###-#--
-#--##---#---#----###-----#-#--####-##------#--#-----#--#--#-#------#---##----------####----#----#--
--###-###--#-#-#-----------#----------#-----------##--#----###---#----------#--###------#-#-#-#--###
--#-#-------#--------#--#-#-#-#---#--#-----#---#-#-#---------#---#----##--#---##----##---------#--#-
-------#-----#--###-----###-##-------###------------#---##-----##---#-#-#--#-----#-#-###--------##-#
-------#-#----#-##-------##--#----#----#--#-------#--##------##----------------#-##----###-----##--#
#--##---------#-----###---------#--##--#-####----#####-#-#-#-----#-----#---------###-#-----##--###--
--#------------###--#----###-#-##-----#-##---#-------####--------#------#-##-#-------#-#-----#--#--#
-------#-#--------#---#-------##-----#-------#----##--#----#--#---##----#-----#-----#----#----#-----
----##------######-##---#---------#------###----#---##-#----##----------#-##--#--###-#----#------#-#
---##-#--#-----#------#-------#-#-----##----#----##----#----------#----##-----#-#---###--###-#-----#
-------###---#---#--##-----#-#---#-------#--------#--------##----------#--------------#---##---#----
--#-###---##---#-##----##---#--#-#-----#-##--#-#---#----##--#--#-#-#-------#--###--###----------#-##
#-###------##-#---#---#------#------#--#------#-----#--##---#----##---#----E##---##----##-----#-----
-###----#---#-#-#-###----#-#-----##--#-#----------####--##--------#----#--------#-------#--##-###--#
#------#--#-##-------#---###-----#------##---#--#----#-######--#----#--#------##--###-----#---------
---###---###-#---------#-----#-#-------#--#----#--##------##-##--#---#-#--#---##--#----#---#---#---#
--##------##--#-##--#---#----------#---##----##-#-##----#---#---#-------#--#-----#--#-#----#-#-#----
--#-#-#-####--##---#------#--#-----#-##-#--##---#---#-##---#-#----------#--###-#---###-###--------#-
##-----#----------#--#--####---##---------#---#---#-------###-------##---#---#----#---------##----#-
--#-------#---#-###---#-##-#-#--###--------#-----##-#-----###-#-----#---#--##----#-----#------#--#--
-#--##----#--#-#------------##--#------#-#--#--##---#--#-###--------------------##-#--#-#--#--#----#
--###---------------##--#--#----#------#-#--#-##----###---#-#--------##-------#----#--------#------#
---#----#---#-----#----#-----#---#--#----#-----#-#--#-#-#-----#--------#-#----#------#-----#-----#--
----#--#-#-#----#-------#--##-------#--#-#----#----#--#----#--#-------#-##----#-----------#---#--#--