?diagonal=Never;
##-####--####----##-#--------#---##-#-#-----#-#-#--###--##-##--##----#-#--#-#--###-#-#------###--#--
-#---#-#------#----#----#--#-#---##-#-#-----##-#-##--#-------#-#--#-#--#------#-###-###---####---#--
-----#----#-##-#--#----#---#-----##----#---#----#------------#-#-##-------#---#-------##----------#-
#--#------##---#----##---##-#--##-#------------#---##----##-----#-#-#-####------##------##--##------
---------#-##----------#--###-----------------##-----#--------#--#-#--#---------#-#----#----####-#--
-----#-##--##-#-#--##---#--#-----------#---#-------------##----#-###--#------#----#-#--#######--#-##
----------#---##-##------#----#---##--#------#------#-------------#-#----###---##-------#--#-###----
-#-#-----###---#-#---------------##--#-##-------##-------##-----###-##----##---#---#-#---#------##-#
---##---------##-----#-#-------#--###----#----#---##---#--#--#-###-###------#--#---#-##--#--#---#-#-
----###-#--------------#--#---##----------##---#---#-----#--###-----#---------#-####-##---##-#---#--
#---#-----##-------#-#--#--#------#-#-##-#-----------#------##-##-----##--#-##---##-#---#----#-###--
----#-#-#---#-#----#--#---------##-#----#-------#-#-----#--#-------#------#--##-----#---#####-##-#-#
-#----##----#-----#--#--#--------#-#--#---#--------#-#---#-#--#--#--#-#-##--##----##------##----#---
#------#-#-##---#-####--#--#----###--#-----#-#---#-##---##--#------------#-----##-##---#-#---#-#---#
-###-##------###-##----#-----#-#------#-#---#--#-#--##-------#----##--#---#----------#--#-----------
###--#-------######--#-------#-------#-##----##-##-#--#-##----#---------#----##-----#--###-----##---
#-#--#-##-#---#--#----#--------##----#----##-#-----###----##--#---###---------#------#----##--#--#-#
-#--##-----#-----------#--##-----##-##-#-##---#--#-#--##---#------##--#--------#---#---#---------#--
#---#--#--#--#-----#----#---------####---###--###----#-#------#-#-##-#---#####-##--##----------##---
--##-----#------#-#---#--#------------#-----#-#---#------##----#-#---####-###----------##-#-#---#-#-
--##--##----#-#----#--##----#-##--#-----#---##-#---#-------#-#-##--###---###-#--#---#--#-#---#-#-#-#
--#--##-##-#---#-----##-#-##-----##--#----------#---#------#-##-#-----#-----###--##--#-###-#-##-#---
------##--#-###---#-#--#--#---##----#--#--#---#-#---#----------#---#----------###---#-------##-#--#-
-#--#---#-------##----##--#-------#--#----#-----#-#--#------####----#####-#---#-##--#-#--------#----
-#-----#----###-------#-----#--#---#-----##----#-##-----##----#--###----#----#---#------#-#--#------
-------#---#-#-#--#---#-#-##--#---#----#--#-##----####-#--#-------#--#-----#---------###-###-#---#--
----#--#---###-##----#---#-----##-##---##--#--------#--------#--##--#-##--------------##-##------#--
#------#-----#-#--#--#-#-##----------##---#----#-#---#--#--#-------#-----##----#-#-#-###-##--------#
--#-----#------#--##--#----#----#-----###----##------------##--#--#---#-------#---------#----------#
#---#--------#----#----#--##----------------#---#-------###--#-###-###-####-#-#---------#-#-#-###---
---#--#-#--#----##---#-----------#--------------#-#-#---#---#-#----#-#-----#--#---#--#-#--------###-
###--#-###-#----##-###-#-----##--#---#-##--#-----#--#-#--#------#--#-#-##-------#-----------#---#--#
-#---#--######---##--#--#------------#--###---###--#------#-#-#----#------------##-#--#---#----##-##
--##--#####---#-#---#----#------##-#---##-#--#--##--------#--#----#--#--#----##---##-----#---#----#-
-##-----#-#-#-##--###--##---#---####--#----###---#------###--#--------#---#------#------#-##----#---
---#---#------##--#-#-#--#---#-#------##---###--##-##-####-##------#--##-#--#---#-------#------#----
--#--#-#-#-----#---#---##-----#-#--##-#--#--------#------##------###----##----##-##------#---###--#-
##-##------#--#-------#--##-------#---#-------#-#-----#------------#--#-----#-#--------#--###----###
###-----#------##-----##--##-#---#----------#-----#----##--##-##-#-#--#------##---##----##---------#
-#--##-----#-#--#-----#-###---#-------#-----------#--#---##-#--#--#--###--#----#---####--#---##-#--#
--##--#--##-##----#---#----------###-#-------#--#--##--------------##---------#---#-#--------##---##
---#---##-###----##-###--###--#--##-----#-#-#------#--#--###--#------------#--##-##---------#---#---
##------#--#--#--#-----#--#---##--------#---#-#-----##-----#----###--##-----------#-#-#-#-----#-----
##-----##-#####------#----#--#--#---#--##--#--#-#-#---#-------#------###-----#-#---#--####----#-##--
---#------##-##-#-#------#--#--#--------#----####---#-###-#-----##----##-#---#-----##----#-##---#-#-
##--------#-#---#--------#-#--#---#----#-##-------------------#---#--#----##-##--#-#-#---#--#----#--
#-------#----#--#-#--#------#-#--#--##--#------#-#-###-----#-------#----###------#--------#--##---##
--#---#-#----#----##-###----###-##----#---#---------#-------##-#-----#--#----#-#--#####--#-##-----#-
-##--#---##-##-#--##-#----##-#-----#--#-#--##---#--##--#-#-#--#--##-#----#-----##-#-#-#--#------##--
#-#------#-------#--###----##------#------####------#------#---#----#-#--#------##----#---#-####-#-#
#------------##--#-####-----#-#-------#-#-###----####----#---##------##--###--#----##---#-#-------#-
----------------##------#-----#------#--------#-------------#-----------#----##-#-#---#----##---###-
##-###--#-#------##----#-####-#---##--#-----#-#--#-----#---#------#------###---##----#-----####-----
----#-#-----#--##-----##---##-#------------------#--#--#-#---##------####-------###--##--##--#-----#
---#-#-#-----#---------------#----#----#-#-#--------##--##---#-------#-----#--##-#--##--#---#----##-
#---#-#----#--#-#--##--------#-##---##---------#----------#----#---#-#-##--#----##-#-##-#-#----##-#-
##--#-#---#--#-#-----------------#-#-##--#-----#--#--##-------#-#-#--##--#-#-####---#-#--#--#-------
--#----#--#----##-#------------#-----#-#------##--#-#--#-----#---#-#---#---#-##----##--#----#---##--
##----##---#---------###--#---#-#--#---------#-----#--#--#-##--#-##--#-#-------#-##---#-#-##--##--#-
---#--#---#-#-------###----#-####-----------##-#-#---##------#-##-#E--#-#----------#-##-##---------#
-------#-#--#--#----##-----#-#----#------#----#------##----#-------#-----#-##--#--#--#-#--##-#------
---##---------#---#---#-#------------#----#-#-----#-----#-###---#--#---##---#-#--##-----#-----##----
--#----###--##-----------#------#-----#---#---#--#--#-#------#--#--#-#--###---##-#--#---#----#------
--#----#---------###--#-----#-#--#-#-#--#--##----#-----#--##-#--#--------##--#------#---#-#-#----#--
---#------#--#--##-##--#------##---#-##-#-----#-------#--#---------#------#-----##-#-#------#-#---##
--##----#-----##--#-----#---------##--##-----#----#--#--#---#--#-#---------#---------------#----#--#
--#---##-#---#--#---##-#----##-#---##-------------------#--#----#------#--#---------#-##--##---##---
-#--#-#--#--#-----------#--#-#-##-----#-##-##----#------#--#-----#--#---#--#--#-#----##-------#---##
--#---###--#-S-#---#---#-##--##--------#-----------#----##---#----------####----#-#--##-#-##---#----
-#-#-###----#--##--#-#---##-------#---#--##-#-#-#---#----##-##----------##-#-#--##------##-#--#-#---
-##-------#-#-#------#---##--------------#--####-----##----#-#-#-------#---##-##--#------------#-##-
----#--##---##-###-#----#-#--##-----#-#---------#-#----#--#-------#---------#--#-####---#---------##
#--#-----####---#----#-#---##------------##--#--#---------#-##-##-#--#------#-#-#--#--##-###--#-#---
------##--##--------#----#-#--#-#---#-----------#----###--##-##---#-###---#-#--##-----#--------#----
---------------##------#------##---#--##-----#--#------#--#-##-#-#---#-#-#--#-------#--##---###----#
#--#-##-#-#-----##----#-#----###------##-###------#----#####--##---#-#-###----#-#---#-#----#----#---
--#--##--#---#-#-----#--#-##-#-#-#--#----##-#-------###---##------------#------#--#---------#---#---
---------#---##----#-##----#-------##---#----#--#-----#-#-------------------#---#-----#-----###-#---
----#-##--#----------###--#-#-###------#--------#--#-##-#-----#--#--#-#----#---#--##---#--#--##----#
-##--#--------#-####----#-#----#------#-#---#--#------###-#-#---#--##--##-#-####-----#-#----#-#-----
#----##----#----#-##--#-#--#------###----#--#-----#--##-#--#--#-#---#-#--------###-#-#--------#-----
#------#-###-----######--###-----#-##--#----------#-#-#--##-----#--#--#-##-##-----##------##-###-#-#
-#------##-----##---#---#---#---------#--##----#---#---##---#------#-------#-#--#-#--#-#-####-----#-
----------------#---###-------#--#--#--#-#------##----###--#-------##--#--#-------#--#----#--#------
----#-#---#-#---#-#--##------#----##--##----##--#---#-#---#-#-#-----#-----##-##----#-#----#-----##--
-#--##-#------#--#----------##---#----##----#----#------#-------##--##--#-------#-#---#----------#-#
#-------##---#--###-#-#-###-----##-##-#-##----#---###--##---#--#-#--#--#----------#----------##-##--
--###-#----####---##--##----##--#---#--#-##---###--##--#---##-#-#----------#---#-#-#-------##--###-#
###--##---##--#---#------#-----#---------##--#-#---##-#-#-------------##-####-----------#------#--#-
--##--------#-#---#----#----#-----##---#------#---#---#--#---##--#-#-##----#-#------##-#-#-###----#-
-##-#-##--#---##-----#-------#-#--------#---#-#-#-#--#-------###--#--#---#---------##---#--#----####
---###------##-#---##------#--#------#--#--#####-##----##---#-#-##----##-#--####----######-----##---
#----#--#--#---#--##---------#-#--#------#-#-#-##-#-#---#----#---------------####--#---#----#--#-#--
------##--#-#---#---#--#-#-#--##--##-----##-----------###----#-#------##-#----#--#----------#-#-----
#-#-##---#-----#--#-------#-#---#-----##---###----##----#-#-#----#-####-------#--##---##--------#---
-##--#-----###--#------###--##----#----#----##-##-#-----##-#--##--#------------#-#--##-###-----#--#-
------##--##-#--##-#--------#--##-#-#-#-------#-#--------#---#-#-#--#-##--#-----#---#-#-#---#-#-#--#
#-###-##-------#--#--#-----#--#####---##--#------#-----#---##--#-#----##-##---#--#---------##---#-#-
-###------##-#------##-##----####-##------#--#----#-##----------##------##-----#-#---###-###-#------
#-#--#-----#-----#-##-----#-#-##----#----#-#-#---#--#-#-----#-#---#----#-#--#------#---##--#------#-