?diagonal=Never;
----##---##-----#--#-#-#--------##----#------#--##--#----#-#----#-----#----#----#---#------##-##----
-------#--#--#--#-##----#--#--#----##------##-##--##----##-#-------#---#-#-#-###----------#--#-----#
#-#-#-#-#-----#----#--#-----#-####-#---#-----##--#-----#-#----####---##-#-#--#--#-#---##--##--#--#--
------#-#-#-#----#--##-----###--#------#-##---#-#-#-------------#-##----##-##-----##---#-#-#--#---#-
-#---#-------###------------------#--#-##------#-#-#--#-------------------#--#-#-##-----##----##-#--
#-##-##----###----##----#-----#-------#-####-#--##---##-----#--#-----#-#-------#------#--#----#----#
#-####------###-##--#--#--#----#--#-#--#-#-#-----######------##-------#-#-----#----##-----##--------
-----##---##-#----#-#----##----##----##-###-----------#---------##-----##-#-##-#-#---#-------#-#--#-
-#---#--#-----#--#-----##-#-#---##--#--#-#-#-#----###---#----------#---#------####--#----#----##----
--------------#-#-----#---#----------##-#-#---#-#--#------#-#-###----##-#-#--##----##------#-#-##---
-#--#-----#--#----#--#--###-##--#----#--###-----#---##--#--#---------#------#--#-##-----#--##----#--
#-#--##----#----##-#----##---#----#-#---------#-##-##--#-#-##-#--##--------#-#-#-#---#-####-##--#--#
----------#-#---####------------#-##--------#--#----#------#---#-----------------#--#--------#--#---
#-#---#-#-#------#--------#----#------#--####---------##-------#---#------#-#--#----#-------####-##-
#---##---#--##------#-#-#---#-####--##--#-#-#-#-##-----#---#--###-#----#--####------#-----#-----#---
-#-#-#---------#-#-#------##------#----##------#-#---#-#--#----#---------##-----#--#--#-###-------#-
--##---##---#------#---------#--###-#--#-----#--##-##-#-#--#---------##-----------------#--#------#-
-##---#------###-##-#---#-##--###-#-#----##--#--#-----#------#--#-----#---------##-------##--###--##
--#-----#-#-#----#---------##-#-----#-----#--#--#----####-------#--#-----#-----##----##------#--#---
#-----###-##------#---#--##-#-----###---------#-#-#---#----#-###-----#---#----#----#--------#-------
#--------#------##--####-----##-----#-#-#------###------#----#-#--#-##---------##--#-#--E------##-#-
----------##-####---###---##------##-#-#-##-------#----#----#---##-----------#------#-----#--#--#---
#-#-#--##----------#-#---##---##-----#----#----#--####--##--------##-#---##----#---#--#-#---------##
--#-#------##--##---##------#-------#---#---#-----#---#-#--#-----------------#----#--#-###-------##-
#----#-------#---------#---#--------------#--####-----#-------#-##--------##---#-#-##-##-------#-#--
-#-#-------##--##-#----#------#--#--------#--#---------#---##--------#--#-##-----#---#-####--##---#-
------###-------#-#--##-##-#---------#----#---#-#--#-#-##-----#-#-----##-#-------#-#----#-------#---
-------#---------------##--##--#-#-#-#-------#-#---------#---#----#----#----##-##-##-##--------#----
--#-#---#--#-----#------#----#---#-#------#-#-----##--#---#---##-##---------------###--##----#-###--
#-----#-#-----#---#--#--#---#-----#---#--#---##-###----##--#---#---#-##-----#--##-------####-----#--
--#-#----##--#---#####--#-##--#--#-----#---#-----##----###-#-#--#------#-------#---#------#--#---#--
-------#------#-#-------#-#-#--#-##-##---##--##--------#-###--#-------#-#-----#--------#--------###-
-#--------------#----------####---------#-#------##-------#----##-#-#------#--#---#-----#--##-#--###
--#-#--#-----##--#----#------#----####--##-#------##------###----#----#---##-------#---------------#
#--#-#---#----#---#-#--#-----##---##----#----#---##-#-#-------#-#--#-#---##-#---------#-#-####----#-
---###-#---##----#-##--#---#-##----#--#-#----#-------##-#-#---#--#-#---#-#--------####------#---#---
---#-#--------------##-##-##-#--#------#-#--#-------#----#--------#--##----##------##----#-#----##--
#------#--#--#--###-##-#---##--#-#---------##--####-#-#-#---#--#--#----##--#-#---#---##-#--------##-
#-###--#-#-#--#------#------##--#-#--#-#--###----#-###---#--##-#-#-----#--##-###-#--#--#-#-----#--#-
#-##-#---------#-#-------##------#-#--##-##-#-###------#-##--#-#-##-----#-##---#--------#--#--#-#--#
---#-#---#-###-#-#-#---------#-----------------##-----#---#-------------#-#----#-----#----#----##--#
---#--###--#-##--##------#----####-#-#--#-#--##----##--#------#####-###----#--##--------#-#---------
--#--#---#-##-----##------#--#--#----------#--#----#--#----#---#-----#-------#---#-----###---#-----#
#-#--#--##---#----##---##-#---##---##-###------#-------#-------#--#----##------#--------#----##-----
----#-----##--#-------#----##-----#----##-#-#---#-#-##--##-###-##----##-------#-#-#---#--#------#---
#-----#--#-#-------#-#----####-#---#-#-#---##-#-##---#----##---------#--##------#-##---#----#-------
--#-##--#--###--#-##--------#---------------#-#-#---##-##-##--##---#-#-#----#--#--#-------#----##--#
--#-#------#--#--#--#--#------#-##------##------#-##-#-#---###----#--##----#--#------###-#--#------#
------------#-#----------#-#-##-------#----#--##--#----#-##-##--#-#---##----#-----#-##--#----#----##
--##---##---#-#---------##-#--#-#--##-##-----#----#-#-------##---#------##----#---#----#--#-#---#---
-##-#----------------#--####--------#--##--#-----###--------#-#--------#------##----#-----#-##---#--
-#---#-#--#--------##--####--#--#-------##----#-#-------#-#---#------#-----#--##-#---##---##------#-
-##----#---#--#----#-###-###-#----#-----------###-#------#-#--#--##-#--------------#--##----#-#----#
-------#----##----#---#--##--##-#--#------###--#-#---##-#--------#--#----------#-#--------#-#--#--#-
-#--#-#------###-##-#---##------#--##-#--#---#--#--#-------####--#-#--#---#--------##---#-#-#---#-##
##----#----#--#--#------#-#-#-#--#--#-----#-##-#---##------#----##---#-#-#-#-#--#--------------#----
---#----##-##---#####-#--#--#-#----##---------#--#-#-#--#--##---#---------##--#-#-------#----##---#-
##---#-#----#---###--#-#-######-#----##---------#----#---#-------#------#--#------####---#---#-#----
####-#-#-###-#---#--#---#---#---------##-#-##-#--##------#---#----#-##-#----#--------------#-----##-
#---####--#-#--#--###-#---#-----#-#-#-###--#-##-##-#-####--###--#--#--#---#--#---#--#----#------#---
-#-#-----#####-###--#-#-#---###-##-##-------------#---#-#-----#-------#--#---#---#--#-#--#-#------#-
##---------#----#---#--##---#-----------#--##-#---------#--#---#-##----#---##------#-------#-#----##
##-#----##---#-##--#--#-#--#--##-#-#---#-----#---#----#--##--#--#------------#--#---#--#-------#--#-
##--##----##-##-#---#--#------##-#--##----#-#-----------------#-#-#---###--##---#-#--#----###-------
#-#--------###-----#--#-###--#---#-----------#---------######---#---#--#-#-#-###---#--#-#---------##
-----##-##-------------#---#----###----##---#--#-------#-----#----#--#--##-#----#--#---------##-###-
--##---#----#-----###---#--#-----------##-###-##-----#-#--###--#--#------#------#--###---#-----#----
---##--#-----#----#-----##--#-##--#-#-#---#-#-##---#---#--#-##-----##-----###--###--#---------------
-#-#----#-----#------#---------###---------##------#-----#----#-#-###--#--#-##--------#-----#--#####
-##------------##---##-####---#-#-------#------#---#-----#-####--#---##-----#-#--#---#--------##----
-##-####--#--##-###------#-----#---------#----##--------##--#-#------#---#-----#--#--##-#-##-##-##--
#--#--#---##-#--#--##---------#-#-#-#-##----#---#-#-----------#---#-##---#------#-#-##-----#-#---##-
--##---#--##-------#-#--#-#--#-##---#--#-#------##---##----------------##--#--#---##-#-----#-----###
#----#-#-#-----#--#---#----#--#-#----#-#--#---#----------###---#--#--------#--##-####---------#-#-##
#-#---##-----#-----#-#--#-----#-#-####-#--#--#-------#-#--#------####----#-#----#---#---####--#-----
----###-----##---##-----#---#----#----#-#--##-#--#--#-###-###-##--#--#---#-------------#----####----
-#--###--#--#--#---#--#-#------#---###-----##--#-#-#---#-###--#--------###-#--#--#####---##--#-#-#--
--####----#----#-##-----#-##--#--#-#---------#-----------------#--#-#-----###-------#-######--------
------#-##--#--###--#----##-##-#--#-#-#--#-##--##-##--##-#--#-#-#-------#---------#-#-##----####--##
-##--##--#-------#--------###---#-#--#--##--###------##----##-#----#-##-##------#-#----------#-#--#-
---#-#--#--#-###--#####------#----#-#-##-#---#----------##-----#---------#-----#-#----#--####----##-
--#----##---#---#-#----##-#--#-#-##-----#-####-----##---#-##-#-#-------------#---#-##----#--#----#--
##-#--#---##-#---#----#----##-----S--#-----#-----####-----###-#----#-##--#--#-#--##-##--##-#--##----
#-#---###-#----#------#--#-#----#-#####--##---#---#---#-#-##--#--#-------#------#----#-#-#---##---#-
####----#-----#----###-#-------##----##---##----#----------#--#--------#----#--#-#--#-----#---#-----
--###--#-#--#-###-#--#-#--#####--------##--#------#----#--#--------##-##--------------#-#--------#-#
#--#----#--#-##-###---###--#----###-----#-#----#---####-----#--####-#---#--#--#------##-----###--##-
#---#-#--#-#--##--------#-----#---#-----##----#-#-####--#-#--#-#-----###-###------#-------##--#-##--
---#-#--##--###--------#---#-#---##----#----#-#--#---#-------#--#-----#-----###---#--##-#-#-#----#-#
-#---#----##-#-#-#----#---------####-#------------##-----#---------#-#-##-#-------#-#----#---#-#---#
-----------------#---#-#--#------#--#------#---##-##---#----####-------#-----#--#--###--#--#---#-#--
-#-#--#-#--------##----#-----#----#-------#--#####-----#-#----#-##-------#--#-#------##----#---#--##
#-#-#-#-#---#-----#---------##---#-#---------#-#---#---##---#----#---###-##-------##----##-#------##
#--#-#-------#-#--#-#-#-#--#-#----#--#-----#--#---------#---#--###-----#-----#-##--#-----#-#-#------
##---#-----------#-#-#-#-#----#-------###---#-#-----###---#----#---#--#-#---##---##-#---#------##-#-
#-#-#-#-------------------#--#---###---#------#-#--##----------#-#-#----#---###--##---#-##-----#--#-
#--#---###---##-----##--------#-----#-----#-###-----###-----------#-----------#---##----#-##--#-#--#
------#-----#--##---##-----#-#---##--#-#-#-----#-###-#---#-------#------#--###---#-##-----#---#----#
-##-----#-##-#-#-#-#------##---------#-----#-#-#-----#-##--#--#------##-#---##-#---#---#----#-#-----
--#--#------##-#---------#-#--#---------------##----------#----------###---###--#-----#----#--##----