?diagonal=Never;
--###------------#----#----#--##---#---##---#--##---#-----##--#--#-#--#-#---#-----#--#--#--#-#---#--
-----#-----#-#####-##-#-##---#-#-##---------#-#--##--#--#-#------##----------##-------#------#---##-
##---#--##------#-##-#---#-###-#-------#-#-#----------------#-##---###---#---------#--#-#-------#---
----#---##---#-#---##-#--#-------------#---####-#-------#-##----------##---##----#####-#-#-------#--
----##-----#-----##-#-#------#-##-#---#-----#------#-###---#---#--#-###-#--###----------#---#-##----
-----#-#-#---###-#----------#-#--#---#-----#---#-###-#--#-###----------#----E--#-#----#---#-------#-
--#---#---#-#---#--#-#---------####-#---------#-----#---#---#-#--##-#--##-#----#--#-###--#-----#-#--
#----#----#-##-##-#-##---#-##------##-#------#--#--------#----#------#--#-#----------#-#----#-#----#
-#-----#----#-#---#-----##--#--#--#-#--------#-#-#------#-#--#-#-##-----#---#--#---##-#----#--##-#--
-#---#------#--#-###--#------#-#----#---#-#-----#----#--------#--------#--------#--##---#-##------#-
-##-##-#----#---#-#-#--#---#-#-#-----##--#---##--##-------##---#-#--#----#--#-#-#--##-------#--#----
---------##-#-#---##-#-#-------#-##---#---#---##---##---------------##---##-----##-###-##-#-------#-
#---##-#-#-###--#-##-#--------#--##-#---##-#-##--#---#----------#-----##--#-#--####---#---#---##--#-
#----#----#-----#-------#---#------------#---------##-#-------###--------#--###---#--#--#--#-#---#--
-###---#--#--#-##----##-#--#####-----#-#-##-----#-#----------#####-#-#--##-##-##-#--###-###----#---#
-###-------####------##----------------##-----#-----#---##--#-#####--#-----#--#-------#-#--#-##-----
#------#---#----#--#-#---##-###-###--##-#-#-#----#--#--##------#----##---#----#-#---#-----#---------
-#----#-##--#----#--------#------#---#----#--#---##-----------------#-#-##-#------------#---#-#----#
---#----#--#----------#-#---------------#-----#-----#-#-##-#--------##----#-------#--#----#----#--#-
--#----#-----------------#####-#-##--------------#-#------#----------#-------#-#------###---#-#---#-
---------#-#--------#---#---##-##----###----#--#------###---------------#-#-#--#---#-##S##------#---
-#---------#--#------#-------------#---##----##--#--#--#-##-#--##-------#-----#------#---#-#--#-##--
-----#-#--#-#-##-#---------###--#----#-#--#----#--##-#-#---#------##-#--##--#--#--#--#---#-#-#-#--#-
------------#-##-####--##-#----#------#-----###-----------#-------#----#--#--#-##-#-##--#-#-------##
-#--#-#---###--#----#-##--#--#-#--#-#--##-----#-------####--##-#-#-#-#--####-----#----#--##--#-----#
##--#------#---##-#-##-----#------#--##-#------------#---###------##--#-#-##------#---##----#---##-#
-#-----#-##---#----#-#-#--#-#----#----#-----#------##---------#-#------##-##----#-----###---#---#--#
#-##--------##----#----##--#--#-#---#-----#-#-------#----#-----#--#-##---###-#-##-#---#------#-#---#
##-###-###--#-##-#----------#####--------##--------#---#-------#-#-#--------#-#---------#-###--##---
-#-##--##--#---#-#-------###---#---##-#---------#---#---#--#----------#-##------#-######--##-##-----
---#-#---#---##----#--###---------------##-----#--#-#------#-##---#------------------#---#-----####-
--##--#####---#-------#-#####--##-#-#---#-#-#--##--#-#---#-------#------#-----#----#-----#--##-####-
-----------#--#-#----##-##----#-#--------#-----#-------#--##----#-#--##--#-------##--------------#--
---#-------#-#--##---------#--#-#-##--###-#-#---##---#----##-##----#-#-#---#--------#---##----##-##-
-----#---#-#--##-#-----##--------##----##-------#---#-#----#---#-----#-##-###---------##------#-#-##
--##---#--#----#--##---#---###---#---##-#-#####---#-##---###--#-#--------#---------##-###----#-----#
#-#-----#-#--#-#----##--#-----##--#-#-#--------###-----#---#------#---##--------#----#-##-#---#-----
##---###-##---##--###-----#-------##-----#------------#-------##--#-##---#-#--#---#--------#-#---#--
-#-#-----#---#---##------#--#----#--#--#--#-#----#-----#----------##-----##-----#-#--#----#----#-###
##--#--#-###---##--#-#-----#---#-#-#--####--#-#--------#---#--#-#---##---------##-######----#----##-
-###--#---#-#-###----#------------#---#---#-#----###--#--##--#-#--#------##--##--#---#####------####
-##-----##-###-#-###---#-----#-----#----##---#-------#-#-##--###--#----##----#---#-----------##-#--#
--------###---#-###-#--#---##---#--##-#---#-#-##-----#-----#-#--##-###-#--#--#-----#---#-#-----#-##-
-#-#---#----#-#-------##-#-----#-###------##-###----##--#----#------#-----#-##---##---#----##-------
##-#----#--#-#-----------#---##-#-#-#-----#--#-#-##---#---#-##-#--#-#--#--------#-----#-#--#-#----#-
-#--#-#----#---#------#----#------#--#--------##---#---#-##------#--#--#---#--#--##----#-----##-##-#
##--#--#---##----#--------#--##-#-----------##--#---###---#----#--#--#--#-#-####-#-#--------#-##-#-#
------#-##---------#-----#--#----#-####-#---#--#--#-----##--##-##----#-#-#-#-##------#-----------#-#
-#--#---##----#-#--#---#----##-----####----#-##---#-#--#---#-##-##----###--##-#--#--##-----##--#####
-###------#-#------#----#-------#-#---#--###--#--#--#--#-#--#-#-#--#----------#--##-#-----------###-
##---#-#-#--#-----##--#-#-------#---##-------##---##------#-##---#--------------------#---------#---
----##-######--#--#-##------#-#-----#--##---#-#-----------#------##---#------####-####---#-####-----
-#------------------#-##--##-------#-#-#-----##-#--#----##-##-#-#-----------#-#-##-#----#----#----#-
-----#-----##-----------#-##------##---------#---##--#-----#--##-#-----#--------#-##---#---------#--
---##--##----###-#---####-####--#-##-###---------------#----------#--#---#-------------#------#-----
#---#--###-----------#---#---#-#-------#---#-#---#-#---#--##---#----#---##-##-#---##-#--###-#-------
------#-#-#-----------##--####----##-#-##-#------#-------#--#----#--###-#---#----#-#------------#-#-
-#-#-----######-##----#------#-#--##-----#----#---#---#---------#------#----##-----------#-#-#---#-#
-#-#---------#--##-#-#-##-----#--#----##--##-##-#-------#-#-----##-----------#---#--#-#-#-#--#-#---#
---#--#----##-##------#--##----------##---#-#-####----##--##--#---#---#----#-#---------------#---##-
--#-#--#-######--#-#---#--#---#----##--#-#-#----##--#--#--------------#-###-###----###---#--#----###
#--------#--#-#----##--#--##--#--##-#-#-----#-##------#----------#----#---------##-#-##-###-#---##--
#--#--#-##--#-#--##--#--#--#----###-#------#-#-#-------#--------#---###-###-#-------#-#-----#--#-###
-----##---#-----##--------#--##--#------#--##------#-----#--#------#-#-#--#-##-#-#--------------##--
-----###--##-#--###-#--##-------#---##-#------#----#----#-#------#--------#-#-##--###--#------------
-#---#---------#---#--#--#---##--#---####--#-##--------#------#--#------#----#---#-#---------#-----#
##-----#---#--#------#-##--#---##-#------#---#---#---------#----#-#-#---#-##-##----------#---#-##--#
-------#-----###---#----##-#-#-------#--#---##-----#-----#-#--------##---#---##--#----#----------#-#
#------#---#--------------###-----#-###---#----#--#-#-##-----#-#--#---#------#-------####--#-------#
#-#---------#-##----#--#-#--##---#-------#-#-#---#----#--##-#----##-----------####-#-##-###-----#---
------###-##-#----#-#---##--#----------#--------###-#--#---------##--##----#------#--###-------#----
##-#--#-#---#-##---#--#-##-#-##----###--------##-#--------#-----#-#------#------#---##-#------###---
-##-#---##----#--#-##---------#--##--#--##--####----####-#-------#-------##-#-----------#------#-##-
---#----####---##--------#----------------##--#--##-#----#---#####-#---------##---##--#-#-#--###----
------##-#--##--#-###----#-----###---------#--##--------#-#------#-###--#--#---#-#--##-----#--#--##-
-##------#-#-#--##----#---#----#--##---------#--#----------#-#-----##-----##-----#----#--#----------
-----##--#-#-#--##--#-#----#--###--------#--------###--##----#---#--#-----#-#---#----#--###--##-#---
-#------------##----##-----#-----##-----#---#--#---##-#------#-##-##-#--##-#-#--------#--#-#---#--#-
#---#-------#---#--#------#----#---##-----#---#----#---#------#---------------#-----##-----#--###---
-------###--#----#----#-#---#--#---#--#-#-#---------#-#----##----##-#---#---#-#-----#---#--#-----#--
###-##-------#---##-#-#--#---#---------#--#-----##----##-#----#-----#-----##-#---#-----##--##-#-----
###----#----#----------#-------------##--##-#--##--------##--#-#-----------###--#-----#---#------#--
-#-#-----###--#----------#--#---#--------------#-----#-#-#-#----------#---#-#---#----#-####-------#-
#--------#----##-#-#------#--##-------#--#-#------#-#---#-----#-----##---#-####-#------##--###-#--#-
-#-###---##--------#----##-#-#-#---#-##-----##-##-#---#-##----###--#-##----------#--#----#-#----#---
#--#--##---#-#-#-#-------##---#--#------#------##--------#--###-#----#-###--#-------------###-##--#-
--#-#####-----##-#--#---------------##----##---#---#---#-#------#------#-#--###-#-------#----##-----
-----###-#----###-#-#---#---#-##----##---#-#----####-----#-----#-----#-##-#--------------##-#--#--#-
#-----###-#-------#-#----#--#---#--##--#-----##------#-------#--###----##-##-#----#-#--#--#-----#-#-
--#-#-###---#--#-----#---###-----#-###-#--#---###---#-------##-#----#-#----#-#--#---#-------#------#
-#--#####-#---#--#------#-----#---#---#-#----#--#-#--#--##-----##--####-##--#--#---------#-----####-
--##---#-------###----##-#--#-----##-#-----#--#--#--#----#-#---#------#--#-----#--#--#---#-#---#-#-#
--#-----#---#-##---#-------###-##-#---#-##---#----------#-----#-#####-----------#---#-##------######
---######--------##-#----#--#----##-------#--#----#--#-----#-#------#--#----#--------###-###--#----#
-#----#-##-##-----##-#-----#-------------#--###-----##---#-#--###-##---#-#-#-----#-#-#--------##--#-
#-#-----#---#-#----#---#-#-#-#---#--#----------#--#---#---------#-###-#---#------#--------#-#-##--#-
---#----##-#-##-#------------#-#--##--###--#---#-#-------##-####-----#--####-##-----#--#--#-#-#-----
#-------#-##--#--#-----#---#--#------#----#--#---##---#--------##--###-##-###-#-#----#--##---#-#-#-#
-#---#--------#--------#--#-#-###-----#--#--#--#----#--#--#-------#------####------#--#-##-#----#-#-
-----##-#-----#--####-#-##---#--#---#-----#-#--#--#---#-#------#---##----#-#---###---##-###-#----#--