?diagonal=Never;
--------#-#--#---#---------------#-#----#--#--#-----#-----#-#-###-#--#--##-#----------#----#--------
#--------##--#-#---#-#-#-#-##--##--#---------#-----#-##-----#----#-----#---------------##---#-------
-----##--#-###--#---#-##------##---#-----#---###-##--#-----------#-#----##-#----#---#--##-##-#---#--
-#---------##---##-#-----##---##---#--#----------#--#---#---#---#--#--#--#---#---#-###-#--#-#-##-#-#
--#---#---##------##-#-##-##--#--#-#-#--#-----#-##--##----#------#-#---#-#--#-------##------#-##--##
------#-----#----###----#------#--#####---#--#-------#----##---#-#--#---##-#---#---#-------#-##-----
-##--#-#---#--#------#-------#---------##----####------#----#-#-##-#---#-----#---#--#---#--#--#----#
#-#--#--#----#---##--##--#-####-#-#----#-#------#-#-##-#--#-#---##--#------------#--##--#---###----#
----#---#------####-##---#------##----S#--------#----#-##--#----------#---##---##--###---#----------
--#-#---#----##-----#------#-##--#-----#-#----##-##------##----###-#--##-#-------##---------#-#-#--#
---#---#--####-#-##--#-------##---##--------##----------##--##-#------#---#-#----#----#-###-#-------
#------------##--##-##--#--##--##---#---##-#--#--#--##-#---#-----------##----#--------#---#--##--#--
-#----------#----###-#----#---#--##--#--#-#--------#---##----#--#---#---##---#---##-#----#-###-----#
-#--##-#-------###---#------#--###-##-----------#-##-#-------#-#-#---#------#-----#-----------##----
--------#---#--#--#---##----------#-#---#--#--#-#----####-----##----###------------------------##---
-##--#---##----#--##--#-#-------------#-#---#--##-------##----------#---####--#--#--##-----#---#--#-
-----##-##-------##--#----------#-----##-#--#-#-----#-#-#-#----#---#----#--##--#---#--------#-------
-#-----#-#-##--#---#--#-#---##-------##-----##-#-----#-------###--#---###-#--#--------##--##-----#--
-#---------#-----#-----#--#-#-#-#---###-#----#----------###-----#---#--------#----#------##---#--#--
--#-----##--#--##--##----#-#--#--###-------##---#---#--#--#----------#-----##--#-------#--#---###-##
-----#-#---------------------##-#--#-----#---#-----#-#-----#--#--#--#------#-#--#----#---###---#-##-
###------#---##-#------#----#----#-#-##--#-#-#-##----------#--#-#--#----#------#-##-##--#--#---##---
---#--#--#----##--###-------#--#---#--#--###---#-#--####-----#-----#---#---##----###-----###--#--##-
##-##---#----#--#-#-##-###--#-###------##-#-----------#-----##----#-#-----##-##---#-#-----------#--#
------#------##-#---#-#----#--#-####--#-#-###---##-#-#---#--##-#-###-#---#----#---#-#--##------#---#
----#---#-----#---#--#--------#----###---#-#----#---##-##-#-----###----##---#---#--##--#----#-------
--##------##--#----##--#----#--#-----######--#-#----##-###-#-----###-#--#------##--###-#----#----###
----#---#-#----#------#---------#-----------#----#-----##--#--#-------#---#----#--------##--##----#-
-##------#--##------#--#-----##-##-#------#-#-#----##--#-----#-##--#--#-#-##---####--##-#--------###
--#--#--#---#--#------##--#------##-#---#------#------#-#----#--#---#--#---#---#----#---###-#--#--##
#--#--#----------#-#--#-##-#-----------#--#-#-#---##--#------#--------#----#----#-----#--##--#--###-
##---##---------#-#--#-#-#-#------------------#-----------#---#-#---#----#--#---####----###---#-#---
##-#--#--#--#-----##-#-#---##--##----#-#-#--#--------#----#----#--#-#---##-----##--#----##----#--##-
#######--###---##-#-#-#---#--##-#-#-#---#-#--#---##-------###--#-#-#----#####----#-#-#-#-##---------
#------##-##--#--#---##-----##-#--##---#--#--#--#-#---#-#-##-#---##----#-##-#----#------#--#---#----
---#-#-#-#--#----#--#---#---------#--#--#---#-#---#--#-#---##-#-#-##-#-####-----#---#------###-----#
-#-#-----#--#------###-#-#-#-----#----------#-#-------##---#-#-#-###--#-#--#------##-#--#-##----#---
-#-##-#-#------#---------#-----##-#---#-#-##-------#--------#--#--#-#--#---##------#----#-#----#----
------#-#---#----------#---##-#---#-#-#--######---#-#---#-----#-##-----##-#------------###----------
#-----##--#-##--#--###---#-###-------##-#---##---#------------##---#---##-#-#---##-#----------##----
-#--#--#-#------------###--#-#-#-----#--#-#-#-#-##--###-#--#-#---#-#-###----##-#--#---#---#---------
#-#--------#--##---#----------#-#---#--#####----#-#-------#--------#-------#-------#--#-#--##---##--
--####--#-#-##-----#---##-----#-----#---#----#----#-#--##----##-#--#-###---#-#------#-------###-----
--------------#--#-###--#--------#-------------------###------#--#---#---##-#-----#---##--#---##-#--
#--#-#-----------#-#---#---#--#---#-----#---##--##-#-----##-#-----##-------#--#-------#--#--#--####-
------#--#--#-##----#----#----###----#--####-#----------#------#-----#-------##---#-#-----#----#----
---------------#----------##----#------#-#---------------#---#-##-#-#--#----#-#-----------#---###-#-
--#--##-##-#---##-----##------##----#---##---#-----#-------------#----------------##---#-#-#---#----
#--##-##-##--#####--#-#--#--#---#------##-#---#--------#--#-----#-#---#-#---#---##-#--#-###---#-#--#
--##-#-##-------##--------#-----------------##--#----###---##--------#--#--##-##-#-----#---##-#-----
--##-#---#-#--###-#--##--#---#----------##-------#-----#---###---#---#---#-----------#-----#---#----
--#--##------#-###--#--------------#--##----##-#-----##-###---#-##-----#------#-----#---#-#-##------
---#-------###--####---#-##--#------##-#---------#######--#--#---#-###-###----#----##----#----##---#
----#-##--#---#----#-##--#---#------------###--##----#-######---------#-##--#-#--##--------#-#----#-
#-#####------#---#-#--#-#----#--#------------#---#-#--------##-----#-------###---###---#----###--#--
---#-----#--#-##-####---##-------#--####-#----#---------#--#-###-#---------#--------###--#--##-#---#
--#--##------#----#------#------#-----#--------------------######--#---#--####--#--#--------##--#---
-#-----------#-#---#-------##---#-#-----------#--#-###--#--##--#--####-#-#---##-#-#----#--#--##----#
####-#-##--------#---###---#--#---##---##---#---#-#-#---##--#---##-#---#--##--#-----##--##-#--##--#-
--------#----##-#-----#-#---#-#---------#-##-----------##-#---###---###--#--#----###-----#----##----
#--##-----##-#--#-----#---------###-#--#-#--#--#-##------###-###-#---#-#-##---#--#---#------#-#-#-#-
-------------#--###-#-#------------##-#--#--##-#---##-#--#-------#-#-#-----#-----#-#-####--#----#--#
--------------#-#------#-#-------#-#----#-#---------#-#---#-----#---##--#--###-----------#-#---#-#--
-----#-#----------#-##-###--#----##-##-#-#--------------##--#-#-#---#----##-#-#-----##------#--#-##-
#-#----------##-------#-----###--####---#--#-------#-------##--#--#-#-##--##---#-#-------#---#-#-#-#
-#---#--#-##------##--#-#-----##--#--------#------#-##---------#--#--#-#-##-#####---#------##---##--
-#-------###----#---#--#---###--#---##-----##------#---#---##-#--#------E#------#--#-#----##----##--
--##--##-##-#--#-##-----#------#---#------##--#--#-#----#-------#-#-##-#-#------#-----------#--###--
--#--#---#--#---#--#--#----##----#--#--###-###--#---#----###-#----#---##---#--#--###---------#------
----#-#---#----#-#-#----#-#---#--#---#-##-#--#-#-#---#-#-#---#-------#--#--#----####----###-------#-
#--#------##-#---#----####------#-#-#-##-#--##-----##--#-#---#---#-#-##--##-#--#--------#--#---##-#-
-##-##----------#-##-----#---##---#----#------#-#-#-##---------#-#--##----#-##-#-#-##-----#---#-#---
#-#-##---#--#-----------#---##-##-#-#-#--------####----#--#-#---#--##-#----------------#-#--##------
--#----##-#--#---------#---##-#-#--####---#---##-------#--#---#--#-#-#------##--#----#-##---#--##-#-
----#--#-------#--#---#-#-#--------#-#------#-#---#-----#-###--#-#-#---------#---#-------###----#-#-
-#-----###--#---##--#----#--------#------##-##---#------#----------#-----#---###--#-#--##-#----##---
-#---#----#--------#--#---#--#-##---------#-#-##--#-----#-------#--#---#-----##-#--#--#-----#----#--
----#-#-#-------#----#---##------#-#-#---#-##----#--#-#--###-#-----#####--#-###-###-##--#-#----###--
----#--##--#---######-#------#---#---##-#---##-###--#---##--##-####-#-#---##-----#-#----#--#--##---#
----#------#--#-#-##----#-#-#-----#-------###---#---------#-------#---#--#####----##---#-#-#-##--#-#
--#--###--#---#------#--#----------#-#--------#-###-##---------#-##--#----##-----##-#-###---##------
##-#-#-----##----#-----###----#-#-#-#--####---------###--##-#--###-#--#-#--#-#---##-------#-#--##---
---#---#-----#--###-#----##-##--##------#-#--##---#-#-##-----#--#---------##-#-#--#--##-#--##---#-#-
-##--##--##----#------#-----#----#--#-#--------#-------###-----#-#--------##-#---------##--#--------
##-#------#------#-------##---###----##---#------##----------#-#------#--#-#---#-#-----#-##--#-----#
---#-----#---#------#-#--###----####--------#-##---#-----###--#--#----#----#------#-------#----##---
----------------###--###-#----###----#----------#----#----##-#-##-##--------------#---#-###----#-###
---#-##-----##-#--##-#----#-#--#-#-------------#--#-----#-----#---#-##--#-----#-#-#--##--#--#--##---
-#-----##--#----###-------#----##-----##--#-#----#---#--#----------------#--#-----##---#--#-#-##--#-
#-#-----#--##--##-#-#------##--#---------#-----#-#--##-#-#----##--------##--#--##---#---#----#----#-
#--#---##--------#----------#-##-#--#------#--#-#--#-#-##--------##---###--##--------##--------#-###
--#--##-----#-#------#----##-#--------#-#-------#-#---##---##-----##---#----#--#----#-###----###-#--
----#------------------#--#-##--##-------------#---#-###------###-##--#--##-#---#----#-----#-#-----#
--####---#--####--#---------#----##-##----#--#--#-#--#---#-##-#-###--#-#--#-#-#---#--##---#--##-----
--#-----#-#---#---##-#-#-#--#--#--#---------#--#-##----#-##--#-#--##-#-#-#--#-#--#----#-#--------##-
--#---#-#--##--#--------#--#--#-----#--#-#---#------#---#---#-#--#--###-##--#-------#----#---------#
------------------#---##----------#--###----###--##-#---------#----#-#-------#-#-###---#---#------#-
-----###---#--#----#------------#----#-#------#---##--##-------------#--#----##--#--#-#---##----##--
----####--#-####----#----#-#---#-###-#--#-#-#-##-#-#---##-#-------------#-#------#-------------#-#--
---##---#-#--#--------#-------#-----##-#-------------###--#-#------##--#-----#---#-#-##--#-#--------