?diagonal=Never;
----##-##----#---#-##------------##-----##-#----#--#-###---#-#-#---#-------------#----##-----#---#--
-#-#-----#-##------#-----##-----#----#---#---#-----#-------#-#--#-###----####-----------#-#------#-#
-----##-###-----###--------------------##------###--------###-##-#------------#-#-#-#-#-##---#-#--#-
---#---#---#----#--#---#----#-----------##--#-#------#-#----#--#------#-###-#----#-#--#---#-----#---
--#-#--##-##--#-------##-----##--##---------#--#----#----------#--#-##------###--#----#--##-##------
-----####--##-#---##--#-#--##--#-----#-#----#--##-###-----##----##------#-#-#---#-----##--##-----#--
---------#-##-----####-#------------##-##-##--------#------------##-----#----#--#--#----##-##----#-#
--#--#-#-#--##-###-#-------------#-#--##--####--#####--#-----##-#-----##------##-#---#--#-#-----#-##
#---#-#------#------#-#-#---------#----#-#-#----#--#-------#-#--------#-----##------###--##-----#--#
##--##-###---#---##----#---#-----#-#---#-------------##---------#---##-#--###-#--##---#-#--#--#-#--#
-#--###---------#-#----------------###--#-------#----#--##----##---#-----#----#---##-#----#---###---
---------#----#------#-#---##-#----##-#-----#-###------#-#----#-##-------###----##-###----#----##---
##-#-#-#----##------#---#-#---------##-#-##---#-----#----------###---#--#-------------#-#-#---#-####
---#----##---#---##-#------####------#----------#--#----------#---------#-##---------#-------#----##
-#--#--##-----##-##-#-##--#---#-#---#--#-#-----#-#-#----#--------#----#--------#-#----##-#-##-#--##-
--##--#-------#-----------#--#---#-##-----#-#-----##-------#-#--#--#####--##-##--##-#-###--##--#---#
-#--##----#-##---------#--#-#--#--####--------#---#-#-------------##------#-------------#--###-##---
######-#----##-#--#--------#-#-#----#-#-#-----#---#-#---##------#-#-#-----#------##----------#------
#---#-##----#--#####-----#--##-----#-##--#--##-#-###------#---#-------#--#--#-#--###--#----#-###----
--#-----------#-#--#-#--#---#---##---------##-#--##----#----------#-#--#-#-#--#-----#-------------#-
#-#-----#--------------#------#--###---#--#----#-##--##-##-----##-#-#--#--#-#---#-#---#--#--##------
--------#-#-#---------#-####--#-#---##---#---###---#----#-----###-#-#--###----------#-#-##-#----#-#-
----#--#-#--------#----------##---#---##---#-----##------##--#--#-#-----#--#------#-#-----#--###----
##-#--------#--###----#-##-------##---#--#--###--#-#--####------#--#-#-#---###----#--##--#--###-----
-----------###-------##---#--##--#--#------------##-----#----#--##--###-------------##-#-#-#---#----
-----------##-#-#-#---##-#----#-#--#----#--#--##-#-#-###-#-##-#----##---#-####--------#-#--------##-
----###--##--#--##--#------#---------##----#------------#----##-#--#-#--#-###-----#-----####------#-
#---##--#---#----#-#----#------#-##--#--#-##----#-#--###-##-#--#-#--#--#-----###---#----###--####---
---#-#--#--###---#---#----------#-------###----#--#--#-----#-#-#-###--#####-----#-##---#----#----#--
--###-----###---##--#---#-#-##---####-#------##----#--##----#-----#-----#--#--##-----##--##-#-----#-
-#------#------#---##--##-------#--------#-------#-----#--#------#-------#--##-----#----#--###-##-#-
#-------##----------#--#-----#----#-###-------#------##----##--#--###---#----#-#--------#---##----#-
---#--#---#-##-#-#--##------------#--#--#------#-#----#-##--##-#--#--------#---##--------#--#-#--##-
--------------##-#-----#----#--#--#---##-##-#--#-#--#-##------#-#-----##-#---#---#-##----#-#--------
--###----#--##-##----#---##--------#-##-----#--##--#--###----#-##----#----#--##--##-#-------#---##-#
-#-##--#-#-------#--#-#---#-#------#-#----##----#-#-------#-------#---##---#--###--##----#-----#-#--
#--#---#--####-#----------##---##-#---#-#------#---#-----#---#-------##---#-#--#----#----#-------###
---#-----#-----#-----#-##------####--#----#----------##---#--##--#-#----------##----#-----###-###---
##--#--#---##---###-#-#---#----#----------#-----#-#-#------#-#-#-----###---##-###---#-#--#--#--##-#-
----#----##-----##-#------------###-#-----#-##---###-###--#----#-###-##-#------#-#--------------#---
-#-##----#-------#--#------#---#----#-----##--#-#--#-#---#--#-#----------#-##------#--######--------
###----#-##----#----#-#--------##--##-#----#-#-#---#-#--#---###--##--#-##-#-----#----#-##--##---###-
----#--###---------###------##---##-#--##-#-#-------#--##--##-#--##-#---------#---##---#---#-#----#-
----##-----#-##--------#--##--#--#-#-----#----#-###--##-#---#---#-#-----##--#-#---#-----#-----------
#-----------#------------##----------#--#-#---#---#----------------#--#------##----##---##-------##-
#-##-#--##-------#-#---#--#----##-#-#--#--#---------#-##--#-------#-#----#---#--##-#--###-#-#-####--
---#----#-----#---#--##----------#--##-------#---#--#--#---##--##-#----#--#---#--------##-#-##------
-##-----##--#----#--------#--#-##----#--##------#--#-------------##-#---###-#-------###---------#--#
-#----##-#----#---#--------####-##-##-#----#-----##------#-##---#--------#---####-##-#-##-#---##-#--
-##---#-###--#---#--------##-#---#-#--###--#-----##---#--#--##--##-#-#-##--#-----##---#-#---------E-
-----------------#--#---#-#-##------#####-#--#------###-##---#-----##----##-------#------#---##-##--
-----#----#------#-----#--##--#-#------#--#---#-####-##------#-----#-#---#---#-------------#--##-#-#
#-#--###-------#-----------#----#-#------------###-#----##-#------##-------#-##-------###-#---#-----
----##--#---###-#---##--#---##--------#---#---#------#-#---------##-#-#-###---#---#--#-----#---###--
#-------#-----#-######-#-##-#-#-#-#---#---#-#-#--#---#------#---#-#-#---###-#-----#-##--#------##--#
##-#--#-#-----------##-------##------#--#-----#--------#--------##------#--#--#-#--###-##-###-#-----
-----#-##--#-##---#---#-#---#--#---#---##-#---#--#----#-#######-------##--#--##--#-#---#-###-#------
-#----##------##-#--##-##----#------------#----#--------#----#--##---##--#---#---###---#-#-----##-#-
-##-#-#----#--#-----#--###---#--#-#-##-----#-#-----#--##-#--#---#-#----#-#-#--##-#---#--#-#--#-#----
#---##-#---##-##-#-----#--####--#-----#-###-#---##--------------------#------------#--##--####---#--
---#-#--#--#----#------#-#---##-#----------##----###--#-#-----#--#--##--#---#--------#-----#----#--#
-------#---#--#----##-----------#-#--#--###-##--#-#--------#--#---------###-##----##---#-#--#---#--#
-#--##-----#-----##-#--------#-#--###----#-#-#-#------#-##----###-#-----#-----#---##--##------#--#--
--#---#---#--#-----#-#--##--------#------##-###-#-###-------#--#--###-----##---#--##----#-------##--
-#------#-----#---#-#---#---#---#--#-##---##----#-----#---#--#-----#--##--------#-#-#---#-----#--##-
-----#-----------------#-----#------#-#-------#--#-##-##-#----#--#-#--------##---#-##--#---#------##
--###--#--#-----#--------------####--#--#-----------#-----#-----###---###---#--#-###--#-##------#--#
-##--##-#-###--##--#------#----###---#-##----#----------#--##--#-----##-#---##------#--------##--#--
--##-------#--#---#--------##-##--#----#--#----#--##----------##-###------------#-#-#--#---#-#-##---
##----###---#####-------------#----##-##-#-###--#---#--#----#---#--###-#-##-#-##--#--------#------##
#------#----#--#----##-----------###-####-#---#--###-#-#---#------##--###---#--#-#-##--#----#--#---#
#-#-#-##-#-#------#--#---------#----##-##-#---#---------##-----#--#-#-#------#------#--------##-----
#---#----#-----####-##-##-#--#----##-####-#---#--#-----##-#-#----##------#-##--------#-###---#-##---
###----#-#--###-----#--------#-####-#-----#---#------------##----#---#--#----#-##---#--#----###-----
--###-#------##-##----###----####-#--S----#--#--###-##--#----------#------------##---##---#-#--##--#
--#--##----#-#----#-----##-----#--##-###---##-#--#-##-##-----#--#--#-#--------#---#####------#--#--#
-##-#--#---##-#--#-----#-#-###---#---#-#-#-#----#--##---#--###---###-#---#---#---------#--#--##-##--
--##-#-##---------#---------------#---##-#-------#-#--#####-#--#------#-#------#------##-###--##-##-
--#---##-#-#--------#------------##-##-----#---#---#---#--------#-###-------#--#-##-#----#-#---##-#-
-----##--###-------##-#--#----#---#--#-#-##-#-#-#---#--#----#--#-----#--##-#--------------#------##-
---#-----##---#-##-------#---#--##-#--#--#-#--#----#--#---###----##-#-#----#-------##----------#----
---##--##-#-----##---##---##-----##-#--#---#-----#-----------##----##--#--------#---#---#-#-#---#---
--#-----##-----#----------##-##----------##-#--#---#---#--#-#--#-#--#--#-#------#-#-###--#----#--##-
-#-#-#---##---------#-#-#----#--##-------#--#--##-##--####---#---###--#-#-#-#-##-#------------#----#
#-----##-#-##-----#--#-------------#---#---#-#-#-----------#--------#----#-#---#---#--#----#--------
--#-#-----#----#-------------##--##-------------------#--#--#-#-------#-----------##---#---#-#-##--#
-----#---#------##--#-#--#--#-#-#---#-#-#--##-#--#---##-#-#-------#--###-##----#-----###----#-----#-
---#---#----##--##--####-------#---##-#-#----#-#--#----#--#---#--#-#--#--#---##----#---##-#--#-#-##-
###-#--#---#-------#---------------##----#-###--------###--##-#-#-#--#------#-----#--#--###---#-----
-##---#--#-#--#-----#-#-#---##---------#----#-------#--#--#------##-##------##-----#-----#--#--##-#-
-----#####--#-#-#--#-------#------##-----------#-##-------#----#---###-----#--##----#--#---#-----#--
-##---------#--##---------#--#-###--#----#--#-#---#-##-##---#----#---##--##-------#---#------###----
#-#---#---##-----#---#----#--#------#--#-##--#-#-#----##--#-----##-------#-#----------------#---#--#
----#-------#--#--#----#----------##----#-#-#------##--#--#---##---#---#-------#-#--#--#------#-----
-------##-------#--##------#---#----#-#------#--#--###-#--#---#-----#---#-----##---#-------##---##-#
#-----#-#--###-##-##-#--#---##---#-##-----#--####----#--------#-----#-----------------------#----#-#
#---#-#-#--------#-#-##--#------#-#-#---##----#-##---##-----#---##-##-#-#------##---####----------#-
----#---#--#-##---#----------#----#-----#----##-###--------##---#-----####-##----#--#--###-#--##-#--
---#--#--#-##-##-------------##-#--##--#--#----#---#-#-##-#-#-#---#-#---#--#-----###----##-------#--
---##-#----#-----#-----------#----#----#-#--------##---#-----#--#--#---#-#----#-----#---#------##-##