?diagonal=Never;
#-#--#-#-------#------------#--#----#-------#--#-------------######-##-----#-#----#-##--#---#-----#-
---#--#---#--#--##-#---------#-#-#--##-#-#-----#-------#--------#--#---------#--##-#-#---#-##-#-----
---#--##-------#-##--##---##------#-----#---##-#-#--#---#--#-###--#------#-----#####----#-#---------
---#-#--------------#---------#------#-----#-----#--------#-#-#--------#---#-----#--#-##------------
#--------##---#--#----#--#--#---#----#-------#--------##--##-##-#-#------------##-------#-#--#--#---
-###-#--##----##---#-#-#--#-#-#-#-#----##----#------#-----##-#----#--#---#----#----##-#---------#---
------#-----#--#--#---#-#----#----###-##-#-#------#-###---#-#---------#-#--#------------##---#------
-#--#--##--#-#-#--#-----#--#####--#--#-#--#----##-#---##-#--#---#--#-#----#------#-#-----#----------
-#-#----#----#-#-#-#-#--#------#------#-#----#--##------#-#-###-##--###----#---#----#-#---#-#-------
-#-#--#---#------#----##-#-----#-----#-#-#----#--------##--#-#----#--#------#-#-#-##--#---#--##-##-#
--#----##--#--#--#-#--#-#--#---#---#-#-----#--#--##--###--##------#----#-#----#--------------#-#----
----###--##--##----#-#-----------#-#-##---##-#-#------#--#--#-#-#--#--#------#---#-----##---#--#----
#--------#---#---#####---#--------#----#-#-#-#-#-#---#---#------------------#-##-#------##---------#
-#---#-------#---#--###--##-#----#-#-#-----#----#-#--#---###--##--#--###-##------###------##--------
--#-##---#----#--#----##--#-----##-##-###-#--#-##---###-------#---##-----##-#------#----##----##---#
#------#----#--#--##-###--#------#----#---##-#--#-#-------#-#-#----------#-------#-#--#--#--#----#--
###-##--##--#--#-###----#-##----------#-#-----#---###-##-#-#------#-#---#-#-####--------#--------###
-#-#--####------#--#--##-#--###----#---##----##----#-#--------##-----####---#-##------#---#-#--##-#-
--------#----#---#-#---#---------#--#--#-----#-#---#-#-------#--------#----#---#-#-###-------#----#-
--#---#--------#-#---#----#--#----#-####-#------##---##----#--------##-#--#----##-#---------##--##-#
#----------#-----##-##--#--#--###------#--#--#-#-###-#--##--##-----#---##--#-#--#-#--#--##----##-#--
-#-----#--#--##--#---####-#--##---##-#-#---#-------------#--------#---#-------##----------##------#-
-##----#-#-#-#--#-#-###-#-#---####------#--#-----#----------#-#-#---#----##-----#-#--#----####------
-###-#----#-##-##-##-----#----#-#-#-##---#--##----#------#-------#-------#-----#-----------#-##-#-#-
#---######-#-----------------------#-----------#----##--#---#-#-------#---#----#--------##-#--------
#--#--##------#----#---##-#---#-----#-#--------####--#---##---#------#-----#----------#-#----------#
---##-------#--#----#------#-------#------###-----#-##-----###--#--#---#----#-#---#----#-----#-----#
---#----#------###-#----##-#-#-#--##------------##---##-##-#-----##----#--------##-#-----##-#-#-----
#-#------#-#----#----#-----##-##-#--#-#--#--##--------#-------------#---------------##-----#----##--
-----------#---##---#-#-#---#-##------#--------#------#---------##-#---------##-#------#-#--------#-
---------#-#-#--##-##-##---#--##----#--#-----##---#--#-#------#-------#-#--#-#-#-------#-----#---###
-##---##--#--##--##---#-##----#---------#--#--###----##--#-#-#--#---##-##--##--#---#-------------#--
--#-##-#-----#---------------#--#---------------------##------####----#----------#---###-#-#--------
#----#----#-#---#-#--#--#-##--#--##--#--##---#-----####--------###---#---#--#---#-#####---#---------
----#---##--##----##-#---##-#-#----##--#---------##---#----------#--#------------#-----#--#-####----
#--#----#----##-#------#-##----##----#-----------#-#-#-####---#-------#-#-----#----##---#--#-----#--
-##-------#-##-#-----##-#-----###-#--#-#-------#-----#----##------###-###----#---##-#----#--#-------
--##-------#---#--#-------------#-#---###--#-#--##-------##-#--#------##-----##--------------##----#
#--#-----##----#----##-#----#-##-##-##----#-#--##---#---#-##----#---#--#-#-#-##--#--###--#--#--#----
-------#-#--------------#---#--#----#-#--#-#---------##-#----#-#---##-----#-##--#-----##-#---#-----#
----##--##-###-#-----#-----#----#-#-##----##-----##-#----#-----#---#---------#---#----##---#-#-----#
-#-##---##----####--#--#----#----#-##--#------------#-----#---##-##--###---#-----#-##-----#---##-#--
-#---#-#--------##----#-----#--#-##-##--------#---##--#-##------------#-----#----#------##--#-------
##--#--#-#---#-#--#-#-#-#------#------#--#---#-#-----#S--##-##-#-------###--#--#------#--------#----
-#-###--#-#-##-#-##-##-##-####-#--##-#-#-#-#--##-##--#--#----#------#--#--#--##----#---#---#------#-
-#----#----#--#-------###-##----##-##-------#--------##----#---#---#-----##-----##--#--#--###----#--
#----###-###---#--##--#--##----###-##--#-#-#-#---#-------#--##-------#------##----#-#-----#--##-----
--#-#-#------#---#-##--#-----####---#----#-#-##-###-#-#---#-##--##--#----#--##-----##----#-------#--
#----#--##-----------#-#-----#---#--#-####---#----#-#--#-----------#------#-#-#---##--#------#------
-#-##---##--#--------#---#-#---##-------##-------#--##-------#--###-----#-#-#-#---#####---------#---
#--##-###-----##-#-----#--#-##---###-------###-------#-----#---#-#----#--#----#----#----##--##---#--
#------#-#-----------#-##-#----#--#---#-###----##--#----#--#-----------#---##-----#---#-###------#-#
-###----------------#-#---#---#---#--####--#-------------##-#-#--##------#--#--------#-###----------
---#---##--##-#------#-----##-----#-#----#--###-#----#--##-------#-##-#-##---#--#------###-#--#-----
-------#-#-##--------#-###--------#---#-#-#------#-#---#-#--#---#--------#----#-#--#-#---#-#--#----#
-#--##---##-#---#--#########---#---#-----#------##------#---#---#-##---#--#----#-------#-#---#-#----
--##-#-#----#-#-###--##--##-#------#--#-##----#------#---##-##---#-#-###--###-##----##----#--#----#-
#--##--##----#-#-#---#-#--####--###---###--#--##--#--##-----#----#---------##----##-------------##--
#-##--------#----#---------##--#-----#-----#-----#--#---#--#-------#--###----##----#---------#------
----#-#--####-#----##----##-###-#-##--#---##--------##---#---##---#-#--#---#---#-#----##-#---##---##
--####----#---#------#-----##-----#-----##-#---#------##-###-#----#-----#----------#---------##-####
--#-#-###---#-#-##------#----##--#-#---#--##-#-----#---#----##--#---#--#-----##-------####----###--#
-----#------##--#-#-#-#-#-----------------------#-#---#-#-----##-##-###-----###--------#---#----#---
#---#-##-#--#--#---#-#---#--#----#--------##----##-#-----#--##--#-#-###-#------------#---#-----#-#--
#-##------#--###-#--##-#-------#-###-------#--###-#--##--###-----#--#-------#-#--#--#-#-------#--#-#
--##-###-#---#---#--##---#--###-#-##----##--------#------#--##--#---#-----------###----#-###---#----
-------#--####--#--#----#-#---#----------#-----#--#-#------#-#-----------#-#----#-------###---#----#
#-###--#-#---#------##-#------#-#--###--#---#------#-#-#-#--#---##------------#--#-#--------#-###--#
-#--#-#---##---#-----##---#-#--#-----#-------##--#-#-#--------###---#----#--#-----------#-----#--#--
-----------#-------#-#--##---#--#--##--#-##--------#-#-#-----#--#-----##------###-#-----##-#-#---#--
##--###---###--#--##----#------------#---#---#-#--##----#-#--#####-----##-##--##---#------##----##--
-------#--#-----#--#-#####---#-##--#--###------#-------#-#-#-#-------------##--##-#-----#-######---#
#---#--#--#------#--------#-#-------#-####--#-#--#--#-#-#-##-##--#---#-#----#-##---#--#-#------#----
--#--##--#-###-#--------#--#---#-##--#---##--------##---##-----#----##--#----------------#-#---#---#
---------#-##-----##-#-#-#-##-------##-----##--#-#------##--#---##-#-----#------##---#---#-------#-#
-##-##--#---#----#------##---#--------#-#-###----##-#-------#---###--##--#-#--#-#-#-#--##----#------
####-#---#----###---#-###-#-#---##---#-----#-#------------#-----#-#-#---------#-#---##-##------####-
-----#--#--##---#--##-##--####--##--#--------#--#------------#------#--#----#####---#-#-#-#---#-----
-##-----#----#---#####-###-#-###-###------##-----#---#----####-------###---##-##----##---#-#---##--#
#--#-#-#----##-----###-----##-#-##-#---##-###-###-#-#-#----##---##--##--#-##---##-##-#----#----#---#
------##--------#---##--#-##--#-##-##-#-----##---#-----------#-------#---#-#----###--#--------------
#---#--#-----#------##----------#-#-#---#-#--------##--#--#-#---#-----#--#------##-#-------#--##----
-#---##------##--#------#-#---#--##--#----#-------##---#-#---------#-#--###--#----#----------##-##-#
--###-##-#-##---##-------#-#----#---#-##----##-#----###-#-##-##----##-----#-##-##-#--#-----#--##-###
-----------##-#-----#----#-##----#-------#--##---#-###---##----#---------#---#-------##--##--#------
----#---------###----###--#-#----#--------#-##------####-#--##--------####---#-----#-#------#------#
#-#---#-----##--------#----#-#####----#----------#---#--#-#-------#--#---#-#--###----#-##-#------###
-######---#--#-#-#--#-##--#-#-#-#--###--#--#-#---##---##-#---#-#--#--------##---#----####-#---####-#
------##-#--#---##-----#------##---#-----##-#--##---#--#-#--###---#----#-#---#----#--#--#--------#--
--####----------##-------##--###--##-----------##-------#-----------##------------#--------------###
-----------#-#----#-#--#---#------#-###-#-----#---------#--#----#--------#-#--#-##--------####-#----
#---#--###---#-######-----#---#--######--#------#---#-##-#---#--##-#------#------#-#-##-#----#---#--
-##-#----#-----------#-#--##--###-#-----#-#-----#-#--##--#-#-##---#-----#--#--#-----#-#-#-#---#-##--
----#-###------##-#---##---------#--##-#-##-#-----##--###---#--#---##---#--##-#--#--##--#--#-#-#-#--
#---------#--#----#-----#---###-#--#-----#---#------#-----##-#----#--#----#-----#------------------#
---#---#--#--#-##---#--#--#-#---#---#-#--#-#----#--#-------#-#----##-#-----#-#-#---##---#--#----#--#
#---#-----###----##--#-##---#-----##---##----#-##-#--#-###--------#---#-#----#--#-#-#----#-##-#--#-#
---#-#---------####-----##----#------#--##-------#----#--#---#-##---------#-------#-#-------#---###-
--#-#####--##---#--###--------------###--#----#-#------##-##---##-#--#-E-#---##---#---#-##----#----#
-----#---##-----#---------#---##-----#--#----------#-------#-##-----#--#-#---#-#-----------#--#--#--