?diagonal=Never;
#--##---##--#---#--#-----------------#------------#---#---------#--######--#-#----##-#-----#--#-#---
-----#-##----#----#-#--#-#-------#----#-#-##-#-#--#--------#---------#--#--#-#-------------##--#----
-------#------#--####-###--##----##-#-------#-#----#-#--#----#---#------#-#-----###-#-####----------
---#------#-#---#--##-#------#--------#-#-#-#--#-------#-#------#-#------------#---------#--##-##--#
##---#---#---#---#-------##-------##---##---##----##-#--#-------#-----#--#-------#-#--##--##----#-#-
-#---#-##-----###----##---#---#--#--#------------#-----#--#---------#----#-##-##-#----#---#---##----
-#--#---#-------#-------###--#-#-#----##---#----##----##-----##-#----#--##---##---#-#----##------#-#
-##--#----#---#-----##---#--###-##-#####--##------#--#--------##--#--#-#--##-----#---##--##----#----
-#-#----#-#-#--##--------#---##-----------#-#----###--##-#--------#-#--#--#---#--#---##-#----#--##--
-#-------###-#---##---#---#---###-----------------#------#---#-#---#-----#-##--###-#-----##--#--##--
--#-#--------#-##----###--#-#------##--##---##-#-#-------##-##--##---------------#-------#--##------
--#-#---#-#----#-#-#-----#----#-#--####----#------##--------#-----##----##----#--------#----#-##----
----#-----#----#---#--------#-#-#----------####-#-------#--#--#-#-#-------##---#--------#---------##
#-#--#-----#---##-##--##-##----##-##--#--#-------#----##--#---#-###-###--#----##----####----#-------
-##--#-----##-----#----#---#-#----###---------#---#--------#--------#-#-------#-#--#---##-##----#---
---#-#---#---------#-#-------##-##---#-#-------#-#-#-#----#--#-----------#---------#----#--##-#-----
-#-#---#------##-##---#-#---------#-######----#------#--###-#--#---#----#--##--#-----##---###---#-#-
-#--#--#-#--#-#-#--------#-##--------#-#-----#-----#-#-#----#----#--#-#-#-#---------#------#--###-#-
--#-#--------###-#---##-#--#---##------------------#------##-----####-#####--#--#---#---##-----#--#-
#-#-----##-----#-----#---#------------#----#-#-##-#######-##-------#--##-#---------#-#----#----#--##
---#-----#--#-----#--#--#---##---------------##-#---#--------#-#--#---#---####--------#-#-#-###--#--
#-##-----##---###---#-#-##--#-------#-----#---#-##-----#-#-----#--#-#-#-#-----#---#-------###-------
#--#--#----#-#--#--#-##------#---------#--------##-#-##---###---#------##--#-#------------##---###-#
---#----------##-------##--#----###----------#---##---##---#---#--#-#-----##-#--#-#-##-###-#---##--#
-#----#-#-#------##-#---###--#-#-----####--#-------#####-##---#-#-##-#-#--###---##-###-#--#---------
---#----------#-#----------##-----#--------#-----##---------#----##---#---##-#-##--#-----#--#---#---
-##-#--#---#-#---#----##----#-##-#-----#-#-#-##-##---#--------------#-####----#-#-----#-----#-#-----
#----#---#-------###----####---#-#-----####--##----#--#--##--#-------#--###--#------#--------#----#-
------#-----#-----#------#---###------#---#-------#----#---------#-#--#-#-----#--#-#-#-###---#----##
---###----------##---------#---------##-#-##------##---#-----##----#-##-#-##--------#-##--#------#--
---#-#-##--#-#-###--------#--#--------#----#---#------------#-#------#--#--#####----#-#--#-#-#------
----##---##----#-----------#--##-##---#--------#-----#-#---#--#----#---#--#-#-##------------#--#--##
#------##----##-#----#--#--###-#------##--##----#-#-#-#----#-##---------#---#--------#-###-----#-#--
--###-#------------##----#---#----#-#------#--#-##----##-#####-#---#---#-#------------##--#--##-----
###---------#-----##-#####-#-#------#-##---#---##-#----#-#---##-#------#-------#-----#----------#--#
#-#-#-----#---------#-##----##--#-#--#-#-#--#--#---##-#####-#--#---#----##----#-#--#-#--###-#--###--
#----#---##---#-#-#---#-##-#---##-#---#-------###----#--##--###--##-----------#-#------#-#----#-----
----------#----#-------##-##-##-#-----#--#-#------#--#----##-#--#----##------------#--#----#-#--###-
---#----------#-----#--#-#-#-#-#---#--#-----#---##-----#--##-----#-#-----##------##---#-#--#-#-##--#
--#---##----#-------------#-#---#----#-#-#----#--------#--------------##--#--##-#-#-#--##--##---#---
#--#-#-##--###---##--#-##----#-----#---#-#####-----#####------#-#-------------####------##------#-##
##------####---#--#--#--#----------#---#-----##---#---#------------###--#--#-###-#-#-----------#--#-
----#-#-#-#-#------#-----#------##-#-###----##--#-#-----#----##---##-#-#---#-#----#--#-##--------#-#
--------##--#-#--------#-####----##-##--#---#--#-#-##---#------##-------------#----#--#---###-------
-----##-#-------#------#-----#--#--##------#----##---------------------###E#--#----#--#--##--#---#--
-----##---#------##--#------##-------###--#-----##-#-##--#----#----#-----#-----##--#----###---#-#---
-###--##--#---#--#--##---#--#-#-#-----##---#-#---#---#-#-#--#-#-#------##---#-#--#--#--#--------#---
---#-#-#-----#-----########--#--##-##--------##-##--#---#-----###--#--#--####---###----##--#-----#--
--#-###--#------#--##----#-##---##-#---#-----#-#----#---#-#------------######--#--#------##-#--#####
#----------------------##-#---#-------#-------------------#-----#-###----------##--------#-----##--#
#-#-------##---#--#-###----------#-#----------#-----#-##-#-----#--##---#-##------####---#--------#-#
-##-----------------#---#-#----#----------------#-----##-S-##-------#--#--------##--##--###------###
##---#--#--##--##----------##----#----#-##---##-#-------####--#---#-##----#----##-#---#-#--##-##--#-
#-----#----#---------#-##---------#-----#-----#-------###-#----#-#---#--#----#------#---###---#--#--
#-###------#------#-#-#-##-------#-#-----##---#-#-----------#----#----------##-##----#---------###--
--#-##-#---#-#-#-#--#-----#######----##-##-##---#------#--##-#-#----##-#---##-###------#-#-##-------
#-#--##---------##--------#--#---#-----##------#-----##-#-#--------#---#--#--##---#---#----#-#------
#-----##---#--####-#-----#-#-----#---#--#---------#---#-#--#--##-#-##-#---#----#--#--#-----#-----##-
--#-##--#--------#--#---#-#-###------#--#----#-#-#-----#---#--#-##-------#----#--###-#-----#---#---#
---#-----####----#----#-#--##-#------###--#---#-#-#-#-#-##-##-----#----#--#-----####--#---#--#-##---
-#-###---#-------------#----#---#------#-#------#--------#--#####--#--##-#-#-#------#--#-#-##-##-###
-#-##-#-#-#--####-#----------#-#-#--#---#--##-#-------##--#----#----#---##-----#-##---------#---#-#-
#-----#-##-##---------#---###--##-#---##----#--#-#---###---------#---#-#--#####-#-----#---#----#----
-##-------##---#-##-----#---------#-#--##--#-#--#---##-#---#--#--#-------#-#--------#-#--#-##--#--#-
--##-#--#-#--#-#---##---#------#-#----#---------#---#--#----------#---#-#---#--##-------------##----
-#-#---#-----#-#-#-###----###-#--#----#------#--#---#-##---------#-----#----#--#-#---##----#-#-##-#-
##-----#-----##----#-#--##--------#----#----#-#----#----##----#---#--------##----#--#--##--##--#--#-
-#---------##--#----#---###--#--#-----#----#------#-#-------#-#-----#----#--#-#-#---#----####-#-##--
-----#----#-#-#------------#-----#--#--#------#----##-----#-#-----#-###--#----###--#--#--##--#---#--
-##-----#------#-#-------#---##--#-#---#----##---#-##-#------###-----#-#------#--#--#-#----#-##-----
----##---##------####-----##----#---###----#--#-##-#------##-#-#--##-#--#--------------##--##------#
-#------#--##------#--#----#-#-------#--#-----#-##-#-##-##--###--#-##--#----#---#--#--#----##----#-#
-#------##-----###-##-----##---------#######---##---------#---#----#--#-###---#--##------##---------
#--#-#--#-#-#----#-------##-#---##---##---##-##---#----------##---##-##--#--#--##---------#---#--##-
##-----#----#------###--------##--##-##--#-----##-----#--#-#-#-#---#-----#-----#--#-#--##---------#-
--#---#------###-#--#-#--------#-####--##--#---#--#---#-#------###-#-----#----####------#--##--#---#
--------#---##--#---#-#####-----##----#-#-#--#----##----#---#----------#-###--#-#-#-##-----##-##---#
-------#-----#-#-------#--##--#--##---#----##--------------#---##--#--##-#-#-##-##-##--#-##-----#--#
#------------#-----#--#---#-###-----#-##-##-#--#--#-------#--#--##--##-##--#--#-###---###--#-#-##---
#------------##-----##----#-------#-#----#----#----#----#--#----------###--#--#-####--#---#---#--#-#
----#--#--------####---------#--##--###---#--#-##-####-#--####-##-----#-##-#-----##--#----------##--
--###-#--#------------------##-#---#------####----#-----#--------####-##---###---#-------#-#-##---#-
-#-##------------#----------###----##--#------##-#---#---------#---#--#####--#-----##--------#--##--
#-#-#--#----#---#-#---#-###-#-#-#------##------#---#-#---#---#---#------#-------#--##--#------##----
-#--#-------------##-----#---###--##-#-#--#---#-#----##-#-#--#-----#----#--#-####------#---#----#-#-
--#------#------#--#--#--#----###-##---###-------#-----#---#-#-#-----#-#-#---#---#-----#---##---#-#-
-#------##------##--#------##-#--------#-#-#--##--##------##---------#--#---#-#------#---------##--#
-#--#-#--#---#-#--##--#-#--------#-#----#------#---#----#--#-#-##----##-####------------##---#-----#
#---------#####-#--#-#---#---#-------##-##----#--#--##-----##--------#--------#----#-#-#-####-#--#--
--##--#----#------#---##-#----#---##--------#---------#--#-#-#-#---------###----#-----#-#---#-----##
##---#-#-##----#-###-#-####-#---##--#---#-#--##-#-#-#-##-----##--#--###-------#--##-#--#-#---#--####
--##-####--###-----#-#--#-#-#--#--------#-#-#---###----#-###-##-----#--#----------#--------#-------#
---#--##-#---#------#---###------------#--####-##-------#---##-#####----#-#----###--#-#--#---##-#--#
-#----#-##-------#-#---###-----##-----###-#--#-----#------##-###--##-###--#-----###-------##-#--#---
#-------#----#---#--#-##--##----#------#--##----#-#####----###--#-#---------#----##-#---#--#----#---
-----#------#---------##---#-#---###-##------------#----#---#--#------------#-#--#---#--##-------#--
--#-#--#---#------------##---#----##-##---#--###-##----#-#----#-#-------##---#----###-#--------#----
#---##----#------###---#--#-##-----###-------#--##--#-##-#-#--##----#-#----#----###-#-#----###---##-
----##------##---#-------#-##-#---------##-------#--#-#--##-#-------------#-#--#-#---------##-##--#-
--#-#---#-----#--#----------#-#-##---#----###------#--#-#-#----#-------#----#-#-#-----------###--#-#