?diagonal=Never;
###-#----##---#--#-#------####-#----#----#--#---#--##----#-###---------###-##-#------------------#--
-#---------##-#---#--##--#-#------#-----#---#-----#-#-----#--#-#---#-###-#------------------#-------
-##-#######--#---------###---#--###---#-##--#-#-#--##-####-------#---##-#--#--#---##-#-#-#--###-----
-##--#---#----#---#----#--#-#---#-#---##-----#--##------#---#-#---##----#-#--#-----#-#--##-#-------#
---##-----#--#--##----#--#-##--#-#-----#-#-----#-#-##-#----##-#-##--##--#-#-##--##--##--#--------#--
#----#--##-#-#-##-#-##-#-#-#-------#---##-##-#-##----#--##-####------#---##----#--#-#-#-#------#-#-#
----------##---##-----#--##----#------#####----#---------#---------#-#---##--#--#--###--###--#-#----
###---#-------------#----##-#-##-----------#----#-##-#--#-#----###---#---#---#-------------##-#----#
-##---#-----#-##--#----#--#---#---#----#---#-----#---#---#----#-####------#-##--------#----#-##-----
###---#--#--#---#--#-------#-------#------##--#-#---##-#-#-######---#--#----#-#-#-##------------###-
#---------#-#--##--#--##---------##---###-----##--#----#--#-#-#--#---#-#------#-----#---##---------#
------#--#-#------#---#-----#-###--------#-#-#--#----#--#--#--------###--#------#--------------#-#-#
--#-###-----#------#----------#-#----######------------##---#-#------#---#--#-#-----#-##-##-##--#---
---#-----#----#-#---##--#-----#---#-#-------------#-#---#-#----#--#-----#-##---#-#--##-#-#-----#-#-#
#-------###-----#----###-----#-#-####--##----#----#------#-##--------#-#-----#--#-------#-####----#-
#-#--#-----####--#-----------##----#--------#-#-------#-##--##----###---####----------#--#--#-----#-
#-#-----###--------#--#----##---#-----#--#----#--------##---#-------------###-----##---#--##----#-#-
----#----#---##-#-#--###------#--#--------#------------##-#--#-----##-#-#------#---##--#-----##----#
#---##-#---#-##---##---#--##-#-#---#--##---------#--###-------###--##-----#--#--###-##-##--#-----#--
----#-----#-#-#----#--#---#--##---#-###------#-#--#-#-#-----#-#---#--##----##-------#--#----#-------
--##---#-----##-#--#-----------#----#-------#-#------#-#-##--#----------##--#--#----##--#----##-----
#---------####-------#-#-------#------##------#-----#---####---##--#-----#--#----#--#-----#--#--#--#
-------#-##--###-#---###------#--#--#---------##--##-##-----#-----#-------#-----##-----------####---
#--###----##----#----#-##--#-#-#---##-------#-#--#---#-------#-##--###--####----#--#-#--#---#-##--#-
#-#--##-##-----#---#---##-#--####-----------#--#--#-------##-#-#---------------#-#-#---#--#---------
-#----##-#--#-#-#------#--##----#--#---#-##----##-----------#----#--#---#-##---------#-###--#-#----#
----#--###-----##-----##------#-#--#-----#--##-#-#---#---#------#----##-#--#---##---#---##-------#--
-#----##-----#-#----#----##-----------##------#-##-#----#-#--#-##-###------#----------##---##----#-#
--#---#--#------##--#-------##-##-#--#---##--#-##---#---#-##---------##-#---##----#--###-#-##-#-#--#
-#-#---#-------##-###----#--#---#-----##-##-----------------#------##-----#--##----##----#-##---#--#
-#---#-------##--##-#-##-#----#---#--#---------#-------#--#------#-#-------------#----#-#-##----#-##
-#------#-------------#--#--####-------#----#---#-##--#-###--#--#------#------#-#-#---#--##---#-#---
-###-----####----#-#--###---#-#------##--------#--#-#------#---#-#------#---#------###--####-##---#-
------##----###--#----#--#-###-#--##-##-#--#---------#-#-#---#---#---#-#--###----#--#--#--#--#---###
---#-#-#---#-----#----#-#--#-#--#--------##--###---#-#-----#---#-#-##-#-#-#----#----##----------#--#
#---###--#----#--#------#-----#-#-#--#------#-##---##---------#------###-###--###-#----##-#--###----
-#-##----#-#--##-#-##---##----#-----#----#--#-#-##---#----##-##--###-#-#----#--##----#-------#---##-
----#---#--#---#--#---#--##-#--##------#-##--#-#---#-#-----#--#----##-#---#----###--#-##----##--#-##
-###-####-##----#---#----#-----#--#--#--#----##---#-###---#-##----#--------#---####-#----#-#--------
-----#-----#--#-#--#------##--#-#--#------------#--##---##---#--#----------#--##-##-#-#--##--#-----#
#-#----------#--##----#---#-#-------#-----#-#---##----#----#-#----#---##-#--##---#--#-#---#----##--#
##-----##-------#---#-#-#--##--##-#-----#----#----#-#---#-#-----#----##------#----##----###-#----#--
#--###------#------#--#-#----------#-##-#-##---#-#----#-------#---#---##----###--######-------#---##
#------#####-----###-#-#------------##--#-------#---#--------#---#-----#---#--#-------###-#-##--#--#
-###---#-##--###----#-#----##----#-##-#----#----#---#----#--#-###---##-#-#-#---###---#-#--------#--#
#---#---#--#----#-#--####--#---#---##----##-##---#-##-#-----#--#-----------#-#----#-#------##-----##
----###-###-##-##------#---#-###--###-#-#----#--#-#---#--#-----#----------#------#-#-------#-----#--
-#-#--#-#-##-#-----#-#--##-#------#-####------#-#-----#-####-#-#--##--#-----#-#---#--##-##-##-------
------##-#-#-#---#--#----###---#--##-----#-##--#-#-#--#----#--###-#------##-#----#-#--##---##-----#-
-#--#---##-#---#-----####----#-##-####-#--------#--#---#----------#--#-#-----#---#-#-#----#-###-#--#
--####---#-------##---------##------###--##----#------#--------#---#--#--#----##---##---#--#---##-##
-##-----#---##-#------##-#-#------#--#----#---#-#---#--#--------##-#------#------#--#-#-#--###--##--
--##--#---#---####-#-#S--#--#------#-##---#----#-###-------#--###--#--#--#---#---###---###---#---#-#
---####---#-#---#-###---#--#-##---------#-#--------#---------------##-#-------#--##--#E-----#-#--##-
-##--#-----##-#--#-#--#----------#-#-#----###--###----#----------------##------------##---#-##-#-#-#
#--------#-----###-#-#------#-#-#--##---##-##-#-#----#----#----------------------#--#---#-#-##--###-
#-------#-------##-------###---###-#-#-#---#---###-#--#-------#--------##--------###--#---#-#--#----
###--##--#-----##----#-#---#-###--#--##---#--------#-----###--#-#----#-####----#--#---####-#-----##-
-##---#-------#--#-#---#---#-#-#--##--------------#-#-------#-----#-##--------#----#--#---#--##-#--#
-##-----#--#--#----##--#-#-----##-------#--#--------#--###---##-##----##--#--#--#--#-##-#-#-##--#-##
---##----#-#-#--#--#-##---#-##--#----#------##---#-#--#----#------##--##---###-##---#--##---------#-
-##---#-#-#--#----#-##--##--------#------#---#----------#---#----#-##----------#--#-------#-#--##--#
#----#------------#--##-#--#---#-#---#-#--#----#--##----#--##-----------##---##--#-#--#-#-#--#-----#
---#-------#--#-#------#--#-#---#-#-#-####--#----##----------##----#-#-#-##------#----#----##-----##
---#-------##--#----#-###-#---#--##--##------#---##-#---#---##------#----#---##--#-#-------#-#-#---#
--###--#-#---#--#--#-----###--------#--#----#-----##---##------##-#-----#-#--##--#-#-------#-#----#-
-------#-###----#----#------#-#---#-#-#----#-####--###-#----#-##------#-----#--##---##---###-----#--
----#---##----#------#-----------#-#-----##-##-#---##-#-------#---##-#-----##--####---#--##-----##-#
------#-###---#---###-#---#-----##-#-------------##--#--##--#--##---#------#-#------#--####---#-----
##----------#---####------#-----#-#---------#------##-----------####--##--#---##-------------#---#-#
-#------#----#---#----###-#--#------#------------------#--#----#------#----#------#--#--#-------#--#
-------#-#-#--#-#--------#---##-----######----#----##-#------##--#---------#--------##-#-#----------
#----#-#-#---##---------------#--###-------#--#----------#--#-#----#----------###----#--#--##--#----
--#-----#----###---#--------------#----------#-###-###-#----#--#---##-----#-#--#----#-#-----------#-
#-#---------#--#-----##-#-#-##-#----#-------#-----##------#-##------#------####-----#---#-#---#-##--
----#----#-----#----##--#--#-###--#---#####--------#----#--------#----#---##-----#----#--####--#-##-
--#--###-#---#---#-##---#-----------#--------------#-----##--#-----#-#--#----###--#-#--#---#--##-#-#
-#-#--##-##---------#-##---###---#--#-#-###--###----#-#-#----##-#--##----#-#----------#--##--#--#---
#------###-#----#--------###--#--#-#-##---------#-#----#------------#----#-#--#----#---#--#---#-----
-##---#-#-##-##---#-#-#-#-#--#--#----#-#------#----------##--#-###--#----##----#-----#--#---#--#-#--
--#------#-----#-##--#-----####---#-#-#-##-#------#----#--#--#----#------#--#------#--#--------#-#-#
-----------###--##----#-#-##-#--#-#--------#---#-##---##--#---#--#---#---#-#--#---#----###----#-----
---#-#------#--#-------#---##---##--#---##---#--#----##-------#--#-#--###-##-##-#--#----###----##---
-----#-----#-#----#----###------#-##--#---##---##----#---##----------##---##-----#-----#--#---------
#--##-#--------##--#----#-------#---##----#-##--#-#-------#--#---#-##-----####-------------##--####-
-#---###-------#-##----###---#--##-##--#--#####--#--#-####----###--#-#-###-#--------##-#-#-#----#-#-
--#---#---------#-----#-----##---#--#---------#---#---#--#---------#-------------#-------#--#------#
#---#------##---------##-#-#-#-#-------#---#-#-#--#---------#---#-#--#----#--#-##-----#---------#-#-
------#---#-#--#---------###---#-#-----------#--#-#----#---#-----#------###-##--#-#------##---#-##-#
-#-#--#-#---##---#---##--##----------######----##-----#--#--##-#-##----#-#---#---------##--------##-
---#----------##--#-----#-##-----##---##--#-##-#--#----#--#####--###-------------------#----------##
---#--#-#-----#-------#-#-##-------#------#-#-#--##-#-####--##--#-------------###-----------#--#----
-----#---##-#---#-----#####----------##---#------#---#--##--#--##------#--#--#-#-------------------#
-------#---##------##------#----------#-----##---#---##---#-#-##-----#-#--###--#----#--##-#--#------
-#-#---------------#--#-#----##--###----#----#----#---#-#-#---------#---####---#-#---##---#---###-#-
----##-----#-##----#---#-#-------#----#---#--#--#-##---#----------#-----######-#-##---####--#----###
-#-#-#--------#---#--#--------#--#-----#-#--------#----##---#-----#------#-----#----#-#--------#-#-#
--#-#---------#--------#-#-##-#----------##--##-##--#----###---#--#-#----##-------#---#-###---------
----#--#-#---#----##--#-----#-#---#-#---#-----#-##-----#-----##------------------------------#-#---#
##--------#----#---#--------#--#---------##-----##----##---#------#-###----#-------#-#-----#--------