?diagonal=Never;
#--------#--#----------------#---#--#-#--------##----#--------##------##--#-#-##-#---------#-#-----#
---#-#---#----##--#-#-#----##--#-#------#-###---#----##--#-#-#---------#-##--##---#---##--######----
---#-------#---##------#----#---#-----#----------##-##-#-##-#---#-#----#-#----##--------###-#-----#-
-##-#-#-##----------#-----#-----#-#----#--#-#-#-#---#------#-##--#----#-----#---#--#-#---#----#----#
-##------#----------###-----------------#-#-------------#--#-#-----#-#--####-#--#---#-##--##--------
-#--------#---#-----#-#--##--##-#-#-#------#--#---#-#-----------###--#-------#-#--##-###-----#---#--
---##--#--#----#-----###-#-#--------#--###-----#--#---#--#-#--#---#-#-#-#-----#-#------#---#-#-#----
-#----#-#----###-----##---#---##--#---#-#-##--#--##-#--##-------###----###-#-##-#--#---#----#-#--#--
##--###--------#---#-#---#--#-##-#--#--#-#--##---#-#-#-----#---#--#---------#---#-#####-#--#-#---#--
-#---##---##-#----------#-##--------#-#--##---#--#--##-#-----#-#-------#---------#-#--##-#---#-#----
-#--#----#-#--#-#-##---#-#-##-------#-#------#----##----#-#-##--------------#-----####-----------##-
-----##---------#------#---##-##---#----##--#---##--##--#---#----#------###-----#-#-#----#----##-#--
#------#-----##-------#-##-----#--#-#-#-#-#-#-#-##--#-###-##----##---------#-#-##--#--#--##--##-#-#-
---#------####-#-#-##-----##------##---#------#-#---#-#----#-###-#---#-#--##-#--#-------#---#--##---
--------#---------##--------#-##-#-#--------#---#-----------------#-#--###---#-#--##-#-#---###---#-#
#------#-#----------------#-----#----------#----#-----#---#--#------#-------#--------##-##---#-##---
-----##---------#-#--#---#-#----------#--------####-#-----#-#--#--#####-#-------#----#---#--#---##--
##--####----------#--#-#-#---#--##--#-------##---#-##----#-----##------##-#---##-#-------####-###-#-
#-------#-----#------##-------####--########-#-----#---#-##-----#-#-##------##---#--##---##-------##
###--##---#--#---####-----S##--#---#-------##---#-##-----#--#-#--#-#-#---##---#--#-#--##-#----#-----
-----####------##---#--#--#--##-----##-#--###-###--#--#-#---------#---------------#---#-#-#----#-#--
----------#-#-##----##--#------#-------------##---#--------#--##-------#------#----###-#-#-------#-#
#---#---#---#-##----##----###--#----#----#----#------#--##-----#-------#-#--#-#--------#--#-#----##-
--#------##-#----#####---#--####---#-#-------------------##-#-#-##---#---#--#-#--##-####--#-#-#-----
----###------###---#------#--#-----#--------##-#-##-#---#---#-----##---#---#-#-#-#-#----#-#-##----##
---------#-##-#-##------#####---------#---#---#----#---#--#---#--#--#---##----#-#-------##-#--------
#--------#-#-----##-#--###-#----#-------------#-------#----##----#-#-##--#---------#-#---#---#---###
--#--#----#-##-----#--#--####----#--#-##--------#------#-#--------------------#-----------##--#---#-
-#-#-#-----------#--##--##-#----------#---##-#--#-##-#----#---#-----##---#-#-#--------###-##-#--#-#-
--#-#-------#--------#-#----#--------------#--------#--------#-------##----#-#---####--#-----#--#--#
#-#-----#---------#----##-#-##-----##----------#-#--###---------#--#--#---#----------#---#-----#----
-#--##--##---#-#----------###----##---#--#--#-----#--##--###--#------##--##-#----#-----#-#---#--#---
---#-----#####--------#-#----##-----#--#-#--#--#-#---------#-#----------######--##---#---#-------##-
--#--#-#-#---------------------#-------##--#----#-#-#-##-##-#---------------------------#-----#-----
#-------#-#-------#-#----#---------#--##---#---#--#-#----###---#--#--##--#---##----------#----#--##-
-#-###-#-------##-#-#-#----#---#--#-------###--##------##----###-------------------------###--#--#--
-#----##--#-------#--#----#-##-##-#--##---#--#-###-#-##-----#-#-##----#-#--###-#----#--####-#-#--###
---#----#-#-#--#---##--##-##---#-###----##-#---#----#E---##--#----#-#---##-#---#-#------#-#-----##--
-##-##-#--#----#-###-#--#--#---##-#-#----#---#----#-#--#----##-#-#-#-#-###---##----#------##-#------
--##-#---#--#--#---#--#-#-#--##-#------##-#----------#-----#-#----#-##--##--#-#--###-#-##--##---###-
--#------#--#----#--##-##-###-#-#----#--#-#----#----------#-#--#------#-#--#---#------##------#-##--
##-#-#------#-#--##----------#------#--#-----#---#-##----#--#--#-------------#-------#-#----#-####--
------#-#-----#-##-#-#-#--#----#-#------##------#--#------#---#---#--##------------#-###---#--##----
--#----#--#-#-------#----#---#----------#----#-#--#--#----#-------#--#-###----#-#-------#----##---#-
---------#----##----#---##--#--------#---#---##---#------------#--#--#-----#--#-###--#-#-----##-#--#
-#-#-#---##------#--#-#-------#---##-#---#-##-------##-##-#---#-----#-###----#--###--##-#--#------##
-#--#-##-#######-#------#-##--#---#--###------####--------##----#-#-----###----#-------#-----------#
#-###-----------#-##-#---##--#----###-----------#---##---#---#-###--------##-#--------------#---#--#
------#-##-#-#-##-------#----#-#--#--#-#---#-##---##--#--#---#-##---#-#--##---#-#-##-----#---#-----#
------#--#--#-#---#----#--##-#-#-##-----#--------###--#--#-#--#-##---#------#---#-#---#-----#--#----
-#--------###--#--##------#---#---#----------#-###-##----#---#--#-###--#--#####----##-#-------###---
####----------#-------#-####-----#-#---#----#----#-##---#-#-------##--#-#------#----#---#-#--##----#
----#-----#-#-#-----#-##-#-----###---#---#----------------#---##-----###--#-#--#---#######---#------
---##--##-#-##---##---#-------#-#---###----#-----#--#--##-#---#---##-##-#--------#------#-####-#-#--
---#--#---##--#--#--#-#---###------------#---------#-#----##--##---------#-----#--#---#######----#--
#--#-------------##-#---#-#---#--#-##--##--##---##-#-#---###-#-##----#--#-##-----#-#-----#------##--
---#--#-------#---#---##-#----##--##--#--####--#--------#--##---#--###--##--#-#----##-----##---#----
-##-#----------#-------##----####---#-#-#-#-###-##--#-----#----#-#--#----#-##-#-------###------##---
-#---#-#-----#####-------####-#-#-###-#---#-#-#---#--------#----#------#--#-###------#-------#--##-#
--##--#--##-###--##------#--#-###-#-#-#----#--##----##-#--##---##-#-#-##---------#--##--------------
---##----#-#---#-------------#-#---#---#--#--#--#------#---##----#-----##--##------------#------#---
##-----#-----#-------####-------#-#--#-------##-----####----######----#-------##----###---##---##---
--#----#-#--###---#-#-##-----##-#------#---#-------#-##---#-#-#------#-#-###-----#------#-#---##--#-
-##-#-----#-#---#--#--------#--##-----#-#---#------#----#-#-#--#-----#----------##--#-#----#--------
---#--#-#-------#--------#-#--#-#-#-####-#-#-#-###-----------------##-----#--##-------####------#---
----#--#-#----#-###--#-------##---##---#-#--#-------#--###----#--##--#--#---#-----#--##-#--#------#-
--------#---#----#-##-#---------###-#-#------#--#-#----#-#----------##-##-#--#--#-----###--###--#--#
----#----##--###-#-----##---#--#-#---##-##-##-----##-#--#-###--#-#-#---#-#--##----#--#------#-------
--------#-----###-#----#--#---#----#--####---#----##---#-#---#--#------#-#------##--##------#-##----
-----##--#-----##-#-#--#--#----##-##----##-##--#----#-----------#--#####---#------#--#--#---#--#-#--
##--#---------#-#-#----#---------#-###-#-#--###--------------###--#-#-#-#-#--##-----#----#--#-###-#-
----#----#------#-##-----##-#--###-----#------#--##------##----------##------#-#------#----#-##--##-
------###---------#-#-###---##-#-#-##---#--##-#--#-#----##--#-----#---#----##-------##--##-####----#
-----#-----------#------###-----#---##-###---##--#----#-----#-----#--##---#-------###-------------#-
-##-----#-##--#-#####-----#---#---#-----------##-#-###-----#----#-------#--##--#--#---#-#----##-----
------#----##--------##--#####------#------#-#-------------#-#---##--##-----------#-###-----###-####
-#-#------#----#-----#------#--------#--##--#-------#--##---#--#-----##-##--###-#--#---##--------##-
-#---##------------#------#-------##-----#-----###-------##-#--#-#------#--#-#---#--------#---#-#-#-
--##---#-----#----###-----#--#--#--#-------##---###----##--####---#----#-###-####-#----#-----------#
--##----##--###-#---#-#-------##---------#----#-#-#-#---#-##-#-----##-------#--##----#-#-------#---#
#---#-#-#----#-#---###------#---------#-##-#------#--------------###--#---#---#-#--##---##----##---#
--###--#-#-----------------##-#-#--#--#-#-##--#-----#-##---#-----#--#---##--#-----#------#-##-#---#-
-#-#-#-------------##--#-#--#-#-##-----------##--#--#----#--##-----#----#-#-#-#-#--#---#---#---#-#--
----#-#---------#---#--------#-##--#----#-##-##--#----#--#--##--##------#-#-#----#-##------#-#---#-#
---##----#-#-#---------------##-----#-#-#---#-----#-----#-#-------###--------#---##--#--#----##-----
---#---#---#-----#--#-#--#-##-------------#-##--#--#--#--#---#---#--##-##-#-#------######---#----##-
#------------#-##----###---------------#----##---##-----#-##-#-#--#---###-#---###-----#---#-###-#-#-
---#--##----#------#-#------##--------#---##-#-##--#-##--##--------#-----##---##---#---------------#
-###----##--------#--##-##----##-#--#--#--#------##------#-#--#-###---#----#---#--#----##----#--####
----#-----##-###-#---#-#--------#-#---#-#-##--##--#-#------#-------###----------###---#-#-##-#-##--#
#--#-###--#####----#-----#-#---#-#-----#-#-##-----##--##-#----#-----------#--#-#--#--###-----#----#-
---------#-#------#--#-###---#--#-##-#-------------#--####-----#--#-------#-##--------#--##-#---#---
-----#-----------#--#-------#----###-##--#--#-##-#-----------#---###-----##--#------#------#---#----
-##-#------#-###-----#----------#-----#-###---##-#--###-----#-#--#-#---##--------#-#--#---#-#-------
-----####---#-#-----------##--#-##-####---#-----#--#-#-##-#----------#-#-#-----------#-----####--##-
-----#----------##-##--###-#-#-#--------#--##-----#-#----------#####--##-###--#-#---##-##-----------
#-#--##----##---#--#----#-#-----##-----#-#-##-##---#--#----###-#--#--------#--------##----##-----##-
------#-##-#---#-##---#---#----#-#---#------#--#----------------------#--#-##--#-##---##--##---#----
#----#------#--#---------##-#-----#-#-#####---#-##----#---#-------#------###-----##--#-#--#----#----
-##---#--#-##-#----#-----##-#---##--------#-#-##--#-------#----#--#--#-#-#---#---#----#----#---#---#