?diagonal=Never;
-------##-#--#-##-#------#--#---#-----#-#--------#-##---------#-----#---#--##--##-#--------#-----###
---#--###-###-#-----###-#---#-###------###-#-###-###-------###----#-#-----##------#-##--#---#------#
--#---#------#-####---#-#--##-#--#--#-------#-----#---#------#---------------#--------#--#-#-#--#--#
-#---------###-#-----#----#-#------#---------------##--#--#--#-#----##-###-------##---------#-------
#---#--#--#---##--##-------#---#---#-#-##-###-##---####-#-------------#--------#---#--#-----#-#--#--
#------#-----##---#-#--#-----#--#----#-##--------------#--##-###--------#-#---#----#-#----##---##---
#----#-#-E-##--##------##-#---#--#---###--#--##-------####--#----#----#--###-#--#--#-#--#-#----#---#
--###-----------#--------##---#----#-------#--##--#-#---##--###---##-#-------#--##--------------#-#-
---#-#----##----##-#-----------#----######----#---#-#-------###----#------#-##----#---#---#-####----
-#-----#---##--#---------#-#--##--#----#-------#-----------------#----#---#--#-#----------#-#--#-##-
-#----##------###--#-----##-##----#--#--##-#-----#-------#----###-#----------##--##---#-#-##----##-#
##--#-##-##-#-----#--------#-------##--##---#-#------##---#--#------##-##------------#-#-##---#-----
---#----#-#---#----#####--#---##-----#-#---------##--#----###-#-#--------#---##-##--#----##---#-#--#
-#-------##-#-----##--##-##-----##--#--#--#----------#-#---#---#-------##----##---#---#------##-----
-------#------#---#--#####---------#---------#-#----#--##-#---#-----##-------##--###----------#-----
##-##-#--#--#-#----#---#---#--#-----#---#-##----#-#-------#-####---#--#---##-##-#--#----------------
-#---#---------##-#------#---#-##---#------##-----##---#--------#--#-------##------#-#-#---------#--
#-##-##------#---#----------------#-#----##-#--#-#----#--#---#--------#---#-#---#-#-------##--#--#--
-#-#----#--------#--#-##-----###------#-----#-----#--##---##--#--#---##--#-#-----#--#-#-#---##------
---##--##-#-#-##--#-#-----#--#--#----#------#--------#-#-----#--#----#-----#--##--##-#-##-#-#--#--#-
##-----#--#----##-------#---#-----#--##-##-#####--#----###-###----#-#------#---###-#-#----##-#------
-#--#-#-#--####--##---##----#-#--##-----#----#-----------##---#----------##-----#-#---------------#-
--##-#------#----#-#-----#--#--##-#------------#----#----#--###-#-#--------##-###---##-#------#--#-#
#-#-#---#-----#-##-------#---#-#---#-----##-#--#--##-#-##--#---#---######------------#-##-#--#--#---
##--###---------#-#----------##--#----##-#----#-#-----#------#-#-##--#--#--#--#-#------#--#--##-#---
#---#----##--------##-#-#---#-##----#---#---#----##-#----#----#---##-#--#-#-----------##--#-#---#---
###-#-#---#--------#--#-----#--#--#--#--#----###--#--#-#----#------------##-#----##---##--#--###----
--#-##---##---##---###-#------#-----##-----#-----#------#####-#----#---#-----------#---#-------#--#-
---------##-#-#-#-#----#-------#---#-----#-#--#---------#---#-----##---------#-#----#-#-------------
---#-#------#-#----#----#--##-#---#--#----##------#-##---##----##-#-----#-#-#--#-#--#--##------#-#--
#--#---#-##-#-#-#----##-##--#-----#---#--------#--#-#------------##------##-#-#-#-----#--#----#-----
#---#-------#---#--##-------#--#-#####--#---#---##-------#--##-------#-#--#-###---####-#--#-#---#--#
-------------#----#---#---#-----#-#-----##------#---#-#----#---#-##------#-#---##-----#------#----#-
----#-#--#---#--#-#-#----##-----#####-##------#-#-----#-#--##------#--#---------------#-#--##----#--
--------##----#--#-#-#----------#----##--#-------#--##-##--#------##------#--#--##---##---##--##----
-#----#--##-##-##-##-#-#-##-#-#----##---##--#----###-#----#---#----#---#--#------#----------------##
-------#---##--##-#-#--###-#----##---#--#--#----#-##-#------#---#------##-----#--#-#----#--#-#####-#
##--------------#--#---#-#---#----------#-#------####--#-------###----##----#--#-##-#--------#--#-#-
---------##-#------##-#----#---------------##---#---##-#-#---##--##------#--#-----#--#--#---#--###--
---#--#----------#---#--#--#-------------#--------#--------#---#-#-------#--###---##-----##-----####
----#-#-----##--##-----#---##--##-----#-#--##-#---#-#-###----#----##--#-----#--#-#-#----#--#----#-#-
-#-#-----#-##----#---#----#--##-------------##---#####--#-----###-#---------#-----#-----##---#------
-----##-#--#-------#------#--#--#-#-#------#----#-#-----------#-#-#--###----###--#--#-------#----##-
----#---#--#------#-#--------##---#-###-#-------##----#--#-#----#--#-#-#-------#-##-#--#---#-#--##--
##-#--#--#-#--#-------------------#-#-----#---------#-----#---#--#-#-#-#-----#----##-#-#---#-##---##
-#-#-----##---##-#------##-----#--##---#-##-#--#----#----###----##----###--------#------######-#----
--##---#------#-##--#---------##-----#----------#--#--##------##-#----##-##-#---#---#--#----###---#-
#-#-###--------#--###-#---##-------#-#--#-#----####------#--##---------#--#-##----------------###---
---##---------##---#-#----#----#--##----###----##----#---##---------##---#-#---#-#-####-###-#-#-#-##
#--#-##----#-----###----##-#----#-----#----##-##-##-#----##---#----#---##--#---#-#--##-##---#--#---#
-----#--------##--#-##--#--##--#--#--#-----#---------#-#--#-----#--##---#-----#--#-#--------###---#-
##-#-##-#-##---#---#---------#-----#--#-#-#-#--#-#-#-#--#---###-#-------#-#-#-----#--#---------###--
#----#--##----##----#-#--##--#-#---------#---###-##--------##--####---####-------#---#-------#----##
-#######--#----#-#-----#-#---#-#--------#-#---------#-----#--------#----#----#-----#--#------###----
-##--------#--#-#------#--##--#-#---###----#-#----##----------##-#---#-#-#-#----##-#----###-#--#----
##---##-##-#-----#--##---------##--#-##-------#-------#--------#--#---#-##---#----#---##---###-#-#-#
--#------##---#-#-####-#------#---#--#######-#-#-------#-##-#-#-#-#-----#----#-#-#--##--#-------#-#-
---#---#---#--#-#-#---##--#--#-----------#-#--#-#----#-#------###------#--------#-####----#---##----
-#-#----#--#----#--#-#--#---#------#---#-#--#------#------------##-#-#--##--#---##-###--#-#-#-#-##--
#-##--#---#-#-#----##--#--------#---#-##------##----------#-##--##----#----##-------##---##------#--
#-#-#--#---------#-#---------#-------###-#----#--------##-#-##-#------#---#----#---#---#-#-#----####
--###-----##-----#-----#------#----#----##-#--#-#--#--#----##-------##--###--#--####--#-#-###---#---
--#---###---#---##--#--#--##-#--#-#----#--#---#----##-#--##-##----##--##-####-------#--#----##-#-###
#-##-------###-##------###-###-------------#--------#--#---------#-#-##--#-#-#--------###-----#-#-##
--###---##---#------#----#----#------#------#---#--#-----#-#-#--##---#--##-##--#-----#-##-##-----#-#
#------#---#-##---------------#----#-#---#-#-#-#--#----#--#---#-#--#-----#--#--#--#-#------#---###-#
-----##-#-#-#------#----#-##----#---##--#------#-------#--##-#-----#-----#-#---##-###--#-----#-#--#-
-##-----#---#--#---#-#-#--------#-----#-##---#-#--##--#-#-#----#-----#---#----------#-##-#---#----#-
-##--------------------###-----------#----#--###-#-##--#------#--##--#-----#-----###--##--#---#-----
-#---#---#---#-------------------#--#---------#------#--#----------#-#--#--#-----##-#--------#--#---
--#--##-##-#--#---------###-----#---#--#-------#--#-----##---------#---####---##--------#--##-------
-----##-#---#---###-##-#-###-------#-#-#---#---#-----#-#-##--#-#-----##---##--S#--#-#-#-#-------##-#
---#-#-#-#---#---#-------#-----#--#-----##--##--###---#----##--#---#-----###--##-#--#------#----#-#-
---------##-----#---##-#--#######-----##--------##---###----##-----##---##--#--#------##-#-#--#-#-#-
-----#-----#-#--#-----##-#-#------------#-#-----#---------##--#-#-#-----#----####-#---#------#-#----
-#-###------#-#-##------#------#--##--#--#---##-##----#-----#-#----#--#####-#----#-#------##----#---
#---##-----#-#-#-##--#--#---------#-#-----#-#---##--#-#--#---##--#-##----#---#--#--##--------------#
----###-##--#-#-----#---##----#---##-------------#--#-------#-#-#-#--###-#-#-##--#---##--#---#####-#
#---#------#-#-------#-------------#-##----#----####-----##---------#--#-##--#-#-#---#-#--#-#--##---
-#-##--#---#-###-#--#---#--#--##----##-#---#-------#-##---#---#-###-#--###-#-#-----#-##---##-#-###-#
--##--------#---#----#-##-#-#####-----#------#-##-----#-----#-----#-----#-#-----#---------#--##---##
-#--##------#-##--#-#--###--#-##----####------#--#-#------#-----##------##-----##---------##--#-###-
#-------#-#-###--##---###-------##--##---#---##-##------------#----------#-----##-------#---#-------
-###-------#--#-#----#-#------#--#-----#-#--#--#-#--#-------#--#---#------###----#-##------#--------
#---##----------#----#-#-##-#####------#--#------#-#------#---####---#---##-#--##---##--#-#-#--#-#-#
-----##----#---#--##--#----###-#--------------#-##--##-------#-------#-#--#-#--####--#-#----#---#---
-------#-#---#-###-#--##-#-##--#---##-------#-#-------##---#-#-----##---#--#----#---#-----#-----#---
--##----#---##----#----###------#-#---#-###----#-#--------------#-----#------#--##---#----#--------#
-------#-#-#----###--#--#--##-----#####-------#-##-#-#---#-----#-#---#----------#-#----##---##-#-##-
------#-#-----##---#-#-#------###-----#----#---#---#-#---###--#--#-#--#-#-#-#-#-----#---##-#-#-##---
#----#---##--#-#-#-##----------#-#-#---#-----#-------##--####------------#-##------#--#--#-----#-###
--#---##--------#--#-##-#-----##-#---#--#---#-###-#-##-#--#---#--##-----#-#---#--#--#-----#-#---#-#-
---------#-----#------#--#----#---------##-----#-#-----##----#---##--#-----#-#-#-###-#-#-------#--##
##----#-----------####--##---#--------#--###-#----------#-#-----#-------##-###----#--#----------##-#
---#------#----#-#-----#---###------##-------##--#--#-#---#-------##--####----#-#-##---------##-##-#
------------#-------#---#------#--#-###-#---#-#--##---#--#---#---#####--##-----#-#----#-#--#-#------
##-####---#---------#---#-#-#-#--##-#-----#-#-#-------------#-#---#-###--##------#-#----#-----##----
#--##---#--#--#-#-#-##---#-------##----#------#-#--#-#-#--####--##--#--#--#---#-#-#---##---#---#-#--
---#--#--#-###---####--------#-----###-----------##--------#-#-##----#-------#-###-----##---####-#--
#--------#----#---#---####---#-#-----#--#----#-#---#-#---#-##---#--#------#-#---##-#-----##---#-#-##