?diagonal=IfAtMostOneObstacle;
#-#-#----#--------#-#----#--#----#------#-#---####--#----#--------##-#--#-#------#--#-----#--#------
-##--#----####-#-#--------#---#-#------#---#--#-----#-#------##---------#-##---#----#---#-#-####---#
###--------#-----#----#---#-##-###-##---#-#----#-----#--------#-------------##-#-#---#--------#----#
##--##--#----#-------##---#---#------#--#------#------#--#--------##--###-#-----#----#--#---#-#-#-#-
##-----#---#-###----##-#-#-#----#----#-#----------#--#----#-#--#---#------#-------#-#--###-#-#------
-###---#--##--#-#---#-##--#----#--#------#--#-#-#----------------#------#--#----##-##-#-#----#--##--
----#-#--------###--##------#---#------##-##-------##------#----#--#----#-#--#-#--#---#--#--#--#-##-
--#-#----#------#------#----###--#-------#-#--------#----#----#---#-----#-----#--#-##--#-#-#-##---#-
-#-#-------#---#-#---#-#--##---#-##--#----##---###-##--#-------#-#-#--##--#-------------#--#----#---
##----#-----------#-#--#----##--##--------##----#--#-###----#---#---------#-##--#----#-##-#---#--#-#
-----#--#---#--#----##----##------#----#-##-----#-------#----------#--------#-#---###-----##---###-#
--##-#--#-----#---##---##---#-#--#--------------#-#---##---------#--#-##-#-------#-----#------#-##-#
###----#--#-----###------#-#-----#-#--#----##---#------##-##-#--#------#---##--#-##--#-##-##-#-#--#-
---#-#--###--##-----#---------##---#----#---------#---#----#--#----#-##--#--#-#-#---##-#-#---#--#---
--#---##--##---#------##---#------#-####--#-----#--#-##-#--#-#-----#--#--------------------##---####
--##---#--#----------##-##--#---##---#---#-#---#----##----------#--#-##-###-----#------#--------#-#-
###----#-##----##------#-##-#-#-#-##-##-#--#-#----#---#--##-#-#--##----##-#------#----#--------#---#
---###----#--#--#-###-#--##-#------#-#-#--#--#-#---###-#--#-------#----------#--#-##-####-#---##-#--
----#-----------#--#-#-#-----##---#-#------#-###----##---#-#---##-##--##---#-#-----#-------#--#-#---
------#--#----------###-##---#-###---#-####---#--#------#-#----#-#--#--##-#------##---###-#----##--#
##------##----#-##-------#--#-###-#-##-#-####--##-##-----#--#-----#-#--#--#-----#-----#--#--#-#-###-
---------#----#-#-#---###----#-----#-#---##--#----#-----#-##-#-#---#-----#------#-------#--#-#-#--#-
--#---#-----##---------#-#-----#---#-#-#-----#-#--##----##-#-----------#-----#---##------#-----#----
---#-#-#-######----##-##------#--##-#------##---##--#---##-#---#---------#--#----#-#------#----#--##
-#-#----------#--##-#---#-##-#-##----####---##-----##-#-----#----#--##-#-#----##-#---#----#-##-#--#-
#--##-------#--#--#-#---------##----------#-#-#-------#--#----#-##-------#-----#-#-#--###----#-####-
#---#--#--------#---------###--#-##-##-#---#-#-#---#------#--##---##--#-----#-#---#---#---#-##----#-
-###--#-#--#----##--#------###--##--#----#---#-#-#---###--#----------#----#--#---------------#---###
--#--#-#--##-----#----#-##-#--#-#----#----------###--------------#---#####--#-----#----#--##-----#--
-#--#----------###----##-#---#-#------##-#------#---#--#-#-#-#-###--#--##---#--##--#--#-##-------#--
--#----#---#--#--#----------------#-#------#--#--#-#------#------#----###---#-##-#--###---#-----#-#-
--#----##-#----##-##-----#---#--#--#-----#--#---#--#---#-#--#--------#--#----#-#---#-#-##----------#
#-----#--##-#-#--#---#-###---#-----##---#--####-----#-----#-------#---#--#----#-##-------#-###-#---#
-##----##----#------#-#------#-----##------------##---#-#--#-#-----#---##-#-----------####-#--------
###---###----#-------##---#--#-----#-#---#-#--#--#-##-#----#--#---#-#----#--#-#-#--##--#---------#--
##--##---#---#-------#--#--#----#-------#-#----#-#----------#--##--#--#-#--##-#---#---#------#------
-#-#-----#-##----#-#---#--#---######---#--#-#-####---#-#-##-#---#-#----#--#--#---#--#-##-#-#----#---
--------#-#--##-#----------------#--#--#--------#--#-----#-##--#---#-#--##--#---#-----#----#----##-#
##-#--#---#---#-#---#---#--#----#----##-#-###-##-#-----#--#####-#---#--#----#-#-----#----#---#---#--
--##---#-#####---#-------#----##----###--#--#--#--##-#---#---------#-###---###-##---#----##----#----
-------#---##-------#-#---#--#-#--#------#---#----##-##---##-----#-###--------#------##-------#-----
--##----#-#---#-#-------------#-######---------##-##--#----------#------#--#--------##-#------------
-#---#---##--#--#---#--#-------#####-#---##-#--#----------------#--#------------##-#-##----#---#---#
#------##-#----#---#-##-##-##------#----------#---------------#--------#---#------##---##----##--#--
#-#---###---#-#-------#--##----##-#-#---#-#####--#-#--##-#-#---------#---#-###-----#-#---#-#--#-----
#----##--#-###---#--#-----#-----#-#--#-##---------------#------#--##-----#-#-##----#--#----###-##---
-#-##--##-#--##---#----#----#---#-#----#---###--#-#------#---###-#--#--##--#-#---#--#-#-----##-----#
--#-####-#--##---#--##--##-##------###--#--##-------#--#--#----#----#-----###----------------##-----
-----##-#-E----###--#--#---------------#-#----###---###-##-#-#-###----#-#------------#--#---#--#--#-
#--###---##-#-###-#-------#-#------##--#--##-#-------##---####---##--###---------#------#-####----#-
#------#--###--#----###------#---------#----###-#--#--##------#--##------##-#--##-------#----##----#
-#--##----------#-#--#-#--#-#-####--#-------#----------#--#-##-###-###--------#---##-----#-##--##-#-
---------#--#----#---#----------#-#-----##--#-#-#-##-##-#--#----#-------###-###--#---#-#-#-##------#
--------#--#--------#--------------#--#--#--#--##--#-----##-------##---#-#-##-#-----#----####---#---
-----------------#-----##-##-###--#--#-##--#--###-----##--#-----#-#----#----##------##-#------#-----
--#-#--#--###--###--------#--###-#---##-----#----#----#----###-##-------#----#-#-#-#-------------#--
-#------##--------#-#---##--#--#-##----##--#-#---------##--##----------#--#-##-#-###--------#-------
---##--#--#--###---------#-------#---#-#------#----#-------#----#-#---##--##--####-#------##-###----
---##-#-#####--#--#--------------#--#-##-#-----#---#--#-#---#-#--#--#-#---##--#-----#-#-##--##-##---
#---------------#--------###-#-------#-#---#-----#------##-#---#-##---#----#--##-#-------######---##
-----#-#---------#--#-#---#----#----------#-----#-####-#---#-#-##-----#-#-#-----#--#----##--#-##--##
------#-#-##--#---#-##---#----#-#--##--#--##-##-#--#--##--#-##--#-#-##--##-#--#####--#-#-#-------#-#
###--###---##-##------####---#---#------#--###--------------#-#------#--##----#-----#-#---#-#---#---
#--#-#---#------#--#--------##--###-#--------#--#---#---#--##-------#---#S#-#-#---##-###-#--#-#-#--#
-##-#-#--#--#-----#--##--###-#-----#---------#----#-----#-##-#-#----##--------#-----#----#---##----#
--###-----#-----#------##---#-##---#--#-#---####----------##---##---##-#--#-#------####--#---#--#---
----##---#------##--##--##---###----#---##---##-##--#--#-#--#-#-##-#-##--#-----##--#--#---#-----#-#-
-------#-#-------##---##-#---#-##---------------#---#---------------------------#--#-#--------#-##--
----------#-#--#-#-#-##--#-#------#--##-------#-------#-#-#--##---------#-----#--------#--##-##---#-
----------#----###--#---#----###--#------###--##--#-###----#-#-#-#--#-----#-##-------#-##-#-#-#-----
--------#---#--###-#--#-#---#------------#-##-#------#-------#-#---#------#####---#---##-#--##-#--##
-##---##----#--##--------#---------#----#-------#-#--#-#-#-#-##-----#---##-#-#-----##-##--##----###-
#-#-##------#------#-#--#--#--##-#-#-#-----#--#-----##---#--#-#----##----#--##----#-----#-#-#---#--#
----###----#----#-----#-##------#---#-------##--##---------#----#--#----#-#-----##--##--#-###-#--#--
-#-#-##-#-----#--#----#---#-#--#----#-----#-#----#-##--####---#-#-#----###-#-#-#----#---###-------#-
---------#--------#--###--#-----##-#-###-#-#--#-#-###-###--#-----##------#-###---##---#----##----##-
--###-------------------#-#-----##--#--#-#--#------##--##---------#---###------------#-#---------##-
---#---#-#-#-##--###---########-#-#-#-#----#--#---#-##-----------#-----------#---###--#-##-#----#---
--#--#------#-------#-#--###-#---##-#-###--#------#--#-#-----#-#---------##-##--------#------##----#
---##-#-----#-#---###---#----------###------------##-------##----#----#--------###--##-##-#--#-#-#--
-#-#--#-#--#------#---##----##------#---#--#--###----##--###---#-####-#----##----##-----#-#--#---#--
---####------#------#-----#-##-#----#--#---#-----###-#--#--##--###-------#-#-#-#--##-#------#-#-----
--###---#--#-#-#----#-##--#--#------------#--#--###----#--#--#-#------#-##-#-#--#-----------##-#--##
#-----------#---##--#---##--#-----##--------#-#---#---#---#-----#--#---#--##----#--#----#-----------
----#--##-##--##---#-#--####-#--#--###-#-#---#---#------#-#---##-#-#--------#-#-#-#----###---#------
--#-#------#--#------------#-----#-#---#--##-##----##--------#------##----#--#####-----#-#-----##--#
---##----#------#--#-##-----#------#------#####-#---------------#---#--#-----#-#---##---##-------#-#
##---#-#-----#--#-#----#----#-------#---#---#-###---#-#---#--#---#-##--#--#-#--#-#---#---------#-##-
---##---------#-#-----#-----#-##---##--#--------#--#-##-------------------#-#--------#---#----------
#----#------#--#-##--#---#---####---------##---#-----------------#-##-#---#-#------#--#-#--------#--
------#-#--------##---#---#--#---##--#------##-----###--###----##-#--#------#---#-#-#--#-------##---
#------------##-#----##-#-#--#-#-#-#---#-#-----#------------#--------#---#-----#------#----##-#----#
-----##------#-#---#---------##--###-#-##--------###-#-##--#--#----#----##-#---#--##----##-#-#----##
#-#--#--------#---####----#----#--#--------#----#------------#-#---#------#------#--#-##-##-#-#---#-
---#--#---#-----#--#-#--#-##---#-#--#-#----#--#-----#--#--------------#-##--#----###-----#--##------
-----#--------#-##---##-#-------#-#----------#----#----#-##--#-#---##-----#-----#--#--#-----#-----#-
-#-------#--##---#-----#-----#--#-###-#---------#--------------###--#--#--#-#--#-##-#---###-#----#--
-----###-#-----#-#---#----####-#---##---#---#--------#-#--#------#-#-#-#---#----#-##--#--#----------
#-##-#--#----#--#--#--#-#----#-#-#-#---#--#--#--#-----#------#--##----##---------#-----#------##---#
---------#--#--##--------#---#--#---#--##--##-#-#----#-#-#---#---#----------#---#-##-#-#-#----#-----