?diagonal=IfAtMostOneObstacle;
#-----####-#-###----##---###---#--#-#--#-----#--##----#---#---#----##--#--#-#-------#----#---------#
-####-------#-#-#-#----##-#-##-#----##--##-----###---#---#--#---------#-#---#---#-------#-#-##------
-----#----#-----#-#---#-------#-------#--#-#-#-----#-#------#-##-#----#---#--##-#----#------#-----#-
-#--#--#--###-----#-----##-#-------####--##-----#-#-#---#-----##-###----#----------#----#--##--#-#--
--------#-----#--#--#------#--#-------###------##-#---##--#-#---##---##---#-#---------#---#---------
-----#-#-----##-##-#-#--#-#--#-#-----#-###-#-------#-#---------------------------##---#--#--#---#-#-
-#----###-----#---##------#-#-------##---#---#----#--##-####--#--#--##-----#--#--#--------##-#------
#--------#-----##---###---##-----------###-#-##---------#--###------####--##--#----#--#-##----#-#-#-
-----#-##----##-#--#----#-----#-#-------#--##----##--------#------###-#-#---##---#--#---#------#---#
##-###--#-###-#-##-#-#-#######--------#----#--#-------#---#---#-----###--------------#----#--#-#----
--###---------##------#-#------#----#-#------#-#---#----#-#-#--#--#-#--#-------#--####-#-#-###--#-##
------##--#-#--##-#-----#--#-----##--#-#---###----#-##-----#--##-----##---#--#--#--#-------#--------
--#####-#-#-#---#--#---------#-#-----##-----#--###-----#-----###-#--#---##--#-#-#---##-#-----##--#--
#-##------###-#---#-#---------------#--#---------#--#-#-#----##-##-#----#-----#------#-#---#--######
-------##-----------#--#------#-----#-#---------##-#-###-----#-----#-#--#---------#---####----------
##--#--------#--##-##-#----#-----#-##---#-#--#----#-----##-#-----#------------#-#--#--#-##-#----#-#-
---##------##----#----##-#--#--#---#--###------##--#---#--##--##-##---#-----------##---#--###----#--
----#--#--#---#---#-----##-##-#---------#--------------####-#-----------#---#-#-------#-----#-#-#-##
--#-##--##---#-#------##-#-----##------######---#-----------###-#-#----#-#--#--#-####-----#----#----
---------#-#---#--###--##----#--#---#-#----#-#-#---#-#----------#-------#---#-----###-#---#---#-#---
--#---#-----###-#----##--#----####----#----#-#--##------##--#----------#---###-#------#-#-#-----#---
-----#-#-###-----------###-#---###------------------#---##-##----------#-#--#-#-----#--#-----##-###-
#-------##-##----##-##------#-###-----#----#---#--##------#--#----------#-#-#-#-----####-#----#-#-#-
-----#-----#---##----#--#-###--#---##---#------#--#-#--#-##-#-#####-#--###----#---------#-#-----##--
---##--#------###---#-##--------#--#---#-#-----#--#--#---###----#-#--###--#---##-##--#--------#-##--
#-#--#--#----#-----#----------#---#--#-###-#--#----##---#--##----#-##-##--#-###-#---##-#--#----#----
#####---##-#---##----#-##-##-#-#-----#--##-------#----#---------------------##--#---####-#----#-#---
-E#---##-##-----#--#---#----##--#---------####---#-####-#-#-#-#--#---#----#--------#----#--#--##--##
-#######--#-#--#-----#-##-#-------#------#--#---##----#--#-#---#-#----------#---##------#-####-----#
----##-###--#---#--##-#---##-####----#----#--##-#----#------#-#----------#------##-#-#-#----#-#-#-#-
--#--#-#-#-#--#---------##---##-#-#---#---------#-#----##-#-#--#--##---------#--#--#-#--#---------#-
--#-----#----#-#--------#--------###------#--#---#-#------------##--##-#-------##--#-##-#-#----#----
----#-#---------#-----#---#-----#--##-##-#-#------##----------------#------------##---#-###---##--##
###--#-#-#-#-#--##-###----#------#-#--#-####--#-##--#--#----#------#-###---#-----#--#---------------
-#----#---##-##----#----#--#--#-#--------###-#--#-----##----#-----#-#--#---####-#--#-#--#--#----###-
--##-#----##------#------##-##---#-#----###-------##-#----#-#---##-----#---#--#-##-#------##-#--#-#-
------------#--##-------#-#-#-------#-#--------#------------#-#---##--#--##-----#-----#---#-#-------
---#-------##-#--##-##-##-###-------##--#-----##------#-##--#---#---#-#---##-----------#-------##---
----##--####--#-#--#--#--####--#-#---#----#---#-------------#---####---##--#-----#--#--#--#------###
#---##--#-#####----#---#--##-#---------##--#------#-----#--###--#---#-------##-#-##-----##-#----#--#
-----##--#--#---#--#----------###-------##----#-#----#----#----###-----#---------------------------#
----#-----#----#--#--#--------#--#-#-###----#-#----##--##----#-#----#--#-##-###--#-----------#-----#
-#-----#--#--#--------##--------#---#-----#-#--#--##----###-----#-#-#-#------###--#---##-#-----#-###
------#--####-#----#--------#-#-##---######-----#-------#-----#-#-#--##--#--###--#-#--#---#--##-----
------##----#----#--###--#-##----#-#--#--#-------##------------#---###------#-----#--#-#-##-#-------
----##-#---#-#-#---------#--#---#####--#-#------#----##---#----------#---------#--#--#---#--##-#-##-
##-##--#--#--------#-----#--#-#----#----------#-##--#--#-#----#--#---#--##----###-----------##---#--
----#----#--##----##--#-----###----#-#-#--#-#---##---#----#---###---####-#--#--##--####-#---#--#-##-
--##--#---##-------#---#-##-----------#-##----#-#-----##----#----#---#-###-#-----#-#--###----#-#---#
-##---#--#---#-#-#--#--##----#-###--#---#--#-#------#---#-#---##---##---##--#########---##----#----#
###------#----#----#-----##---#---#----#-----#-#--#------#-------------###-----##----#--#--#------#-
#-##------##--#---------#-#-#----S#--#-#--#--#-----#---#---#-#---#-##-#--------------#-#-##-##----##
#--#------------##-#-#-#--#--#-#---------#-#-#----------###--#-------####----#-#------###----#-#-#--
#----------##--#---##------###-###-----#-#----#-#--#--#---##-#-----##--#---#---#------#---#-#---##--
##-##---------------#--#--##----#-#---##-#-##--#-###---##-------###-##----#-----#---#---#-##--#-##--
---------------#-#--#------------#-#------#-----------#----###-#---#--#----------#-##--##---#-##----
-----#--###------##-##---#--#--#-----#----###---#------------#-#----#-##---##------#----#-------#--#
-------###------#--#----#-----#---#---#-------#####---#-#--##-----#--##--------###-#--###----##--#--
##----#-----#-#--##--##-----####--#----#-----##--##---------#---------#---##------#-#-------###-#--#
---#--------------#--##---#-########--#----#--##--#-#-------##-#--#-#-####---#------#--##---#--#-#-#
-#-##-------#-----##---##------##-------##-------##----#-----#-#---#-##---#--#-#-##------------##-#-
-#-#--------#----#-#--#------#---#-#------#-##----#--#--#----#--------#--#---#---##-#----#--------##
##--##-#-#-#------#----#--#--------###--#---#-----##-#----------#---#----#-----#----#-##----#-##---#
---####-##--#-------##-#-#----#--##---------##-#-----#-#------------#-###---#-#-#---#----#------#---
#-----#-------###-----##----##-#-#-###---#-#------#----#-#-##--#-#-#----------#--##-#--###----------
--#---#----#-#-------#-#-----#---#-#---###-----#---#---#--##-##--###---##-----###-#--#---#---##--#--
#-------------##---#---#------#----##--#--#-#----#--##-#--##----##---#---##-###----#--###-----####-#
-----------#--####----###-#-###----#-#--#-#----##---##-----#--#--#---##--#--------#--#----##-#---#--
###----------#---#--###---------#-----------#----#-----##----###--#--#-#--#-#-#-----#-----##-######-
---#-###--##---#---------#--#-----------##----#--##----##--#-#----#---#--#-----#---#-#-#-#--------##
-#--#--#-----####-#-#---#-###--------#---##---##-#-##-----------#----##-##--##--#--#--#--#-#---#--#-
###-#-----##---##-##---#---#-#----##---#-#-#---#-#-----#-####-#--#-#----##--#####----#-#----#-----##
-#-#-#-------#--#--#--#--------#-----#####---#---------#---##-----#---------#----#----#--##---#--#-#
#---------##-#-#--#-#------#-------######-----#---#--#-#-#-------#-#--##----###----#---#--#-----#---
-#-##-##-#--#----------#-#-----#-#--#----------#-------###-###-##---##-##------#--##---#-#--------#-
----#------#-#-##------##-#-#-----#--#---#--#-#----#--###-#-#-----#---#----#-##---###---###------###
-----#-----#-##----#---#---#---##---#----#----##-##-#--#-#-#--------##-#------#-#------#-#----####--
-#-----------###---##-#-##---------#--#-------------#-#-#-#-###-###--#----#-#-----#----#----#-----#-
-##-##-----#-----####-#-#--#----#-#---#---#--------#--#---#--##--##-------------#---#--#---##--#----
####-#------------###--###---#--------##----#-----###-#----##-#---#------------#--#-----#--###------
--####--------#--#-##-##-------#--#--#-##-#---#-#--#------#---#-###----#--#--#-------#--##-###-#----
-#-#-#-----------##---##-------#-##-##-----#--------#-------##-#---###-##----#----#--#-----------#-#
#-#-#-#--#--##-##---##------##-#-#---##-#--#---#----------#-----#----##---##----##--#--#-##-#---#---
------#----#--#-#----##-#----##---##---#-------###-#---------#--#--#-###-#---#-#----##----#--#-#----
-#-------------#---#-#---##----------##-----#-#-#-----#--#---#--###----#-#----#-#-#-----#---------#-
------###-#------#-#-----#--#####------------#-----#-----#------#####----#-#-#---###---#-##--#----#-
#-#--#-#----------#-#--#---#--#------#-##-##----##----#----#--##--#--#------------#-#-#-----###-#-#-
-----#-----#-#-#----------------##-------##---#------------#--##-----###----#-#--------#------#----#
----#---#--------#---#------##-#-#------#--#---##-#-----#--#--#----#---#----##-#-#---#-#--------#---
-------#---#---##-----------#-##--------#----#-#---#-#--#-----###--#---#------#--#-#-#--#---------#-
---#---#------###--------#--##--##-##---#--#--##--#--#-##---#----###------------##-##---#-##-----#--
--#--#----#------##----##--#----#-#---#---#------------------##-----#----#---##--#-#---#---#----#-#-
----#----#-#---#-#----#-#---#--#----##---#--#--#-#--#-#---#-#---##-##-------#-------##---###--#-#--#
#-#--#-##--#-#---#-#--#-------#-#-#-#-##-------#--##-###-----#-###--#-###---#-----#-##--------#--#--
-#--###-----#-#-##-#--#------#------#-----#------#--###----#---#----------#-#---##--#--#--#-#----##-
-----#-#----##-------#-#---##-----#-------###-----#---##--##----#-----#---#---##------#-#--#-##-----
#-#--------#---#--#----#--###-------#--#----#------#----##----#----##-##-----##----#-##-##----------
-#---##-----##----#---------##-#---#---#----#-#---#-#-##-##-#--#--------#----#--#-#--------#---##-#-
---#---#-#------#--#--###-##---#-#--#---------#-##--------------------#-------##---##-##---##--#----
-#-##-----#--#----#-###---#--#-##-----#--#--#--##-#--####----##-#---#--##-------#---#---------------