?diagonal=IfAtMostOneObstacle;
------#--##--##---#--#-#------#----#---##--#--#--#--#---#-------##-#---------##-#----#---#-----#-#--
--#------##-#-----#-#-#-##-#-###-----#--#------#---#----#---#-#------#------##--#---------#-#-##--#-
-#----##---------------#-#---##-#-#---#---#---##-#----#------##-#--#---#--#-###-##-#-##-----#-#--##-
-##-----#----------###-#-------#------#---###--##-#-#----#-##--#--#-#-----#-------#--#-----#-----#--
#---##-#---##--#-##-----####------##-#---##----#---#--#---#---#-#---------##-#####--#--#-----###----
----#-----#----##---#------#-#---###---###-###-#-#----######---#----####---#-----#-##--#-#-#-#---#--
-#-----#-#--#--#-##---#-#--##--------#----#-------##--#-#--#--------------------#-#---#---------#---
-#-------#---#-#--##---#--#---#-##--------##-#-#--#---#---#---#---#----#----#---##-----------#--#--#
#--#----###--#-##--#-##--##-----#-#--#---------#####-----#----#-#---------#-###---##-----#-#--##--#-
#---###--#-----#--#---##-#-#---#-###---#-#-#--####--#-#--#----##-----#--##-#-##-----##----##-#------
#--#-------#---#-#------#--##--#-----#------#-----#-###-#-------#---##-#-##--#---#--#-------#--#--##
--##---#--#-#-#-#--#--#-##-#--#---#-------##----##-##--#-----#-##----#-------------#-#--##------#--#
#------#--#---------#----#-----------------#---#------#-##--#-#----#---#--#------#----###-----------
----------##---#---#-#--#---###--#----#-##--#--#-#---#-----#----#---------##----#-#-#--#------------
#---##--------#-#-------#-#-#-#--##-#--##--##------#--#----#----##-------#---###----#-#-------------
------------------#-#--###------#--#--#-----###---##-####----#---###-#--##---##---#-#######--#--#---
#-#----##-##---#--##----#----#-#--#--#-##-----#-##-#-#--###--#-##----------##-------#---#-#-------#-
-----##-##----------##------------------#------------#--###-#---#---#-----#-#-##-----#--#--#---##---
-#--##-####---#--#-------#----#---#--#--#---------##-----###---##-#----#---#--------#--##----#-#-##-
-#--#---#-----#----##-#----#-------##----##-#--##-#-#-#--##-##-----###-----------#----#-##-##--#--#-
##--#--#----##--#-#-##----#-#------#-------#-#-##----#--------#--#---#--#-#-#---#-----##---##-------
#-##-##-#---##---#----##--##---#----#-------#--#-#--------##---#------#---#--#-#--#-#-------##----#-
#-#---#-##-#-#-###----#-#---------#----#---#-#-#-########----#-###------#------#---#-#--------#-----
#---------------#---#----#---------#-#---#---#---#-----#--#--##-##--#--#-###----#----#----#--#--##-#
##------##-----#------#------#####--##-#-####-------#---#-----##---#-----#---####---------##--#-#---
-#-#----##--##----##--------#######-#--###-----##-----#------#----#---------##---#--------#----#-#-#
---#----#-----##-###----#-##-#--#---##---####--#---#-##--#--#--#----#----#-###-#---#-#-#------------
#--#--###-#--------------#----#----#-##------#-------#-#-#----##-#--##-#---#-#-###---##--#----##-#--
##------##------#------#--#-##-###----#---#-##----##---#----##-#----##-#-#--#--#--#-#-#---##------#-
-#----#---#-#----#-------#-#-----###-#--#---#-###-----#--####-##--------#-------###-#--#--###------#
##------#-----#----#-##----##--#-#----##--####--#---#-#----#--------##--#-------#---#------####-##--
-#----#-##-#--#----#----##--#----#-#-###-#--##--#--------------##-#---------##-----#---#------##-#--
---#---#-#----------##-##---#---#------#------##-----------###--#---##-#--#-#------#-#----#----##---
####---###---#---#-----#-##-----#-----##--##---#----#--#-#------#--#---#---#---##-#----#----------##
-#####----##--##---#--#-#--#--#----#-#---#---#---##-#--#-#--#--------###-----#--####-##-----#-##----
##---#--------##------#------#--#----#--#-----#-###-###-#--#-####-#--#-#----#------#---------------#
-#-#---------#-#--####---##-##-##--#-##-#-----#--#--#---------------##-##-#--------#-#-#--#--#------
#----#-#-#-##-----#--#-------#-##--##-#--#--#-----------#--##--#-#--------##----#-#--#--------#--#--
-----##-#----#--#-##-##----#--##-##-#####-#---#-#---#------#----##----#-#--#---###-------##---#-----
#-#--#--#-#----##---#-###--#----#-----#-#-----#------##-#---------##--##--#--##--##-#----#---#---#--
---------#-##------#--##-####-#-##--##-###-------#---#-####-----#---------###-###-----------#------#
----##---#---###-#---#-##-##---#-#-----###------#----------###---#---#--#-##-#--#-#--------------#--
-###---#---##-----#-##---#-----#--#---#------#---#--#----#-----------##------##----#-----#--#--##-#-
----#-----#------##--#--#--#----#--#--#--#----##-------#----#-#--##---#----#--##--------------###-##
##--#---------##----#--#--#-##-----#-#-##---####-#---#-#---#---#---#-----#-#-#-###-#---#--#----#-#--
----------#---#---------#-----#---#-##--#--##-##------------#-#----###--#---------------#---------#-
#-#-#---#-----##------------##-----##--#-----#--#-----#-#---#------#-#-----#----#--#---##------##--#
--#---#---#--#----#----#----#------#-##---------#----##-#----#--------#--####----#--##---#----#--#--
#---#-#----###-#-#-#-#--#-----#------------#--#----#-#-##--#---------#--#-##----###--#--#-#---------
#----###---#-#--------#------###-#-----------#-----##--------#---------#---#--#---#-#-----#--#------
---#-#------#-#--------#--#------##--#------##-###---#-#--###------#----#--#-#--##----##--#--##-#---
-##---------#--###------#--##----#-#-#---#--#--#-##-#-#--###-##-------##------------###---------#--#
-#----##--#--#----#--#-#---#-----##----#-#-###---#--#--#----#----#-##---#------###--#----#-###--#-#-
#--#--#--#--------------##--###-----#-#----###-#-#####-#---#----#--#-#-#---##-#--#-#------#--#----#-
-#---#--------#--#---#----##---#--#---#---#-#------##----------#-##-##--#----------#--------##------
#----#-#----#--##--#-----##------##--#------------##--------##------#-#-----#-#----#----##-----#-#--
#--###----##---#---#-----#-##------#---#-------###------------##--#------####----###----#-#####----#
#-S-#---------#---#---###---#---#-----#---#--##----#-----#--#-##-------#-----#-#-------#----##-----#
-#-#-----##-##-##-----#-#--#----#--###------#-#---#-#--###--#-----#----##--#-#--###--#-#----##-#-###
--#----------------#-#-----------#-#####----------#-#-------##-#---#-#--------#---##---#----#----##-
---###--#-#---###---#----##-#--#---#--#---#-----##------##---#---###---#-#--#-----##-#------#-------
-#-###-#-#---#----#-#-#--##-----#------##---#---###-----#-##----#-#-#--#-#---#----##--#-----#-#---##
##--##-------###-------####------------------------#---#-#-#---#-###---##--#-------#---###-#---#---#
--#----#---##-------##------#--###---#-#------#-----#-#--#----#--------#-----##-#----##-#--#------#-
#-##-----#--------#--#-#-----#--#--#---#---#-#---#----####-#--------##-------#-#--#----#----###----#
--#--------#-#-#----####-----#-----#-#----------##-#-----###--##-----#------###-#----#---#-------#--
--#-------#---#--#-----#--#------#-##----###----##------#-----------#----#--###-----#------#--#-#---
--###----#-------#-##-#-------#-----#---###-##-##------###---#------#-------####-#-#---#--#-------#-
--###----#----##-##-------##--------#---#-----#-----#----#----#-----#----#--##--#-#-#-###--######-#-
###----#---###--#-------##------#####-#-#-#-----##--##------#-------#---#----#-------------#----###-
#--#-#--#------##---##----#------#----###--#-----------##--#------------#--#---#-##---#--E---#-#--##
----#-----------#-#----#----#-#---#-----#-#-#-------#-----#--#--#-#--#--------##-#-#---#----###-#---
---#------#-##--#-####--#---#---------##-#--#------------#----#---#-------#-#------##--#---#-#------
#--#--#--##--##--#---#--#------##--#-#---#--#---##-###-#--#--#----#---------####-----#-#-####-###--#
------#--##----#-------#------#-##-##--#------##-#-------#-----#--#---#--#-#---#-#---------#--#-##-#
--####-##---------------###----#--##---###--#----#-#-------#---###-----#--#-#-#--##--------#-----#-#
##--#----#-##-----##--------#-#-----#--------##--#-#--##---##----#---------#----#----#-#--##-----#-#
------#-#---##-##------#----#---###----------#--#-------#----------#---#-------#-###----#--###-----#
#-#---------#-#-#---#-#-----#--#-#--#---#---#---#-----------#-----#-#---------#------#------#-#-----
-#--#--#-----#-#-#--------#----#---##-#---#-----#-----#-#-#--#---#-#-------##--###-#---#-#--#--#--#-
--#----#-#-##-#-----##-#--#--##-----#---##-###-#---###----#-#-#--#----##--#---#-#---###---#-----#---
---##-#----##-##-#----#-##---#-----#-----##--#--##-#--------#--------#----###---###-#-----#-#--#-##-
----#--#------##---##---#--##----#----##-#------###--#------#------#-#--#--#--#--#-##--#-###-#-#--#-
###--------#-#--------#---#--###-----------#--#----##--#--#----##--#----##-#----##----##-----#-----#
-#----##---#-#------#--#--#--#--#----#---#--###--##-##--#-#-#-#----#---##--#---#--#----#--#--------#
--##--#-#-#-------##--#-----###-###-##--#--#---#---#-###--#--##---##-------##-#--#--#--#-#-------#-#
-#-#------####--#-#---###-#----#--#####---#-##---#------#---##-##--####----#-----#--#---#----##-----
-------#-##-##----#--#--------###-#-#-----###-##---------#--#-------------####-##----##---#-#---#---
#-#----#-##--#----#--##---#-#-##-----#---#--#----#---#---#-#---#-#---#-----#--#-------#-#--##----#-#
----#----#--##---------#-#-##-#-###--#--#--#--##---#----#----##-#------#----##----#----##-##-#-#-#--
-#-#----#----#-#-------#------#-#--#------#------#----#-##-#-----####----#--#-#-----#-##-----#-#----
------#-#-----#--####---#----#---------#--#----#---#-#----#--#----###-#--#------#-#-----##-##-#-#---
#-#-----##--#-###-#-----##-#---##-------##-----#----#--#--##--#-#----##-#-#-##-#--##-#----#-#--#-#--
#-#------##-----#-#-##-#--#####------#--------#-#-#-#-##--------#----#-------#---#-#-#-#----------#-
-#----------#----#---#-#-#--##--#-#---####-#--#-##-#-##--#--#-#----###----#--#---#-#-##--#----------
#--#--#--#--#---------##-##-##---------#--#-----------#-##-#--##------------------#------#--------##
---#---###--###-#--#-------#--------##-#---#-#-#--#--###--##--------------------##---##------##-#---
-------#---###-#------------###---###----##--------#--##-------###------##--#-#----##-#-#----#---#-#
##--##------##--#-#----------#-#---#-----#-##--------#--###-----#------#-#---##------#---##--------#
-#-#---#---#-#--####-------#####---#-------#--#-#-----##-#-----------##-##----#----#-#-#---#-#-##-#-