?diagonal=IfAtMostOneObstacle;
###--##-#--#-##--#-#----#----##-##-#----#----#----#---##----######---#----#--##---##-#------#---#---
---##-##---##--#-#-#-#---#--#-----#--#-#-#--------##-#------##----#-----#---##--#-----#----#---#----
-#-#-#--#---------#----##--#--#----#--##-----#--#---#-----#---##-#-------#-##------------###-----#--
---#####---#-----------#----##-----------#-#---##-###--#---#--------#------#-----#--------#---------
---#-##-----#-----#-##-----#--#----#-##-------#-#------######--------###--------#-----##-#------#---
-------#--#-----------#---#--#-----#--#-------##--#-#-----#-----#----##-###--##-#-#----##----#-###-#
-#--#------#--#----#-#-#-#----##--#-#-##-#--#--------#----------#-##-#--##--#-#--#--##---------##---
#----#--#----###--#----#-##---#--#---#-#--#---#-###--##-#---------##-#-----#-#-----##-#----#--##--##
---##---##--#-#--##-#-##-#--#---#--##---###-----#-------#-###---##--#--#---#------#-#-#---##-----#--
-#---#----##-----#--------------##---#--------------------#-##----#---##---#--##-##---##-#-------#-#
-##-----#--#-#--#-#-##---###--#-------------#--#--#-#----#-#--#-----###----#-#--##-#--##----###-##-#
#--##-##----#-##-----#-#-#---#-------##--#--#-#-----#-----#-#--#----#-----#--##-#----##--####---#---
#-##---##-#-------#-#-----##---#------#-------#---##---#--#-##-#--#-#-------#-#-##----##-----##-##-#
#-#-------#--#--###-##----------####-----##--####----#-#-#----#-#-#----#-#-#------#-----#---#-#-----
-###---#---##---#------#------#-#-#-###--#---##-----#-#---#-------##-#-###-#---###-----------#---#--
#-------#-#----#---#----#-####---#-#--#--#---#---#--#-##-#-##--#####---##---#-##-##--------#-##-----
#------#------------------#-#-###---##----####-#---#--#-#--#--#---##------#---#-----#----#---#--###-
#------#-#---------##--##-#-#----#------#-#----##-#---------###--#-#-#----##----##------#--#---#---#
-##-----------------#----#----#-#--#---#--#---------#--#-------#----##--#----####-##----##--##-##---
------##-#---#-###----#--#-##-----##---#-#---#-###--------####--#-##--#-----#-##------##---#---#----
---#-----------###----###--#-----#-----##-#-------##-#------#-------------------#--#-##--#--##---#--
#---#-#-#-#-----####-----###--##---##--------#----#--#---####----###-#--##---##----#----#--#--#---#-
----#--#-#----#-##-----#--------##------------##------##-#--#---#--#----#-##--#-#-##------#---------
-#-##----#---#-#---##-#-#--#-##--##---##--#--####-----###--------#-----#-##-##----#--#----##--#--##-
-###--#-----###------#--##---#-#--#-##-#----------------#-#--###---##-------##---#--##----#-#---#---
#-#--#--#---#--#-#-#-------#-#-#--##-------#--------##-##----#-#----##------#-##-##----------#------
--#---#------#####----##-#---#--#------#-#--------###--#----###----#-##-------#----#--------#-------
-#--##-#-##-#-##----#---#---#-##-----#-##-------------#-----##-#-------#---##-------#-----#---##--#-
#-------##----#----###--#--------#-#----#----------###-#--#---#-#--#-#------#-##----#-#-#---#--##---
-####-----#-###--#---##---#-----#--------#---##--##------------#------#-#--#--##-##------#-#--#-----
---##-----------#-----#---#--------#----##-----#-------#----##---#-----#####----#-#------#---#---##-
-#---------#-----###----##-------##--##--#---#---#-----#-#####--------#------####-----------##------
--##-#--#-####---------#-#-#-#--------#--#--###--###---#----#---#--S##-##----#--------#-----#-------
----#-#---##--#-#--------------------------------#---#--#--#--##--#---#-#----------##-#---#------#--
##-#-#--##--#-----##--#-##-#-#---##-----#---#---#-----#----#--#----####---##-##-#-----###-##-------#
--##-#-##-#---------##------###--#-#---#--#-----##-#----#-##------##-####-#-#---#--#---#--------#---
#--#-#----###-#-#---#--##-----------####-------#-#-----#--#---#--#-------##---#--#----#-#------#-##-
##---#------###-----#-#---##--#---##--#-----###--#--##-#---##-------#-#--#-#----#----##----------#--
--#-----##----#---##-----##--#-#------------##------#####----####--------#--------#------#------#-#-
----#-------#--#-##--#----#-##--------------#-###--#-##---#--------#-------####-#---#-#-----#-#----#
-----#---#--#----#----#-#-#--#---#--#------##--------##-###---#---##------#---#-----####-#---#--#-#-
---#-------#--#-#------##----###--#---#-#-#-###--#-------##-#-#---#-----#--#-###-----#----#-#----##-
--------#--#-##-#--##-#--#--#-####-------#-#-#----#---------##-----#--#--#----##---##----#---##--#-#
----#---#----#----##---##-----#--#--#------#-------##---#-#-##--#-#---#--------#----#--#-----------#
-#--#------#---##-#-#-#--#------------##----------------#####----#-#----#----#--------#--#--#----###
#------##---##-#-##---#----##------#--#----#-####-##----#-##-----##------#--#--#----#----#----#-----
---#--#----###--#----#--#-------##---#-#-#-#-------##---#-#---#-#-#-----#---##-----------##-----#--#
--------#----#---###--####-#--##--#--#--#--#---#--#----#-#-----------#----###-------##--#---#-------
-#------#---###-####-----#---#------------##--#--##-------##-#------#-##-------#-##-#-#-----##------
--#----------#-#--------#-----#-##-------#-#---#--#--#----#----#-#----######--#-###------#---#--###-
---#------#-----###-#---##-##----#----#-####-----#####---#--#---#-#-#-##--#-#-------##-#---#--#-####
--#--#####-------------#--#-#------#-----#-##------------------#---##-#-------##-------###-#-#-##---
--------#------##--##----#-#--#-#-#--------------#-----#---------#-----#------------#---------------
-----###--#----#--##----##---#--#----#--------#------#----##--##-#-#------#-----#-----##---#-----#--
--#-#-#-#---#-###---####---##---#--#-#-#----#---##-##-------#---#-##---------#----###----##---###---
-##----##---####-----#-#----#------#-------#--#--#------#--#-----###---###----#--#-#--#----#-###-##-
---##----###--#-#-------##-----#-------#-#-#-#--------#--------#--#-##--#-#--###-###--#-#--#--#---#-
#--#-#--#--##----#-#--------#---#----#---#---#-#---#-#---#--#-#-----#--###-------#---#--------#----#
#------#--#--##-----#-------###---#----#-------#-----#----#-------#--#---#--#----------#----#-----##
--##-#-------#---###-#---#--####--#----#-#---#-#---#-#---###-----------#---###--#----#----#--#-#----
#--#-#-##---#-#----#-#----##-#--##----#-###------#---#------#-#---#---#-------------------------#---
--##------##-#-#--------------#-#----##----#-----#----------#-###-----#--##--------##---#--------###
-------------#-###-------------##---#-##----------------##--##---------##---#--#--#--###-----##-#---
-------##--#-------#-------#---#-##--#----##--#-##--##-#---#-##---#---#----#-#-##---#----#-#-----##-
-----#-#----##----#-#-###-#------##-----------#---#-#-#----#-----#---#-##--##-#----------##-#-##----
#-----#-----#-#----##---#-##-##-----#-#---##----#--#-#---#------##-----#--##----##---#--------#----#
-#-----#----####--#-##-------##-----#-#---#----#------#-#---#-#--##--#-----##--#--#---#-#----------#
#--###---#--#-#-#----##--##----##--##-#---#---#-----#---#--#--#-#-#--#-----#------#-#--------#-#-#--
---#-#-#--##--###-#----#----#---#-#-#-----#-###-##-----------#-###---#-#-#------#--#-#---#-#-#---#--
#-------#-#-##-#--########------#--#-#------#-#-#-----#--#-------#-#--#-#-##-#-#----#-#-#---#--#---#
--#----##-----#-#-#---#-----------------##-##---#---#-##--------#---#---#----------###--#-------#---
---#-##----#--#-------#-------#---#-#--#--#--###----##---#-#----#--#--##---#--#--#---#-----------###
---#---##--#-###-##-#--#-----#--#-#-#-###----------#-##-------##----#---#--##--#-#-#-##---#---#-----
-##----#--##---#---#-###-#####----###--#------###---#--#----------#-##-#--#--###-#---##---------#-##
#--#------#--------##-#----##-#---#-##-----#--#-##-#-------#--#--------#-##--#--##--#-##-------###--
-#--##--#-#----#---####---#--#-#--#-#----#-##--#--#----------##-----###----#----#----#------#----##-
#---------##---#----#----#------------#--#---#-----###----------##---#---------##-#--------##-#---#-
-###---##-#--#----##------##-----###-#------------###---#-##-----#-##----#----#---#####--#--#--#-#-#
--#-#----#-----#####----###-----#-#-##---#---##---#---#--#-#--#--#-###-------#-#--#--##--#-#-#-#-#--
---#---#-#---------------#-----#---###---#------#-#---##----#-----##-----------#--#-----#--#---#--#-
#-#--#--#---------#--#-#-###-#---#---------#-#--#-#-#---#--#------###---------##-#--#----#---#---#--
#-------#----##--##-##-#--##-#-#----#--------#-#--#-----##-----#--##--------#--#------#---#---------
#---####-##-#--#---#--#-#-###-#--#--#-##--------##--#--#-----#--#---#--#----------##--#-#---#-#-#---
----#------#-#----#---##-#-----##----###----#----##-#-#-#----------##----#-#-##----#-##----------#--
##-----##----#--#--##-#-##-##-#--##-----##---#---#---#-#-#-#----#-----------#-#-----##-------#-##---
#---#---###-###-##--##----#-##---------##-----##-##-------##--##--#-#--#--####----#--------#----#--#
##---#---#--#-##--#---#--##--####-#---#-#-#-#-#--####-------#--##------#-#--##--#-----------#---#-#-
-------------#---#---------#----#---##-#--#-#--#-#------##-##-#--#----#--------#---##-##---##-------
------#--#-#-------E--#---#------#--#--#-#--#--#--#--#--------###-----###------------#--##-#----##-#
--##--------#-------#-#------#----#-##-#-#--#-##-###-###-#-------#-#-#--------#-##--#-#---#---------
---#---#-#------#-#----###-##------#--#-#-######--###-----#-----##---##-###-----##---##-----------#-
-#------#-#----#--#------##-#----#-#----##-#-#-----#------#-#-#--##--###-#---#-#-#-#----#---#--#--##
----#-#----##-##-#-#---#--------#-#----###------------##--###-------####----#--#-#-#-----###--#-##--
---##--#-##-#------#-#--#-#------#-##-----#-#-----##-----#--#-#---#----#-----#---#--#--##-----------
-##------#--#---#--#-----#--#-##--##--------------##-#-##-##-#-----#-#-#-#-##-----###--#-#---#---#-#
-#--#----##--#--#----#----#-----##--#--#----#-#-----#-#--#----##--##--#--#---#------##--##-##-------
#--#--#------#----##---#-##-------#--##-------#--------#------##--#--#--#-#---#--#-#---#-#-#-----##-
---#-----#--##-----##--#--#----#---------###---###-------#-###----####------#-#-##---#--###-#-------
--#-----#------##-#######-----#----##-#-###--#--###-----------##-#--#-####--#--#----#-##-##-#---#---
#------#--#-###----##-#----#-##----#--#--###--------#----#---#---##---#---#-###--#---#------#--#---#