?diagonal=IfAtMostOneObstacle;
#--------##-###------#-#----#--#--#-------------#------------#------#--#--#---#-#---#--#-#-##-#-#--#
---#--#-#--#-----##--#--#---#-----------##---##-#-----#-#----------------#-#--------#-----#-##------
---#---#--#---##------#-##--#-------#----#--------#----#-----#--#-#---#-------#--#--#-#--#-#-----#--
-----##--##---------------#-#-#-----#---#--#----##-#--###----#--------#--#-#--###-------------------
--#-###-------------#--##---#-----------------##-#-#--#S-##-----#---#--####--##-------#-#---#-----#-
---#--#--##--#--#---##--##-------------#--#-#-#####------#---##---#-#---------#----##-#-#----#---#-#
--##----#-----#-#-----#-#-#--###---------#-----##-----#--###---#--#-#------#--#-----####-#-######---
#-#----------##-####-------------#--#--#--##------#----#-----####-----#-#--#-----#--##--##------#--#
#----#-------###----##----#---###--#-##----------#-----#--##-----##-#-#---------##-##----#--##---#-#
-#---#----#-----#-----------------------##-------#-##-----#-----#-----#-#----#-#--#-##---#-#----#---
-#----#-#-------#-#---#---##--#--#-----#-#---##-#-#--#---#----#--------#-#--#-#--#----#-#--------#-#
--##--#-#------#-#--###----#---#--###--##----##--------#-#----##--#---#-#----#--#---#-###-#--##-#---
-#-##-#----#---#-#-#-----#-----------#--#---#-----------------#-------------#-----#--#-------#-#--#-
---#------###---#--#--##--#--###----#----#---#--#-#----#-#-#----------#####-##-------#-#-----#-#-#--
#--#-##---#------#-#-------##--#--#---###-#------#---#------###-#-#---------##-###---------#-##---#-
#------#-#--------------#--------##--#----##---#-#-#--#--#----##-##---------#-#----##--#----####--#-
#----##--------#--#--#-#-----#--#---##---------#-------#----#-##--#-##--#-#----#-##-----##------#---
#----#----#-#-##----##---------#-####-#--#--#-#--###---#------#-#----#---#--#-----##------#--##-----
-----#-----###---##-#----#-----##-##-#-#-----##-----------##------#-#--#---##--#-###------#-#-#----#
-##----###---#-----##----#-#-----####---#--#--#--------#-##----#-#-####-----#-----#-#-#--#-----#-#--
---#---#-#--#-----#----#-####----#-#--#-----#---#--#--#####-#--###-----###--#----------#--##---#-#--
#---#-----#---#--##--#-----##-----#-------#----------###---#----#-----------#-----#----#--------#---
--#-----###----##-#-------#---#-##---#--#-#---------#---#--###---------------#--#--#---#---#-#-##---
---#-----#---##-#-##-----#-#---#-------#-###----#---##----------##-#-------##---#--##-##-#--#-------
------#-----#-----#----#---------###---#--##---#-#-##--##--------###-##----#-------##-------#-------
---#-#----#--#--#-#--#-##---#-----##-#--#--#--#----#-#------##--##-----#-----------#-#-#-----##-----
---##--#--#-#-#--#---------#---#---#--#-#---#-#-#----------#-----#--#------#-#--#-#-#----##-#-#---#-
#---####---#-##---##---##-##-#-----#-----#---#-#----#----#--#-##---#----#-#--###----#-#-##-----#----
---#---#--##-###--##---#--###---##------##---------#-#---##---#--#-----#-#-##----#-##-----#--##-----
----#-#-##---##---#-----#---#------#-###--#-#---#---#-----##----##-----#--#--#-#-----###----#---#--#
----#--##-----##-####------#--#-----#--#--#------#------#---#---#--#####--###-#-#---##-#-----#--##--
--#-##---#----#-##-#-----#------#-#-----#---##---#-#-#-#---###---#---#-#--#---------#-#-----#---#---
------------#----##--##--###---#---------#-------#-#---#--##--#---#--##-##----##-##---#-------#-##-#
----##-####-##--#--------#-----#-----##--------#---#-#--###-------#--#--#----#--#---###--#--#-###-##
------#--###-#---#-#-----#----##------#-#-------#-----#-#------###-##-##-------#-----#----------#-#-
#-#--#------------#-#--#-----#---#---------##--#--#-##-#--#--#--##--------#-##--#----#--------##----
#--#-----#-#----#-#--#--#-#-#--------#-###---#---#--#--##-#-#####--##--#--#--#-----#--###-#-#-#-#--#
#--#-------#-#-#--#-----#-##---#-##---#---##--#-##-----#--####----#---#-#---#-----#--#--------##-#--
----#--#--------#---###--##-#----#---###-###---##-#--#-#--##--#--#--##-------#---#----###-------#---
-#-##-#---##--------#-###------###-###-##-#-#----#-#-##-#-----------------##--#----#--#-----#--#----
--#----#-#-----------##--------####-------#--#-#------##--#-------##--#--#--###----##-#--#--#-#----#
------#-#--#----------#-#-----#--#-#--#--#----------------##--#-#-------#--------#-#--#---#---#-#-#-
#----##---###----##----#-#-#--##----#-#---#--##-##-#-#-#---#--#-##-#--##--##----#--------#-#--##---#
---##-#-#-###--##-#--#--#--##---#----##---##--#-#---------------#----#----##---#------#----##----#--
#-#-#--#----##--#-------####--------#-#----#--#----##--#----##-#----#---#-------#-#-#----#-##----#--
#-#----------#-#-####----##--#----##----##---#--#-#--###---#------####--#-#-#-#----------#-##--#----
#---#-#--------------##-#--#-#-#-#-------#---##------#-#-#----#--#----#------##---#----##-#-#------#
----##-#----#-------##-#--##----#--#-#----------#-#-------##-#---#---------###--#--#-#--##-----#----
#-#------#-#--#------###-#-----------------##---#-------#--#---#--#--#--#-###---##------#-#-#-----##
----#-----#---#-#----#------#--------##--###--#---##---#--#--#-----##-##--##---##--#-####-##--#-#--#
-#-##-#---#-#-##-##--#--#--#---#---------##-#-----#-#--#-#-##-------#----###-##--#---#-#----#-------
#-#--------#----#-#-----#---#-##-----##---#--#------##-------##---#----#-##-------#----------#---#-#
#-----#--####----------#----#-#---##--#--#---##----#-#-#-#------#---#---#---#----###--##--###--#----
##-##-----------#--#--#-#-##-##----###----#--#-------##--#--#----------#----#-#-#----#-#---#-##---#-
--#-##-####---#--###----#------#-----#-----####-#-----------#---------#-#-#--##---#---##-#-##--#----
#--####-##--------##---#--#--------##-#----------##-#-#-##-#---#-#-#---#----###-#---#--##--##-#-----
---##--#--###-#---##--#-#---------#-#-------#-----##--###---#-#------###---#---##-------#-----##-#--
#---##--##----##----#-#--#-------------#-###-#----#------##-#-------##---#---#-#-#-#--#----##-------
#-#-#-#-------#-#-####----#--###---#-----##--------#-----#-###---##----#-#-------###-#-----#--#--#--
--#-#----##-----##--#####-#-----#--#---#---------#--#-###-------###---#----#--#--##-----#----------#
-----#-----#---#-------#-#---#---------#-#--#-#-#--#-#####--#---------#--#--#----##-----#-#--#---##-
----###---####--#-#-------#---#-------#------#-#----#-#--#-------##-#----###--#-------------#-----#-
-#----#------#-#-#------##--#---#---#---#-----#--#---#####---------##-#-#--#-#--#---------##---#-#--
---#-------#--#--#-#----#--##--#-#-#----------####-----####--##---####-###---#-#---##-------#---#---
---#--#--#-###--#-#----##-#-#-#-####--------#--#-------#-----#-#----------#------##---#--------#-#-#
---#--------#--##-------#---##--####-#-##---#-##---------#--##---#---##-#-#--##-#--#--#-##-#------#-
--##---#------##-----#-------###-#-##----#-##---#--#---#--#-#---#--##---#---#-----##-----###---#----
--------#-#---#---#-#-#------#---#---------##--#----#-#--------##-----#-##--##-##-----#---#--##-###-
-####--#--#-------#-#--#---##---##-#---###-----------##-##-----#----#--#-##--#--###----#---######--#
--------##-##-#-#---------#--------#----#---------#---#-####-##--###--#------#---------#--#-#--####-
--#----##---------###-----#--#-##--------###--#----#-##---#-#--##----#---#-#-##-#--#---##-#---#--#--
#------##---------#--##---------#--#-#-#-#---------##--#---#---#--####----#-----#------#--#--#-#--#-
#######-------#---##-#--##------#----##-##-#------#---#--####-#-#-#---#---#-----#--#-##-----------#-
-#-------------###---#-#-##-#------#---##-##--#--#--#-#-#-##--##-------##--##--#------##-##----##---
---#-#-#---#-#-#--#--##--#----#--###-------#-#------#--##--#####-----------#-#----#----#--###-------
#---#--#--#---#----###-#-#------#-------#-----#-------#-#-#--#-------###-##--##-####-#---------##---
--#-#---##---#-##----#-##-###-#-----#-----#-##-##-#-#--------##----#----#---#--##-----###-----------
#-#--------##-##--#---#-#---#-#-#-#-#--#--#---##--#--##------#----#-##-#-#----##--#--#--##--#----#--
#---#--#-#---#-##---#---##--#####--------#-------#-#--#-#-#--#----###----#--#--###-##-#--#-----#----
-------#--------#-----##----#--------##---#----##--#----#-----E----#----#-###---##-#---####--##----#
--#------#-#----#-##-------#--#--##-#--##-#--#-----#-#-#---#--#---#--#-------#------#-##----##--#---
-##--#--#-#--#---------#-#-#-#-#---#--#---##-----#------##-----#----#-#-#---#-#-#-#-##-#-#-------###
#-#----#-#--#------------------------##-#------##--#-#---###--##-----#---------#--#---#-##-###-##---
---#-----#-----###-----#--#-------##--#----#---------#--###-----#-##------#-#--#-#-#-##--#---#------
---#-------#---#-------##-#-#-#-----##-#-------------------#--------#-#--##-###-#-#--#-------#--#---
##---###---##-#----##-#--#----##---------#------#--------#--##-##-#--#------##--#----#---#-#-----###
#-------######-#-#----#-#--#-#--#---#-----#---##--#-#-----#-#--------#--#-#-#-#-#--##-##-----#-#--#-
##-#---###---###--##-#--##---#----#-#------------#-----#---##--#--------##-----#---#------#-----##--
------###---#----#-------##---#-####--#-#--#-#-----------##---#-#--#--#-----#-----#-##--#---#-------
-------#----#---#--#----#--#-#---#------#-----#--#-#-#----####-#-----#-------#---##--##--#-##-##-###
--###-----#--#-----#----------#----##--#-##---#----#----##-----#-#-#--#-----#------#----#----#-#####
-#---#----###---##-#--------#---#-##-#---##-----##----------##---##----#---#-#--#---##----#-------#-
----#-----#------#---##----##------#-----------##------------#-##-#----------#-#------##-------##-#-
-##---#-##-##-------#-----#--#-##---##--#-------#-#-#--#--------##-##-#--------------#-##-#---#----#
-###-----#-##---#---##---#-##-#--##--#-#-#--#--##-##-##--#------##-------#---#--#---------#----#####
-----#--#-#-------#-----#---#-#----#--#-###---#------##---------#---#-#----------###------##-#----##
--#------------------##--####-#------------#---#-#-------#-----##-#-##---##----##-##-----##---#---#-
-#-#-#---#---#---#----#-#-------#------##-----#-#------#####-##-#------#-------#--------##---##---#-
-#####---#-----------#--###---##--#---####---#-##---#----#-#------#--##---#--#--#-##----#--#----#-#-
-#-###---#---#---##----#---##-----------#-##-##-#---#--##----##-#-#---------#--#-##---#--####-##----