?diagonal=IfAtMostOneObstacle;
--##----##----------#---#--------E##--#--#--##----#--#---#----##--##----#---#----#--##-----#--#---#-
-----#--#-#-#-##--#---#-------#-----#----#-------#---#----##----#----#-#-#-##---#---#--##-#----#--##
#--------###-------#-----##--#--#-#--#---#--##---#-#--#---#----#--##---#-#-##------------#---#-#---#
-#-----------------###-----#---------####--#------##------##-#--####-----##--#-------##--#--#---#---
--#----###-##--#--#--#-----#------##--#---###---###--#-------------#-#-#------###---###-##---------#
#--#----#---#-#-#--##-#----###------####--##-#---####---#-#-----#-#-###----#---##-#-#--#-###--#-----
---#--#----------#-----#---#-####-#-#-------###---#--#-------#-#-------#-------#-#-----##-#--------#
-#--#--#-##-----------#-------##----------#--###--#---------------#----#----##-------#-----#--------
-------#-----##-##----###---#--######--------#-###-#---##------#-#--##-#-----#-#-##---#-##--#---##-#
#--##----#--#-#---##--#-#-#-------#-#---###-#-#--##----------#--------#-#--#--##--#--#-#-#-#-#------
###--##-----#-------#------##-#----###---#-#--#-#--##-#--#-##------##-#---#--#--##------#-#--#--#--#
##---##--###-------#--##----###--##-------#-#-#----##-#--#---#---#--##---##--#-----#---######---##--
-#--#--#-#---##--#-----#------#----#-----####-#--##--#-----###---###----##-#---#--#------#----------
--------#---#----#-#-##---#-#--#--------##-#-#------#--#-----##----##-----#-##-#---#----##----##----
-#--#--#-----#----##-#-####------#---------##-#---#-----------###--###----#--#-#-##----------#------
---#--#-#-#-----------##-#----##---#---#-#----#-#---#####-#--#----#---##--#-##------#-----------##--
##---##---#--##-#----#----#----##-----#---#-#----##-------#-#--------#-##--#--#-##-##-#-##-----#----
###-#---#------#-------#-----#-#---##-#-##--------------#----#------#--##--#-##--##--##-#---#-#-##--
-#--#-##-#-#-#-----##-#-##----##-#-#-----##--#-----#-----#-----##----#---#--##-#--------#--#----##-#
-----------#-#-#-------#----#----#####--#-----#---##--#-#---#-#-##-#-##-#----#----##---###--#--#---#
-#-#----------------###--#-####-###-#------#------#------#----#-#---#---##---#----#------------#--##
-#-----------#----#-#--#------###---#-##--#-#-#-#-##-----##--##--#--##-----#-----#-----------#-#----
-##--#-##-##--#-----#-#----#-#----##------#-#--#--------------#---#-#-#------####--#-###-#----###---
#----#--#----#--#-#-#---------#--#--#-#--##-#--#---#-#-----#--#--#-#-----#-----##-#--#-----#-------#
-##---------##--##--------###----------##-----###-##---#---#-##-#-#-##----##----------#--------##---
--#-#--#---#---#--#-#####---#-#-#-#--#-----###---#--##------#--#--#-------------##--##-------#---###
##---#-##----##--#-#-----##-#----------------#---#-#---#----------#--#-####----#-#---##-#--#-#------
-S-#----#-#--#--#-#-#-####-##--------###-----#-#--##-#--###-------#---#-----#------#-----##-#------#
----##----#--##-#----------#----##---##---###------#--#---#-###--#---------##---##--------#-----#--#
----------##-#-#--#-##--#-#---#----##--#--#-#-###------#-------#-#-##-##------#---#------#-##---#-#-
----##------#---#---##----##--#---##-----#-#---##-##-------#-###---#-#--------#--#-###----#------###
----#-----###----##--#---#--##---#---#-------------##-------#----#--#------#--##----#-#---#----#-#-#
-----#------##-----#--####-#---#--------------#-----#----#-------##---##------##-----#--##--#-----##
-----##---#-##--##----#-----#-------##-------#-##----------#-##-#-#-##---#-#----##---#---##---##-#-#
-#---------#--#-----------#------####---###--#--#-##----##--------##--#-#-#-#-------##-----------#-#
#-##----#-----------------##---##---#---#----#--------##----#---#--#-##----#-----##-----#------#---#
-----#-----##----#----####---#-#-###----##---#--#---#--#--##-------#--#------###--#---#--#-------#--
--###-#--#--#--##----#-------#--#--#--#------#-#--###---#-------#-###-####-#-##-#-----#-#---------#-
-###-#--#----#---###-#--#---####-----##---#---#--------####----#--#---#-#---------#-------#-#-##---#
-##--##---##---#---#-##---##-#---##---#---------#-#---#-#-#----##-------##-----#-##--##-#-----#-----
-------#----#--#-#--####------###--###-#-----##-#-##-##-##---#----##-----------#-##------#--#-----#-
--#-#---#---------#-##---##-#-##-----#--##-----#--#-#-##--#--##-------##-#--#-#-----#----##----#----
#----------------#-##-#--#--###---------#-#------##-#---#------#------##-#-----#--#--##---##--#--#--
--#---------#-----###------##-#-##----#------#-#-#---#---#-----#----#----#-------#--------#---##--#-
#-#-#-#------#------#--#----#--##-#---####---#----###-##---#-------#--#----#-#----#--------##--#--##
#-##----------##-#-###--##-#------##----------#----###--------#--##-#----##-##----#-##-----#---#-#--
##-------#--##----#--#-#-##----------#----#-#-----#------------------###--------##---#--##--#-----##
#---#---#--#-#-#---#---------#---#---#-#-----#--##-------##------#---#------#-------#----#-#--#---##
-------#----#----#-----#----#------------#-#---###--#----------##--------##------##--##----#-------#
-##-#--#--#----#---#######---#-----#-----#-----#####-#---#------#--------###----#--#-#----####-#----
----#-#-##-----#-##-#--##-#--#----##--------------#-----#-#-##-#---#-#-#----#-----#---#---#-##---#--
-#-####------#-#-----#----------##-----#-----#-------##--#----------#------------##-----#-------##--
-##--#---#----------#--------------####--#-#------##--------#-##--##-#-##-------###--###-----##-#---
##----##-###---##--##--##-------#------#--#-#---#-------#--#-##-----------#-###--#---#---#-----#----
#-------#-#---------##------##--------#-----#####----#---###------#----##--###----#--#---------#-#--
------#-#-#--#-----###-#-#------##--#-##-----#-#-------------#------------#----#-#---#----#---#-----
---#-#--#----##--#-#----#----#----------#-#--###-##--##--------#--##-----#---#--##-#--#----#--###-##
#---###---#---##-------##----#--##----#---##--##-----#-###-#-#---#--#####------------#---#--####-##-
-#-#-#-#----#-#--#-#---#--##-#--#------#---#--##--##----#--#----##-#-#-#--##-##-#-#-#------#------#-
##--#--#---##-----------###---##--##-##----#--#--#-##-#--------#-----------#-##--#-------##--#---#--
--#--#---###-##-#---###--#--##-----#--#-##--#------#-###----#--#----------#-#------------------#---#
-#-##----#---##---#-###-----#-#-#--#----#--------#-#-----#---#----##-----#---#-#---#-#------#-----#-
---------##--#--#-----##--#---------------##----#-----#-------###-###----------##-----######-#------
#-##-#--------##--##-##---#------##--#--#----#---#-##-------------------####--------#-----#-----#-#-
-####----#-----#--------##----#--###-#-#---##--#-#------#----#-####-------#----#----#-#--###----#--#
---##----####-##----##----#-#---#-#-#--#-----##-#--##----######----#-###--#--#-#-##-----#--#-------#
-----##---------###--------###--#-#-----#####-----#--#-----#---##-###-#-#--------#--#--##--##--#--#-
#------#-----##-----#-----------#--###--------#--###--###--##----------##---#----#--#----#-#--###---
-#-#-#---#----##--#--#---##-##--#------#---##---#####-##--#---#----#------#---#------#------####-#--
----#--#-#---####-#-####---#-#------#----------###-#------####-#-----------##---###---###-#-#----#-#
#---#----##--#---#-#------##--###---#--------------#---##---#---------##---#-#-----##-#-#--------#--
---#--#-------####---#-####-#--#--------#--#-#-#---#--#-####----####--#-####-----#--###-----#-#----#
--------#----#-##----#-#---###-#-----#-#-#---------#--------#---#------#-##-#-#--#--#--###--#-------
-----#----------#----#--#----------###--##-------#-#-------#-###-#-#--###---#--##--#----#-#------#--
#-------#-----------##--#-##--###-##------#--#-----#---------#-#####--#--#---##-#----#-----------##-
----#-##-----#---#--------###-###--#-##---------#------#-------#-----#-###--##--#-#------#---#------
------#--#-###-##-#---##----#--#-#-#-#--#---##---#-#-----------#--#------#----#---#-##---------#---#
--#-#-##-----##--#--#----#----#------##---#--------#------#--#-###-#--#-#----#-#--------##-#--##-#-#
---#-----#-----#---#-------------#-#-#-------###--------#-#-#---###-#-#-#-#-#--#--------#--##------#
-##--#--###----#----#---##-#--#-##---####------#------#-#--#-----##----#------#----#--------#---#---
------#---#---#--#-##---###-####---##----##--#-##----#----###-----##----###-#---#---##-#----##------
---#---#--###--##-#-#--------##-----#---#----------#-----------#-#-#--#--##--#------------#---#---#-
-#----####-##--#---#--####----###---##---#-#--###-#-----#-#-----#-#---###------##---#-----#-----#---
-#-#-----#-----#-----#--#-----#------###--#-#--##-#---------####----##-#-#-#---###---#-------##---#-
--##--#-#--#---#-------#----#--------##--#-#-##-##-----###--###-#---#-------------#--#--#----#------
-###--#-----##-#---#---------#--------#----##-#-#--###-##---#--#----#-------#-#---#-#-##--#-----#---
--##-#--------##--------#--#--#------#-----#-#--##--###--------##------------#-#-##---##-##---------
-##---#-##----#----##--#--#-----##----##---##-----#--#-#--##------------------#---------#---#------#
------###-#----##--#-#----####------#-###-##--##---#-#----#--------#--####-----#-#-#-----##--#-#----
-#-#------#------#--#-#--##-#---#--##--###-#---#-#--#--##---#----#-----#-#-#------##---##-#-###----#
-------####-##-#-----#-#--##----#--#--------#-###-#---#-----------------##---#--#----####---#--##--#
-----#----#-####--###---#-#----#-------#-----#---#-----#---#---##-----#--#-#-##--###-----#-#-#----#-
-#---##----------#-#-----####--#-#-#------#-#----#-#-----#-##------###----#-###-----##---##--##--#--
--#----#-------#-##---##--###-#--------###-----#-------#-#---#------#-#-##--#---##----##--#-##--#---
-#----#--#------##--#-#---#-#--##----##---#-#---------#-----#--#-------------###-#-----#--#-----#---
--#--#-------###-#--#-##--#--###---#---#--#--##-#----##-------##--#-#------#-#-#-#------##----#-#---
#--##--##-#--#-------#---------------###-#---#-----#----##--------#---###-#---#---#-#-##--#--#--#--#
-------#---##-####---#---#-#-----#--#----------##--###-----#---#--#---#---####-------##-#-##--------
----#-#---##--#--######---#-#----#----#-###--------####--#-------#--#--#---#-#-#--------------#---#-
##-##-----#-#--#-#------#---#-----#--------#-#------#---###------------#--##---#--#---#-------#--#--