?diagonal=IfAtMostOneObstacle;
--------#----###---###---#--##----------##-#--#---#-----###-----------##-----#-----#-##----##-------
----#-##-#---#---#----###----#-##-#-#-----#-------#-#-#---#---#-#--##------#--#-----#-##---#--#-----
--#--------##-#-##---##-------#-----#-------#--#---#-------#-#-------##---#----#--#---#-#--##----#--
-#--##----#-----#-##-----#------------###-#---#-#-----#---##-#E##----##-##------####--#--#####------
-#---#-##--#--#####------#-------###--#------#-------#-#--#-#----##------#-----##-------#-----##--#-
-#-###-----###----#---##---##--##---##-----------#-#---#-----##--#---------#------#-##---####-#--#--
--#----#-----##-#-##----#----------#--##-##-##---#-------#-----#----##--#---##---#---------#-#----#-
----#---#----#--#-#-----##----#-------#-#-----#---#----##-#-------#-##-###---#--#-------##-#--##----
----------#------#-##---##----##-####--------#----#-------#-#--##-----##--#-#-#----#-##----###-##---
##-----#--#-----##--#-###-##---##--#-#---####------####-##-----#----#-----##-####----#-------#------
-#-###--#-#----#------#-#-------#-----#-----#---#------#------#-#-#--#-#-##----#---#----#-#---##-#--
--##----##-----##----------#----#------#-##---#-#-#-###----#-------###-##--#----#---------#-##-##---
#-#-##---#------#-----#--#--##--##-#-#----#--####------#-#-#----###--------#--##---#------#####--#--
---#-----##---#----#--------#-----##---#--#-#--##-#-##----##-###---######---##-###-#--#--------##---
-#-#----#-##--###---------#-#-#--##-#--#-###---#--------#-##--##--##-#---------##--#-----#-----#-###
----#-----#-------#---##------##--##----#----##----#----#-#--#-##---##-----####---------#-#---#-###-
--------#----#--##-#---#-#--#-------#-##--#---#-##--#-------#---#----##------#--#-#-#--#-##---#--##-
###---------#-##--####-#-#-----###--####-######----#-#---#--#---------##--#-#----##-#-------#--##--#
-##----#--#---#--------------##-----##-#####--#-----#----------##--#--##--#----------#--###-----#---
--##-#-----#---#-#-#--#---#-##-#---#-##---#----#--------#--#-##--#-###-##--#----------#---#-#--##---
-----#--#--------#-#------------#-----#-#---#-#-#-----#---#-#----#--#--#-#-------##--#--#----#------
---#--#-#-##-##-#------##-----#-#-###-##--##---#-----##--------#-#----#-------------#--#-----####-##
-#---#--#--##-####----######---#-----#--###-##---#----###---##-#---#--#-##-#-#------#----##--------#
-#-#---#--#----#-#-##--#--##--#-##--#--#--#---#--##--------##-##-----#----#------#--#-#-##--#-##-#--
###--#------#----#-#-#-------##-#--#--#-----#-###-##---------#-##-#--#---#--##------#--#-#---##----#
-----#---###----#--#----#-##---#-#####-#####---##-#--------#---#-#-----###--#-#-------#---#----#-#--
-----###------#-#---#-#----#-------#--#--------#-------#--###---#--#------##--#-------#-#-----------
##--#--#------------#--###--------#-##---###-#---###-----#-----#-#---##-#------##-###--#---####-#---
--#-##---------#-#--#-#-#----#-#-##-#---------#-----#--#-####--------#----#-#-----------#-#----#-#--
---#---##---#----#-#-----#----##----#---#---##-###-#---#--###-#-#-#-----#--#---#--#---------##-###-#
#-----#-#-#--##--#---##--####-#---#--##--#--#-##-#-----###----#-#---#-##--##---------#---#----------
---#-##------------#-------#--#--#-------#------#-------#-----#----#-------#--------##--#--##-###---
------#-#-#-----##----#--#-#-----#---#--#------#-#---##--#-#-#--###-----------##-##-#--#-------##---
---#--#--#----#----#--#---###-##-----#--------#---#---#----#---####-----#---#-##-----##---##-#---#-#
----#------####----#-------------##-#--#---##-----#--#-##--#-#-##---##-###-#--#-#------##--##-##--#-
---##--##-------#-------#-#------#-##-----#-#----#----#--#----#-#----------#------#-#--#-#-##--#----
-#---#----#---##---#-#------#-#---####------------#----#------#-----##-#---##-#-#--#-##------##-----
---#-##--------##-#---###---#-#------#-#-##---##---#--#-#---##-##-------#---------###-####--#----##-
---#-----##-##--#---#--#---#-----------#--#-----------##-#-#------------------##-----##-#-#---------
##---#-------##---#----#----#----#----#----#-----#--#----#---#-##--------#-##---###--#---#--#----##-
---###--#--##-#---#-####---###-###-----#-------#----#---#-##---#---#-------#------#--------#--##--##
----#-#-----###---#---#----#-#---#---##-#-##-#-----#-----#------#-#-#--------##-#--#------#-#----#--
##-##-#------#-#--##----#---#-----##-#-#------#--##-#---#------------#---#-----#------##-#-----#####
----#--#--#----###---#-----###-##-#-####-#-----#---#---#--####---#---#-#-------#--#--#-----#------#-
---#-####-#-#------##----------#----##-#-#-#--#---#--#--#--##---#------#-----#-----#---#--------#---
#---#--#-------#-----#------#-##--#-#-#----#----------##------##---#--#-#--#--#-----------##-##---##
-------#-#---##-#-#--#--#--#------#-#---#--##-#--#-----#-----#--##-#-----###----##-------#----#---#-
-##-#-#-#-#--##----#----------#--##---#---##-##-##---#-##------------##--------###-----##-#--##-----
##---#---#-----#--#------------------#-#-#----###--#--#-----##-#-###---#-#--------#-#--#--------##-#
##----#--##---##--##-##------#-##-#----##--#--#--##-#----------#----##------------#---#-----#-##-#-#
####----#-###----###--#-##----#--#-#--#--#-#--#--------##-#####-##-#-#---#-#-------###--#---#-----##
#--#--#--#---#-#--###--##--#-------###----S----#-----#-##-#--##---#-----##------#-----#------#-#--#-
---#-#--#------------#----------#-#-----------##------##-----###------#------#--------#------#------
------###-#----##---###-#--###--#--###-#--#----------#--#-----#-#--#--#---#-------#---#--#-----##---
#-----#---#-------#--##-#--#-#-#--#-#-#---#--#-----##--#-#-------#----##-#--##--##---#-##-##-#------
--#######------##----#--#--##---------#-#--#-##-#-##-#-##--#----##-#--#------#-##-#---#--#-###-----#
--#--#----#---####-------#--##-##------#---##-#---#--##-#-----#--#-#-#--#---##-####--#---#----#-----
-###-###----#-#------##----#----#-----#---##------#----#--#---##---#-----#--#--#-#-###----#-#--#-#--
----#--#--------#--#---#-----#------#-#-#-------##---------#------#----##--------#------#-#-##-###-#
-#---##----#--#----#--#--#--------#-###-----#-#-#-##--####-#---###--#--#-#---###-#-##-----#---------
-----#---#--#--##-#-#----##-#---##-------#-##------#---#-#----#####-----##---#-------#-##----#------
-#-#--#--#------------##--#-##--#---------------###-###--#--------##--#---#-#-#-#----#------#-------
##-##-##-#-#-#-----#-######--#-----------#------------#-----##----#---#-##-----------#---#-------#-#
-#-----##-##-----#-###-#-#---#----####---##-#-#---#-#---------#####--#---------#------#------#--#---
--##---##--####-#-----#-#-#-----#-#----#---#---##----##-------------#--##-------#---#--#---#-#-#----
#--#------------#--#-###-#-#-----#---##------#---#----#-#-----#----##-----#-##-#--------##--#-----##
------#-#-#-##-#-##--#-#-#------#-----##---------#-#--#---###-#-####------#--#-------#---###-##--##-
--##-##-#--#--#--##----##---##------#--#--#---#----#----#----#--###-----#------#--#--#--###-------#-
#-------##---##--#------###--#--###--#----#-##-##--#--------#----##------###----#-#-##---#---###---#
-----#-##-----------------#--##----#-#--#-##-#-#---#-####---#---##----##------#--#--##-#---##-------
--#------##---#-#---##-#---#--#--------#---#-#---#-----#----#--#---#--###-##-#------####-##----#-#-#
-##--##---#-----------#---#---------####------#----##-------#----#------------#--------#---#-#--#---
---###-#-----#-------#---#----#------#---####-------------#-#-#------#---##------#-##--#####-#---#--
#--###-#---#--------#---#-----##-#--#-#-------------##--#----#-#--#--#--###-#--#----#----#-#---#-#--
#-#---------##-----#------#--###-----#--#-----##---------####-#--###--------#--#--##-###---#----#--#
###---#--###-###-###--#--#-#---#---#---##-#---#-#--------#-###--#-##-#-------#-----------#----------
------#-------#-#---##---#-------#-#------#------##--#--##-##--#---------#----###----#----##-#-----#
---#-------#---##-#---#-##-----#------##--#-----#---###----#----#--##-#--#-#---#----##-##--------#--
-----#-----#---#-#------------#---#---#----#--#---#---#-------#---#---#-#--#--------#-------###-----
--#--##-#---#--#---##-#-#-#-------------#-------###--#--#------#---#-#----#-----#-#----#--#-#---#---
##----##------#-#---#---#-----#-#-#----###-----#-----#----###---#---#----##-#--------##-------------
---#-#-----------#--#--------##-------#-------##-#-##--#-#--#--------##----##---------#-##-#--###---
#-----#----#--#-###---#--#---#---#--#----#---#-----#------#----##--#----#--#-#--#-#---##---##-#-##--
-#--#-##---#-#--####---#--------#--#-----#-##--#----###--#-------#-#-----#-------------#-#------#---
-###----#-#-#---##--#---#-----#--#-####-----###----------#-----#-#-##--#---------#-----##-#------#--
-#------##-#-#---#-#--#-#-##------#-##--##-----##-------#---#-------#---#---#-------####-#----##----
-----#--####--#-----#--#-------#----##-----#--#-#---##-----#-------------##-----####-------##----#--
#---#---##-#---###----#---###-#------#-#--#--#----#-#-----##-###-#-##----#---#-----#----#-#------#-#
#-#---------##-#-----#----#---#--##------#---##----#-#-----#----#---##---#---#---#-###---#---#--###-
#--#-#-----#--#-------#---#-#--#---#-#----#---#-#--#-------#-##-#--#--#-----#------------#------####
#-##------#-#------#-#-#--#------#--#-##-#--#--##----#---#-----#----##------###-##--##---#---#-#--#-
-##---###--------#-#---##-----#-#-##---#-#--#--##----#---------#-#-#------#--#--#-#---#---###-----##
#----#-#--------#--------##--#-#-#----#----#--#--#--#--#-#----------#-----#-##-------#---####--#--#-
--------#-#--#--##--#----#-#--##-#-----#-#------#-----##------#-#-#--------###---#--##--#--#-#----#-
#-------#--#-#--#-----#----#--#-#---#-#--##----##-##---#---#---#-##----##-#-#-#----#-#-----#---#-#--
---------#-#--#--------#-##--#--#-#---#---#--#--#---#--#--#---##-###---#-###-#--##--#----#-#----#---
#---------#-#-#--#---------##-#-#----##-#----##----#---##--###----#----#---#--##----#------#--------
##------##-#--#------##--#-#---##-#--#--##-#--------#-##---#-------#---#---#-#---#---##---------#-#-
##-#--#-#------##---#---#------#--##----------#-#-----------------#---------------#--#--####--------
-##--#---#-#-#---#---------#-#-#-----#----#-----##-#--##-#--#---------#--#-#--#------#----#--#------