?diagonal=IfAtMostOneObstacle;
-##-------#---#---#---#-#-------#-##-##---#---##-----#####--------#-##----#---------------#----##--#
-------#-###-#---#------#--#--#--#--#-#-----#--#--#---##---#-#--###--##-#--####-#-###---##-----#-#--
-#--#-------#-##-----#--#------###----##---#-#----------#------##-##----#-##-#-##-#-#-###-#---#-#-##
#-#----#-#---##---------------#----###--###-###---##--#--##----##-----#--##-#---#-#-----#--#-#---#--
##--##-#-----#--###-#----#---#-----#-#---#--#---##---#-----#-----#-#----#----#####---#-----#---#--##
#--#-#-##--------##-----#----#--#-----#--##----#--#---##---##--###--#--###-##-#-#-#-#----##---#--##-
-##---##---##--#-----#-#---#--#-##--------#--#---#-----#---##-------#--#--#------##-##-------#---##-
--#---#--#-#####----------#---#--#--------#----#--##-#---------##---#--#-##--#---#-#-------###------
-#--#--#-###-##------------#--#-#-####--#-----#-#--#------#--------#------#--###---#-###---------###
------##-#--#-#-#-#-##-------#---##-#-#---#-##---##-##---#-#--####-#---##-###-#-##-#---#-------#-#--
#-#---##-----#-#-##--------#-######--#-##---##---#-----#-------------#-#------##---------##-------#-
#-#-----#-##----#--#--------#---##---------#--#-----###-##-----#-#-------#--#-#--#-##--#---#----#-#-
#-#------#--#----#---##--##---#-----------------#-##-----##----------#--#-#---##---#--##------#-##-#
-##---#---#--#--##-#-####--#----#----#--#------#--#---#-----#--#------##---#---#-##-----#-#--#------
--------#---#----#-#-##-##----##--------#------#----#--#-----#------#--#-------#-#-#----#----#------
--#####--#-##-#---#------###---###---##----#----##--------#----#---##---#---#-#--#------#--#--#-----
-##--#---#-#--------#----#--#-#-----##--------#---#-#--#-###---##---#---#--#----#---##---##--------#
-#----#---------#--#-###--#---#-###--#----##-------#-###--#-##--#-#-------#------##--#------##-##--#
----------###-------###--#----#--#----------###------#--##-#--###--#-##-----#-#--#-----##-#-----#---
-#---------#-##-------#------##---#----#-###----#------#-#---------#--#--#------####-###-#--#--#-#--
------##--#-#-------##---#-#--#-#--#-#-------#----#----#--##-#-------#--#-#####-#-##--#------------#
-----####-----##-----##--#--#----##----#-#--##-#------##---##----#-----#--#-#-###---#---#-----##---#
---##--#------#-------#---#-#-##--------##--#-----##--#----#-##------#-------#--------------#---#-##
-#-------#-#----#-----#---#------#-----#--------#--##-#-------#----###-#-##--#--------------#--#----
#---##--#---------#-#---#-#--#-----##------#-#-----#--#-#----#--##-------#------#------#---##--#----
--#---#---#-###-#-----#----#--#-#----------#--#----###-####------#----#--#-----#-##-----#--#-----#--
-----#------##-#-#-#---#--------#####-#####------------#--#----#--##---#---##--#####-----#---#---###
#------##-##-#--#--#---##-----#--#-#-#------#-#--##--#---#--#--##----##---#----#---#-#-----##--#----
#----#--#--##---#---#-----###-##------##-#-#---#-#-#-------#---#-#--##--##-##-#--#------#-#-#--##---
#---#-#---#-----###-#-#--#-----###---#------------#--#---------#---##-----#-#-#-#----------#------#-
----#---###-###----##--##------##-#------#-------#------#-----#-#----#------#--#-##---#----#----###-
---#-###------#--------#--#------#----##--##--##---#------------#-#--#----#-#---##-#--#--#----##--##
-#---#--#--#---#-#-#----####------##-##-##---#-####-------#--#------------##-----#---#------#---####
-###------#-##-##--#-#-----------#---------#-#--#-###-----#------------##----#-#--###---#-----------
#----------#-##--#-##-#---------##------#-#-#------##---#--##-------##---#--#--##-#-----#----------#
----#------#---------------##--#---#---##---#-----##-#---#--------#--#------##--##--------#####--###
---#----###----#--#---###-------#----#----------##--#---#-#-#--#---#--#--#-----#-#####-#-#--###---#-
----#--------#-----#-----##-#-#-#-----##--#-#----##-----#------#---##---------#-----#-#-#-#--#------
#-----#--#-#-#-#--#-------#------#----#------#----#---#--#-#-----------#-#-###---#-----#--#-#-#---##
--#-#-#-#-----#-#-#-----#-#--#------#--#---##--##----##---##---#-#---###----#-----#--#-------##----#
------------#-#---##--#------#-----#--#-----#----#-#-----------#--##--#-----#---#---##---#----#-##--
---##----##--#-#--#-#-##-#----##-------#-----#-----#---#------#--#---##-----#-----------##--#--#-#--
-----##---#----#-----##-----##--#-#--#--------##---#-#-#-#-#-#--#---##--##--##-#----#-#---#------##-
-##-#-----#-------##---#----------##------##--------###---#-###--#--#----#--#-#------------#--------
--#----#-#----#----##-#-####---#--#------##-#---##-------#---#-------#--#--#--#-##-#----#####---#-#-
#----##-#----#---##--------#----####-#---#--##------###-#---#--#---#-#-#------#----#-#--#-----#--##-
-#--#------#-###-#-##--------#-#---#-#-#---#----#----##--#-###---#-#-------###---##-##-----##-##----
###--#------#--##-##--###--#-#----#----------#---#----##-------##--#--#-------#--------#-#----#-#-#-
------------------#--#-#---#--#---##--------#---#--#-#------#-----#---##--------------#-#-##--------
###------#-##-#-#--#----#--##---#----#--#-----#-#----#-------#-------#--##-------##---##--#---------
#---#-#---#####---##-----#---#-#-#--##----###--#------#-#-----#------#--###-----#-##---#-#-------##-
---#-#-#--------#--#-#-#####--#--##-#-------##-----#------#----#----#-#------#-----------------#-###
--#--#-#----------#-#-#-##-##----#--#--#-------##---##-#--------#----##------#-#--#--#-------##----#
-#----##-#--#-#-#------#-#-###-##-------#-#-##---#-###---#---#-#--#-------#--#---###---##-##-##-#--#
###-#-##-#--#--#-----####----##-#---#-#--#----#---#-#------###------------##--#------------#-#---#-#
-##---##----#----###-#--####--#-##--#---#-#------#-#--#-#-----####--------#-#-#--##--###--#-#----#--
--#--##---#--------##---#----#-#-#--#-#--#---#---#--#-----#--#-#---#---#-#--#-###------#-###----#---
---#-#--#----#--#-#-##-------#---#-----##-##--#-#-#-#-#-#-----#-#----------##-##------###-----#---#-
#--------#---#--#--#----#-------#---##--#--#---#---------#------#-#------##-----##--#-#---##-----#-#
---#----#---##-##-#-----------#-#------#---##---##-------#-#-------#----#---#--##-----##---##--#-#--
-#-----------------------#####----------#--###--#--------#-----#-----#--------#-----#-#--#--------##
#-#--#-#-#--#-#----#-##------#---##-#-----#--#-##--#---#--#-##-#-#####-#--------##-----####---------
--#-#----#---#-#---###------#--#--------#-#----------#-##---#----##-#-#---#--#-#------#--##--##--#--
---##-#-----#-----------##------#---#----##------##------##--#-#-#----#--#-------#------#-----------
-###-------#-#--##-#-#----------------#---####--#-#--#------##-##----#-#-##----#----#-#-#-#----##-##
--------##---#-##---#-##---##-#----#--#---###--##---------###--#-#------##-#--#-#--------##----#---#
-#--#------#---#--#-#-----##----#-#---#--------###-#--#--#------#--------#-----------#--#-----##---E
--#-#-#-#---#-----#--#------#-#-#---###-#-#-#-#----#------#--##---#----------#---#--#--#-#-#--#--#-#
--####--#--##-###---##-#----------#--------##--#-#--#-#-#----#---------#---###-#--#-------#-#-#--##-
--###----#--######--##-#--#-#--#-#----#-##--##-#----------#-#-#---#----#---#-##--#--##------##--##--
-#-----#---------#-#--#-##-----#-#--#---------##----#--##-#---##---#-#---#-###---#-----#--##--#-----
----#--------#-#-----##---------#--#--#--#-----#-#--##---#---#-------##--##----#-----#-----------#--
---#----##---##-#---#-###-S--#-#---#----------#-----#-##--##-#----#---###--##--#--#--###-#----#---#-
--##----#--#-#------##--#-----#-#-----#------#---#----#-##--##-#----#---#--------#--#-#--#-##---#-##
##---##-----#--#-------##--------#-#-###-#-#--#-----#-#--------#-#--#---#--------#----#-#-----#-#--#
----------#----##----###-------#---#-#-------#----#-#--#---#-##--------#---##--------#--#-------#-#-
----#-###--#--#---####--#---#-#--#-------#-------#--##----#----##---#-#--##-#####---#-----#-##---#-#
-#####----------#-#---#------#---##-##-#--#-----#----##------#-##----#---#-##-#----##-#--------#----
-#---#####-----#--#--##--------#-#------#--#-###--#----#-##------#--#-------#-####-----###---#-##-#-
#----###-#-------#----#-##--#-#--##------------#--#-----#--------------#------###------#-##---#---#-
----------#-#----#---##----#--#--#--##--#-#-#----#--#-#--###--#-------#---#--#--##--#-------##---#--
---#--#-##--###----#---###-###-##--##------#--#--##-###-----##-#-##---#-----#------#---------#----#-
-#-##---#-#-#-#-------####----##---###-#--#-#--#-#--#------------####-#--#-#---##-#--#-#-----###----
--#----##----#--#--##-#-#------#---#-#--------##--------##-#-#-----------#---#------#---###---------
-#--#-----##-#-#---#-###----------#-##----#----#---##-##--------#--#--##--#-------#--------#-#------
--#-#-#-#-#---------##--#--##-#----------#---#------#--#-----------#---#-#-----#---#--#-##---###-#--
-#---#---###-#---######-##--#-#--#-----#-##-------#----#-###---#--------#--#-#-#-#--##-##-----##--#-
-#--###-#-#--#-----##-----#--##-#-###-------#---###-##--#---------##---##-#---#-#-#--#-----#--##-##-
-#--##-#-#----#----#---#-##----------#-#---#-#--#-----#-###-#----###--#----#---#-####----#--##-----#
#--#-#--##-#---#----------##--------#------#----#--#------#------------#-------###---#-##-#-------#-
--#---#-##-###-------#-##-------#-----#--#-##-------#---#-##-----###----#-###---------###-----#--#-#
-----#--#------#----#-#---#-------#-#-----##---------#--##----#---#---####-#----------#----#-#-#-##-
#-#-----##-----#-#----##-----##-##------###-#----#--###-------###------#-#-------#----#---#-------##
#--###--#--#-------##-#-###--#----##--##--------#---##----##--####----#------#----###-#-#-######----
---#-----#--##-#-#----#--#----#--#--------#---#---#---##-##------#-#---#--##---##-------#--###---#--
#--#--#---#----#----#---------##-------#-#-#---#----#----##-#---###---------#--##-##---##--------###
-#---####-#---#-#---#---#-----------###--#-#--#--#----------###-#---#--#----#--#--#--#-----#-------#
-#-##-----#------#--#-#-------#-#------#--#-#-#--#-#-#--#----#--#-#--#----##----#--#-###----##--#-#-
##-#---#---#------##---#-#----#--#-----##--#------------###-#------#--#----#-#--#-#----#--####---##-
----#-#-#-##--------#--##-----#-#---##--#--#---#---#--##-#-----#------#---#------#--##---#-#-##-###-