?diagonal=IfAtMostOneObstacle;
-----------##-##-#--##------###--##---#-#-#--##------##--#--------#---###-#--####-#-###------#---#--
---#------#--###--#----#----##--#-----------#-----#--#----#--#------#----#----##-----#----#-#-#-----
---#---#---##---#---##----#--#-#-#------##---##-#---------#--#--#-----#----##---------##--#----#-#--
#-#-------##--#####--#--#-#-###----#--##-####----#--#S---######----#--#--##-#-##--#-----#----#--##--
#-#-----#-------###---#------###---#----#-----#-##----------#-#-----------------#--#-#-----#--#----#
------#-#-##---##-#-##---#-#---#-#--#-##----------#--###---#-##--#----------#----#-##-#--#--#--#--##
-######--##-#-#-----##-------##--#-##--##-----------#--------#-#-#--#---##---#--#-##---#-#---#--#---
-----#---##-#--#----#--#------#------------#-#--#---##---#####---#-----#-----#####--#--------##--#--
#--#-#-#--#-#--##-----#--------------------#------##------##------#-##-##-----#--------#-----#--#---
#-#-##-#---##--###---#--##-----#------#------##-#--#-#---###---###---##-----#--------##-#-###-#-----
#---------#---#-##-----####-#--##--#------##--#-##--------#--#-#--##-#-----#-#---#-#--#--##-#-#--#--
#--#-#-------##-------#---##--#----------#-##--#-##---#----#-#-----#-#-##--------#-#---#---##--##-#-
-----####-----#-#---#-#-#---###--#-----#---#-------#--#---###------#---##--#--------#------#-------#
-##--##-------------#--###-##--#-#-#---##------#---------#-#-###--------------#------#-#-##---------
------###---#--------#----#-#---##-------#-###-------------#-#------##--##----#--#--#--##----#--#---
#--#------#----------------#---##---#-#---------#--#-#-----#--#-#-----#-##--#----##--#-###-#-------#
----#-####--#---------------#-#--#--##---###-------#----#----#---#------#---#--#---#----------#-----
-#----------------#--#--#------------#---#-#---#-##-#---#------#-#---------#-----#-#-------------###
#-#----##-------#--------#----#---#-#-##---#---#---#----#-----#-#-----##-#----#----#-----#----#--#--
-----#--#---#----#-----------###--#-#-####-##-#--##-#---#-#---#---###-#--#-##-#-#---#-#-##-#--##----
------#-#####----##--####--#-----#--###------##------#------#--#---#-------#-#--------#-------#--###
#-#---#--#---##-----##--###----#--#--#--##--#-##---##------#-#-#-----#--#---#--#----------#-#-#--#-#
---##-#-#--#-#-----------------##---##-##---#-#-#-----------#--#-##-##---#---#--##-#-----####---#---
#-----#----#--#####-#-#-------#-#-##-#-###---------#-----------#-----#------#--##-#--#----#---------
-######-###-#--#---#--##-##--##--#--####-#-#-#---#-#-----#-----#-----#--#--#-###-#-#--------#---#---
#---#------#--#-----#----###--##----#--------#----##-------#---##-#-#-######-##-#------#---------##-
-----##--#------##-----#-##--#-------#-----------#-#-#--##--#--------##--#---#-#----##----#---------
-###----#-------#--#-------------#--#---##-###-##--#-------------#---#-----##----##---#---#--#--###-
---##-#--------#---#------------#--#-#--###-#------#---#-----------##--------##-#--##--#---#--#-----
------##-#--#-#-###---#-#-#-------#-#--#--#--#-###---#--#-----#--#-------#-----#--##--#---#----##-#-
#-#--#--#--#----#---##-----##-##-#--#--#------------#----#-#---#-#---#--#----#-###-----##----#-----#
-#-#---##--#------#----#-#---####----#--#---------#-#---##-------#---##--#--##----##--##--#------#--
---#-#-##-------#-----#------##-##-#------##-#------------#-#-------#-#---###-------##--#--#-#---#-#
#----##-#----#----------------##--#---------------##--##--------##------#----#--#--##---#-----#---#-
---##-###----###-------##-###---------##-----#-#---###-###-#--#-##----#-#-###-----##----#--#-#-#----
---#-#-------#####---------#------#---#--#---#--#-----#--#-#---------#-----#-----#----####--#-##---#
--#####-##-###-----#--#--#-####---###--#-##------#----##--#------#--#---#####---#----#-#------##--#-
------------##---------------#-#-#--#---#---##-#---#-----###-#---###-----------##--#--#----#----#--#
--#---#---#---#--#---###---#----#--##------#--####-#-##-#--#----------#--##-#-----#-##------#------#
-#-#-##--#----------##---------#-#---##---#---#----#--#---#---#--###-------#-------#------#-----#---
------####--#--#--#-----#-#---------#--#-#--####--##--##---#---##-##-------#-#-------------#---#-#--
#-#------------#---##---###--------##--#-#---##-#--------###-#--#-#-------#-#---###-#-----#------#--
###-##---#--#---------#--#--#------#-#----##----#-###-##-----#-----##--#--#-#---#-#--#---#-#-##-----
-----##-----#--#-#-#--#-###---#-#---######-##--------#---##-##---#-#----##-#--------##-#--#----#--#-
-####-------#-#----#----#--#-#----##-##-#-#-#-------####-----#--##---####--##---------#----#--------
-##---##---#--#---##------#---##-#--#------------#---##-##-#--##-#-##--#-------#-#---------#------#-
-----###-------##-----##-#--##--##-#-#--------#-#---#------#----#---#-#---#-#----###--#--##--#-----#
###----------#--#-#-##-#---#-------#--#-##------##---#--#---#---#--------#####-#-#--####--#----#----
###-#--#--#-###---------##--#-#-##-#----------#----------------##---------#----##--#-#--#---#----#--
---------#-#-#--#---##-#-#--#-----##--###--#--#----#-#-##--------#----##---##--#----#-----------##--
--------------------##-##-----#----##------#-##-##-#-#---------#----#-------#-#---#---##------#-####
---------#-##---#-#---##-#-#--#---##--####------#-#---------#--##--###----#--------#----#--#-#--#--#
------##--#-#---------#--------#-#--##-----------#--##-##-##--#--------#--#-#-###-#-------#--#--#-##
#-#--#---#---#---#-------------------#-#----####-----#---#-##-----#-----#--#--##--#----#------------
--##---#-#-------#---#---##--#-##--------#----#--#----#-#-----##----#-----#----#----#-----##----#---
----##---#--#-----------#-----#--#--#-----#----#-#---##------#-----#-##--#---#-#-#---###------#----#
-#-----#--#-#-#-###----#-#----#####-#-------#-##-##----#-----#------##-----------#-#-----#--#-------
--#------#####----##--##---#-#-#-##--#----#-#--#--#---##-##---------##-#-#-#-#---###-#-#--------##--
#------#-#-#--#--#---#--#------#-------#-#---------------#-#-#-##---------#-###--#-#---#---#-----##-
##---##----#-#---#---#------###---#--#-----###--#--#-------##--#-#----------##----#----##-#####----#
-----#--#-#------#------#-##----#---#---#-##-#-#--#-#----######--##---#-#-#----#-#------#-#--#--#-#-
--#-#----###-#---#---###--####--#---##-----#---######---#--#-----#--#--#-#---###--#---##---#-------#
----##----#-#-#--#-#--#---###-----#--#---##-####-------#-#---#-----#-#---#--#----------------#----##
--#-------#--##--#-#--##--#-#---#---##-#-###-##--#------##----##------#----###-----#---#----#--##---
-#---#-----#---##--#-#-------#-#--#----#--##--#---#------#-------#-#--#------####--------------#--#-
-#--#-##---------#---#-----#-#--###------#--#---#--##-----#---#--##-#---#--##---#----#-#-#--#-#-----
#----#-----#-#-#-##----#-------#--#-#-----##----#----#-------##---#--##-#-##---##-#-#-#-#--#----#--#
---#--#-----#--###--#-#----##--##-#--------##----###------##--#---------#-#--#--#-####-#-------#---#
----#--##-##-#-----#-----##---#--####--#--#-----#--##--#--#----#-#-#-----##--------##-------#---#--#
###--##-#----#-##-#--#---##--#-------------##-#----#-----#------##----------#--#-#-#---#-#-#-#------
----#-##-------#------###-#----#-#-------##-#---#----#-###---##-##---------#---#-##-#-#----####-#-##
---####------#--##--------------#-------#----##---##-#-#----#--#-#-##-#-#----#---#-####-#---#----#--
--#--#--#----#---###--#----#--#----##-#------##-#-----#-#------##--#----#--#-#-----#-----#-##-##----
-#--#------------##---#-------#----#-#-----#--#-##-#--#-#--#--------#-------####---#---##-#----##---
-#-----#--#-------##--#-#---##----------###--#-#-#---###---#---#-####------------#--#-#---#---#---#-
------##-----------##-#--###---##---#-#-#-----#---#----#####---#----#---#-#--#-#----##---#--------#-
----#-#####--#---#-----#---####------#-##-#-#-###---##---------#------##---#---#--#-#-#--##-##----##
--##-#--#--#--------#----------#-#-----##----#--##-##----#-##-#----##-##----#---##----#----##------#
-#--E------#--------#-------###----##-##--#-##---#--##--#-#--##---##-#--#--#-------#---##---#--#--#-
#------##--##--###--#---#-##-------#----#-----------##-----------##----#--##--#----#-#--#----#---##-
#-----###-----###--#-#-#-#-#-###------#-#-#--#---##-#--#-#-------#-#---#-##--------###-#-##--#----#-
----#-#---#--#-##------#-#####--###----#----#-------###--#---#-----###------#-#-##-##-#-#---#---####
--#-#-#--#--------#---##---#----#--####--#--###----##--#-##-------##--#--#-#----##-#---#------##----
#---##--#---#-------------##---------#-#----##---#---####-#-#------#-#-#--------##-#------#-#---#--#
-##-#-------##----#---##----------#---------#--##-----#--#-------#-#---#-#----##--#--##----##-#-##-#
##---#--#---#####-----##-##--#---#-#-#-----#-#---------##-#-----#--##----#-#-----##--###-#----------
-------#--#------#----#--------#---###--#--#-------####-#-------#--##--#------#------##-----####----
--##-##--#--#-------####----#-##-------#--#-#--######--#####---#-#----##--##---#-------#----#---##--
###--##-----#---##------#-#--#-###-----#--#---##-#--#-#--#--------#---#-#---#-----##--##-----#-##---
---#--#-#--------#-#-----#----#---#----##-----------#---#-#-##--#-------------##-#----#-------------
----##------------#-----###--##-#--------------##--#-#---#-#---#---#-#-#-#---#------#-#--##------##-
###-----###-----#----#-##-##-#------#----#----#-----#-#--##-----#-#-##--###-#---#---#-#-#-----####--
-----#-#--#--#---#----#--#-#---#-#-#-#----#-####----##-#-#--#----#--##-#-#-------###---------#-----#
----##-------#-##---#--##---#--#--#-#-##-#---#---#-#-#-#-----#---##-#----##--#----###-##-------###-#
-##-#----#-----##----#----#------#-#-##---##-#-------------##-----#------##--#-#----#----###----####
##--#---#--#--#---#---#-----#--#-------#--#-#---#---#--#-#---#---#----------##-#-----#---##--#--#--#
-------#-##---##---------------##--#---#---##---------#-#------##--#-#----------##------#--#----#---
-##----#--##-#-##---------##--##----#-#----#-#-------###---------#--#-#------------#-------#-----#--
#-##--#-#----------------#--#-#-##----------##-#-------##--#-#-#--#------------------##-----##---#--
#----##--#----#-----##--#----##----#---##-#---##--##--#----#--------#-#-#-------##--#--#--##-#-###--