?diagonal=IfAtMostOneObstacle;
----#---#----###-------#------#--####-----#---#-#---#--###-##--#-##---#---##-##-#----#--#---##--#---
-----#-#---#----------#---#-----#---#----####------#---#---#-------#---####-------------------###-#-
---####-----#----#-----#-----#-----#---#-#-----#-#--#-----#--#----##-#-----#-----##-------##--------
#--#----#-----#-#----#--------------##---##---###----##--#-----------#---#----#-#--##--###--#----#--
--#--#--#---------##---#-----#-##-------#-#-#-#-#-#------#-#--------#-#-#-#-----#---#--#----#----#-#
#---------------#--#-#---###--#--#---------#--#-#-----#-#--#-#----##---#--#--##-#--#--####--------#-
-#------##----------###----##----#-#--#---------#---#------#---#---#--#---##----##-#--#--#-#-#-#-##-
#-------#--------------#--#--#--###----#-#--#-----#-##-#-#--###----#------###-##-####--####---#---#-
-#---##-#--#----#-----#--#-#------##-#----##-----#-##---#-#-##-#-----#-------##----#--###--#-#------
-####-----##----#----#-#---#-----##--#--------#---##------####---###-#----#-------#####-----#--##--#
#-#####--------#-##-#-#---------#----#--------#-#-#---#-#-------#-##-#----#--#-####-------##--#-----
--###--#--#----##------##--#--#------------#--#####----#-------##---#--#----###----#-----------##---
---------##-----#-#-##---------##-#--#----------#--#---#------##---#------#-#--#--#-##--#-#------#--
-#---#-#--#-#-#-----#-#---#---#---#--#-#-----#------#--##---#--#--##------#-----###---#-##--#---###-
-----#------#-##-#---#-------#----#--------#------###--#------------##-#------###-------###-#----###
#--------#------#-#--##--#-####-#-#----#---##-#---#---#-##--#---#-#-#-##--#-----##-----#----#-------
-----###--#-----##-----###-------###---##-----#-#---#---------#####-##--##----#-#----##-------#-----
--#-##---#---#---##--#---#---#---#--#-##-------##-#---##---#-----#----#---##--###-#----#-#--#-#--##-
#----#---##--------##------#--------##-##-###--#-----#-------#-##---#--#-#---##--#----#---##-#------
--##--#--#------#------#-#--------------#-###--#-#--##--#----####------#----##-##--#---#--#-#------#
-#----##--#---##--#---##-##------###-#-#-----#---#--#-##--#--#---##----##-##-#--#------##--#-------#
#--###--#-#----#--#----#------#--#-#---##-----#--#-----#----#----#-#---###-##-#---#-----#-----#-----
---###-----#-#------##--##-#-------#-##-##-##-----------#---#-#--#---------#-#---#-#---###-###---#-#
----#-----##-----#-------#---------##-#-----#-###-----###------#---##-#---#-#-#####---#--##--###--#-
-###--#-#--#-##-------------#-#-#---#-------------#---#--###-----#----#-#---#---##-#-----#-#-#---#--
#------##--#--##---------------#----#--#-#--#-#---#--------#-----#--##--##-------#--------#----##---
###---#---------#---##--#---#---#---###----######-##--##----#--#-------##---#--------#---##--#-----#
##--#-#-----#-#-#--#-------##--#-----#-##---##-#-----###---#--###-#--#-#-##--#------#-#-----------##
-#---#--#----------##------##---#-##-#-----##----#------#-#-#--#---##--#--##-#-----------#-#-##--#--
##--#-##-##--#-----#-------##--##-#---###----------#--#----#-------#-#-#---#---##--------##--#-##-#-
------##-#-#-------##--###---####---#------#-#--#-------#---##-#-#---#-#------#-###--#-#-#-----#-#--
--------#-###--#-##-------#--#------##--#-#------#-------#--------###-###-#-#--#-----#--##--#---#---
#-#-#-#-#------##---#--#-----##--#-------#---#-#---------#---------#-#----###-#---##--#---#--#----#-
##---#-###----#--#-------#--#---#---#--#-#-------####----##---#-#---#-----------#--##--#--#--#------
-----#--#------#--#----#-####---#--#####-##--##-#-#-##--------------#---#-###-#-##-##----#------#-##
---###-------#------------#-##-##-#-----#-##-#--------#-#--#-#--##-#----##--------#--------S-#--#---
#---#---####----#------##----#--#--#------#---#-----------------#-#-----##-##----#---------##-------
#---#----#---#----#--#--#----#-----###-#-----###-#---#-#---------#--#-#-#----------##----#-#-#---##-
-------#-------#---#----------------#---#----#-#-#----#----------#----###-----#------------#----#--#
------------#-----#--#-##-#----#----#--#--##----#-#---#-#-#----#----#-##--####----#---#-##-#------#-
#-------##--####--------###-----##-E#-------#-#-#--##-##---------------------#-------#--#-----#-#--#
--#--#--#-#----###--#---#-------------##-##------#-----#-###----#-------##--#------##---#--###-#--##
--#-#--###---------#--#--###-----####-#----------#-----------#--#----###-##--###--#-##-#-----#--##--
-----##---#---#-----#----#------#--#-#--###--#--#-#---##----#-----------#-##-#---#---------#-----#-#
-##------#------#-------------#---##--#--###-##-#--#---#-##-#-#-----#-###--###-------########--##---
-##---#--#--#--#-#-###-###-#-------#--#-#--##-#-------------#-#----#------#---##--##-#----##----#-#-
-#-#---###-##--#-----##-------------#----#---#--##-#-#---------#--------#--#-##--##-####----#--###--
-----#-#--#------#----##--------##-##-#----##-#-----##-#--##-----#-##-#----#-#------#--##---#--##---
------##-#--###-##--#--------------#-----#--#-#-#--##--#-#-----------##-#---#----#-#-#-----#---####-
--##--###-#--###--##-----#----##-#--#-----#---#---##--------#--#----#--##--##---#----#-#-----------#
--##----##-----#--##-##-#---#--------##---#--#-##----##--##-#-#------##-#---##----#-##---#-#-###-##-
--#-----#----#------#-------#-----#--#------#--#----#----##-##--##-------#-------####-#-------#-----
-----#--#--##-----#--#-----#-#-#--#-###----#--#-----#-----###---#-----##--##-##-#-##----#-#----#--#-
-##---####-###-#------##------#---#-#---##---------------##-------#-###-#---#-----#-------------##--
---------#-----------##-#-#-#--#------#-#--##---#--#------####----##--------#-#-----#-#----#--#-###-
##-----#-#####--##-##----#---------#-#--#-#--##--###---#--##-#---------#-##-----#-##---##----##-----
#-----#-##-----##--##---###-##-#----#----#---#--###------#-#--##-#--##--#---#-#-#---###--#----#---#-
--#------------##---##---------#--#-#-#--#----#-----##-##--#-##-----------------#-##-#--##---###-###
---#-----#---#-#---#-----#-#-----##---#-#--------##---#--------##-#--##------#-----#---###--#----#--
#-##------------#----##-----##----#-#----##----------#---###-#----#--#--#-----#-----#-#--#-#-#----#-
-#----#---##----#----##--#####-----####------#--#-#------#-##-#---#------#-----####--#--#---#---##-#
--#------#----##-###----#-###--###-##-----#--#---#-#---#----------#------#-##------#---#-------##-#-
---#----#--##----#----##-#-----#----#-#-----#-#-----#-------#----#-#-#-----------------##----#----#-
----#-#----#-----------#---###---#-----#---###-----##-#--#------#-#-#---###--#----#--#---#-#---#----
-#-#--#--###------###--#-#----#-#------#-#-----##-#-#--#-----#-#-##--#---##---#--#----#---#---------
-----#--------#--#--##-#-#-##--###-#-----##------#----#-#---#----#----####------##--#--##----#------
----#--#-###-##-###--#----#-------##--#----#---#--###--#-----#-#--#--#-----#---#----#------#--#-####
-----#-##---##----------#--#--------#-#---##-----##-----##-#-#--##-#-----#-#--#---#----#----#--#-###
#------#----#----#---###---#---#-##-####---###-----###---##-######--#-#--#--#---#-###------#--##----
-#####----#-#-#---##--##--------#--------#-----#--#----#-----------#-##---#--#--#-------###-#--#---#
--#--###----#-#--------------#------#---#--#--#-###-#-----#-#-#-------#-----##----#--#-##-#---------
---#---#---####-#--#-#--------#--#------#----####---#---#---##--#-#-##--#-#-----#-#--#--#--------#--
#-----------#-------#--#---#--####-----#--#---------##-----#---#-----##------#-#--#--------#--------
-#---#-----##--------------##----------##-----------####-#---#------##--##-####--##------#---##--#--
##--------#-##-##-##--#----#---###----#---#------#-#--#-----#----------##---##-##-##--####----------
---#-#---#----##--------##---##-#---#-#---##--#-###--#-#-#-#----#--###-#-#--#---#-#------#------#---
-##-----###-#--##-#--#-#-#-##----#-#-----#-#---###--#-----#-#-##---###-#--##-#--#---####----#--#----
#--#------#-#-----#---##----#----------#-#----#-----#---##-#--###-#----#----#-##-#---##--------#----
-----##---#--#----------#------------#---#-----#-#-##-------#-----#--#---##-#----#----##-----#----##
---###-#--#####--#----######--#-###-###---#--#-##------##-----#---###--#-#-----#-#-#--#-----#--##-##
----#-##-#-#--#-#--------#----#----#---#--#-----#-#-----#-#---#----#-##-#--#--------##--#--#-##-#-#-
#--#-#------#----##---#--------#-----#-----#-#--#------------#---###--#--#-#-###-#-----##---------#-
#--##-###-----#----#--###--#----#----#----##-#-##-#####--##--#---#-#--#-###-#----#-#-##----###-#--#-
##------#---------#------#-#---#--#---#----#-##---#--#-###-#-#--##-----#------#-----##-------##-----
-#----#-##-#--#---------##-#--##----#-#---#--##-##-###---#----##----#--#-##---#---#----#---#-----#--
-#-##--#-#-#-#----#----#----##-------#-#-----##---#-##-#----#-#-#-#--------###---#--#----#--#------#
-##-##-----#--#---#-#-#-------#--#--##-###-##--#--#--#----##----#---#-#-------#-------#-------###--#
-##---#-###----#-----#-##---------#--##-----##----#---------#----#----#-------##-------##---#---#---
---#--#------#-##--#-#-----##--##-----#-----####---#--#-#-----#---#-##--#-#----##--#-###-##-####----
----#--##--###--------#------##-----------##-------###-#--#--##--#---####-#-----#--##----#-------#--
-------#---##-#-#----------#-##--##--#-#-------###-#---------##------#-----#---------#--###------##-
###--#-----#--#-#----#--#--------#------#-----------#---#-----##-----#-#---------#--##-#---#--#--#-#
#-#--------##----------##-#-##-#---#---------###--#----##-----#-#-#----#----#--#--#-----#-----#-#-##
##-#-----#---#----##------#--#--------#-------##---##-#--###---#----------###----#-###---#--#-##-#--
#--##----#--#-#---------#-#--#---#-----#####------##-#-##-##-#------#----#------#-----#-----------##
-----#--#-#----#---#--#-#-##------#----#-##-----#-##-###--#--#---##------------##----#-------###----
---------#---#----#--#--##-#-#-##----##-##---#---#----#--#----------------------###-------------#-#-
#--#-------#-#-##--#---##-#---------#---###-#----####-##--------#---------#--###----#-##----#-#-----
#--#--------#----##-###----#---#-------##---#-##-#---#---##--#-------#--#----#-#--##-#---------#----
##--#------#-#--#-#----#-#------#-------#----#-#-------------#--#-#----#-##-#------##----#-#-------#