?diagonal=IfAtMostOneObstacle;
#------#------#--#----#--------#---##-----#------#--##--#----##--##--#-#-##----#-#-----------###--#-
--#--#---###-------##---#----#---##-##----###-----#--#---###-#-##--------#---#-----#-----#-#---##--#
-----##----#-#####---###-----------####----##---#-##---#--#------#----##-#---##-#--------#-###----##
#-----#----#--------#-----#-#----#--#---#-#-#-#-##-------#----#----#--#----#-----##---#-###---##---#
#----#-##-#------##-#-----#--#-------#---------##---------#-----#------##--#---###---------------#-#
##-#-#---#-#-#---##-#----#-----##-------#---##-#-#-----#-#-----#---####--#-#-##-#--#-----#-----#--#-
-##-#-------#--#---#------#---#------#-----------####-####---#----#---------###------#------##---#--
-#-#----#---#-##--##---###----##-###----###-#-#-----------#-----##------##---###-#----##--##-#-##---
#-#--###----##-----##--#-#-##--------------#----#-###--#-#-#-###---#####------#-------#------###---#
---#----#------#---##--#------#-##----------------#-#-#-#-----#--##---#---#-#--###----###--#-#-#----
##----#-#--#--#-##----##-----------###-#--#-#---#-#--##--##---##-#-##-#---##-#--#--#-------#---##---
#-----#-#-------#--#-##-----##-#-#-----#------#-#-----#-#---##----#--#-#--------#-------#----#------
-#---#--#---##---#-------------#-##--#--#--#--##--#-#-----#--------#--#--------------#-#-#---####---
#--#-##-##--------#--##-------##-#-----#---##-###-##--------#-----##---##--------------##-#----#-#--
----##--##--#--##-#-#--#-#-###-##--#----#---##----#-#---------#--#-----#---------###------#-------#-
#--#--####-----##--#---#---#-#-------##-##---#------#--##--###-#---------##-#-#-------#------#--##--
--#---#----#--#------#-#--#--###-##----#---#--------#---S##---#--#-------#-#---#-------##---#-#-----
----#--#-------#------#-#---#---#--#-#---###----#-#-#----##--#---#---#--#---#-------------#--------#
#--#-###-#--##-----##-#---#-----###-----#-#-#-#-##---##-#--####---#----#-#--#-#---#--#-##-------#---
#-------#-##------------#####--------#---#--###--###-#-##--##----------------##------#-#---#---#----
-#--#--------#------#-#---------#---------#---#-#-#-----#----#-#--#---#--#----#--#-#-##-#-#----#-###
##----------#--#########-#-#----##---#---##---##-#--#--#-----#---#-------#-###-----#-##-####------#-
-#-##----#-##-#----#---#--#---------##-#-#-#----##--#-###-#-#--#-------#----#--#-------#---#----#-#-
---##-#-#--#--##--#---##--##-#--##-####------#---#-#-#-##--###--#-------#------------#--#---#------#
-----##---#-#-##-----#----#--------#-##-----#------###----#------#-#-#-###-#-##--#---#-#----###-##--
##-#--#---#-##-####-#-###-------##----------###---#--#-##---#---#---##-#-##---#--#-----------#---#--
#--##---------#-----#--#---------#--#---#---#--#-#-#-----#----#####---------#-#---####-----#--###---
-#-#-------#------#-#--#---#-#-----#-##-----#-------------#-----------#-#----#-#-#-#-#-#-#-#---#-#-#
--------#-#-#--##--#------##------##---####-#-#---#----#-##---#####--#----##--#--##-#---#---##-#----
-##----#-#---##--#-#---#----#---###-----#---#--#---#--#-----#--#----#-#-##--#--------#----###---##--
------#--#---#--#---##--#----#--##-##--#-#----#---#-#-##----#--#--###---##------#-#---#-#---#--##---
-#-##-#---#--#-#####----#--#--####---#--------##--------##-----#-#-##-----#-##---#------#--------###
----#--#-----###-#-------------#--###-##---------#--#--------#-#----#-------#--#-#-##---#---##--#---
-----###------#----##-------#---#--#----##-##--###-#--##---------#-#----#---#-#--#-----#-##----#--#-
---#--##---#-#-#-#--#--##--##-#---#--------#--#--##-----##--#--------#--##------------#-#---#-------
-#----------#--#------#--------------##------#-#-#---#-----#---#-#-#--####---#----#----#-----#------
-----#-#--#---##-#-----#-#---##---#-#-#---#-----#-#-#--##--##--#---#------#-------###-#-------#----#
#-#####---##-#----#------##----##---##--#---###-----#--#--#--------##--#----###-#-------##-#-#-#-#--
----#---#-------#----------#---##----#----##--##---#-#---##---------#---#-#--#-#--#--##-----#-#---##
---##-----#--#------#----#-##-#-#---#--#-#####--##----#-#-##--#-------#-----###--#----#--#-#-#---##-
----#-----#---#----##------####----------------#---##------#-----#-##--#-##---#---##-----#-#-##-#---
#-##----#---#-----------------#----#--##--#--#-#-#---#--#----#-##---#--####---##--##-----#---------#
-#--#####---#-----#--##-#------#-----#---##------##--#---##----#---#--#-#-#-#-##--#-#-----#---------
---#--#-#-##-##-------##-#----#-##---#---###---##-###-#---###--#-##--#--#-##----#-----------##-##-#-
----###---#----#-#-----#-----#-####------#-#--#-#------#---#---------#------#------------##-#-#-#---
#-#----#--#-#-##-#-#-------###-#---#---###-#------#--------------#-##----#-----------#--#------#----
--##-#--#---------#-------###--##----------#-#--###---#--##-#----##---#--####----#---#--#--------##-
--#----#---#-#-#------#-#---#-#-##-##---##-#----#-#-##--#-----###---#-##---###-#--#-#---#-------#---
--#---#----#--#--#------------#-#-###---#-#-#-#-#--#-#---#---#-##--##-##-#--####---#--#-------#--#-#
-###---##--#--------#---#-#--------#--------###-##------##-------##--#--#-####----------#---#--##-#-
------##-#-#--##-#----------###-###------#--#----#---------##---#-##--#------##-#--#-##---##---#--##
--##--##-#--#--#-####---#-----####-#-#---#--#-#------#-#----###-#-#--------#---#----#-#--#---##-----
---#-------#----#---##-#--##-----##--#--#----#-#----#--#--#-#----#--#---##-#--#------##-----#-#--###
----##--#--##----##-#---#------#-#-----##----#------#-#-##-#--#----##--#-#--###-----------#-------#-
#-#---##---------------#-#--##---#--#-#-#-------#---------#-##----###--#--#---#-----------#---------
-----------#-#-------##-###----###--###-----###-##-#-#------------#######--##--####-------------#---
-#--#-------##-----------#----#----------------#-##--##--##-#-#--#---------#---###-------####---###-
----#-##-#--##----##-----####------##-#-----#--#--------------#--#------#--#--#------#-----#-##---#-
----------#----------#--#---------#####-------##--------#--#---#-##--#--###---####---#-#------#-#--#
------------#-#---#----##---------#--------##-#----------##-##--#---#--#----####--##--------##-----#
------##-----#-##--#---#-----##-#---###-#--------#-----#--#----#-#-----#---#--------#-#-###--#-#####
#-#-#----#-#-#----#--------##---#-##----------#-#--#-#-#####--#-##-#--#----#-#--#--#-#-#-----#--#--#
----------#-#----###-#---------##-##------#--#--#--#--##--#--##--##---#-#-#-##-#-#-##-#---#--#---#--
--#-#----####-#-------#----#----##---#-------#--#--#----####----------##----#--#-#-#-###--##--#-##--
----#--#---#-----#-#-#---#-------###-----##--#-------#--#---#---##------#-----##---##---####-#--#---
-#------#-#--#--#--#--##-------#-----#---#-##---#--#----#----#-###-----#---#----##---#--------------
###-#----#-##-###----#----#--####---##-#-#-#----##---------#--#-----------######-#---#-#--#-#--#-#-#
-#---#---#---##-----#--#-#-###-#--#-#-#---#-#-------#---#--#-------###---#-#------#-----###--#-#--##
--#-###--##----#-#----##-#----##--####--------------##----#----###-#---#-#-#-#-###---#--#-----#----#
--#--#---##---##-#-#-###-#-#--#-##-#------##-----##-##-##-#----#-#-------##------#-##--#--#----###--
#-#-#-##----#-###-##-#---------#---#-#-------------#-#-#-#--#-#-----#----##-#------#---#--#-#-#####-
---------#-#--------#-#----#-##--------#-#---#-#--------#---#--#---#-##-#---#---#----#------#---#---
#--#----##-----##----#-----##---#---##-----#------#-#-----#-----------###----#-#------#-##--------#-
------#-####-##----#-#--#-#-------#-----#-----##---#---#-#------#-#-#--##--------##-#-------#-----##
-#--#------#---#-------------------------#---#----##------##-----#------#-----#-#--------##-##-#-#-#
--#-----#--#--###------#-----###-#---###-#----#-----------##-----#-#-------#-------#--#--#---#---###
#------#-----##---##-#------------##---#-####-#-------#---#----#--#--#------#------#-#--------------
---#-#-#----#-###----#---------#-------#---#--------#---##----#-------#------####---------###-------
--------#----#-##-----#--#----#-#------#-#-#--#------##-------##--#-#--#-#--#-#----#-#-##--#------##
-#--------------##-#-----#--#---#-#-#---#--#--##-#-#----#----#-##--#--------------##----#--#-#----#-
--------#----------#------#--##-#---###-------#---#--#-#--#-###-#---#--#----------#--#-#----#---##-#
-----#----#-#---#-###----#--#-#--##------#-##--##-#-#---------#-----------##--#---#--#-#---#---##-#-
-##---#-##-------#---#---#--#------#-----#-----#--#---#-------------#----#---###--##--#-#-#-#-----#-
#-----#--##---##-------#--#--------#-----##----#--#--#-#--------#--###--#---#--------#-#----#-###---
----------#---#----#-----#--###---#-------#--#----#--#------#--#-------#--#------####---#----------#
###--#-----#----#----##-------##---##--#-##---------####----##-----#--##--------------#----##-------
--##-####-###-----##-#----#-----#--------------#-#------#-##---#--#--#-------##--#-#-##-#-#-#---#---
----#---#---###----#--#-#-#-#-#----###-#-------#-##-----##-------#-##----#------#----------##--#--#-
----------#-#---##-#-#----#--#-#-#--##-#---#-#---#----#--#-----#---#---#---#-----#--#-------------#-
-#E---#-###--##------------#--------#---#-#---#----##---#--#---------#---#-----------#-------##-----
--#--#----#------#-#----#-------###--##-#------#-#--#---#-#-##--###-#-#--------#-#-###-#-----####---
-#-##-#-#-#--##----------------##-------#-#--------###-##-##-##----#-----#--#-#--#--##--#-###----#-#
--##-----#--###---#--#--#--#-----#---------#----#--#--------##---###--##---##-##---#--##--#--#--#--#
##----#-#-#-#----#---#----#-###-#-##-#--##--##--#--##--#--#-##-#-#-##-------#--#--------#------#-#-#
-#--#--#---####--#-#-----#-###--#-##--###--##-------#--#----#--##----#------------####------###--#-#
##-#-#---#-------#-#-#--#-#--#--#---#---#---#-##----------#-----#--------------#-----#-----##---#-##
#-#--##-#----##----#----#----------##---#-##------#--#-----#--#--##-#--#-##-------#-#----##-#----##-
--#-#-----##-##-#-##-#---#-#--#--#-----#---#--------#------##--#-##-----##--###----#-##--------#----
-#------#---##-#----------#-----#----#----###----###---##----#---------###--#-###-----#-#---###----#
##-#-##---##-#--#---#--#-#-#-#--#--#---#-------##------#--##------#------###---#--#---------#---#---