?diagonal=IfAtMostOneObstacle;
-#------#--##-##-###-#-----#----#---#-----#-#---#--#------#-#-#------##-#-------#---#--#--#--------#
----#-#--#----#--##-#-#----#----#------##----------#-#-##--------#--###-#---#-##--#---#-----#---#---
-----#-##---#-#-#--#------#-#----#-#-#-##----#-#-###------##-#----#--##------#--#-#-#-------##-----#
-----###----------##--#--#----##-##------##--#--#--#-#-#-##--#-------##--#------#----#---#-#--#----#
#-#------#-#-#----#------#--#---#--#-#--#--#--#-#--#--------------#-#-#-#-----#-------------#--###--
----------###---#------------##----#--##-##---#-#----#-------#---#-----####-#-#--#--###--#-#-#-#----
#---#--#------#--#---#-##-----#-#--##-####-----#---#--#----##-#-----###--#--------###---#-#--#-----#
-###---#-##----##-----#----#-----------#--------------#-#--------#----------#---#----####--##--#---#
-#------#---##--#-#-####--#--#---##---####---###------###---#-#---#--------#-#-#-##---------------#-
-#----#-#---#------#-#--------##-----#---#-#--###-####-###--#--------#------------#-#--#-#-----#----
----#-----###--#-#-----#--#-#--#----#--#######---###--#--###-------##-##---------#-----#-#------##--
##--#---#-#--##-#---###---#--#-#--##-----#--#-#----#---#--#----##-----#--#--###--#-#-#----------#--#
#---------##---#-#-#-#--#--#---#--#------#---#----###-#----#-#----#--#--#------####-##---##---#-#---
#--##--#-####-##-#---#-----#-----#-------#----------------#--#----#-----#----#----------#-##----##--
#-#-#----#-#-#-------#-##---------#--#----------#---##--#-##-#--#---#---#--#-##-----###-##----#-----
----#--##----##--#-##-##---##--#-#----#-#--###--##---------#---#--#---------#-----------#-###--#----
--#---##--#---------#--------#----#----#---###--#---#-#-##--####-#-#--##-###---#-###-##----------##-
#------#----#---#--#--#---#-#-------###----#--#----#--#-###----###---#---#--#------#----#-#-#-#----#
-----##---------------#------#-#----------#------#--#----##----#------#-#---#---#--#--##--#-##------
---#----#####-------##------#-#-----#--###--#--##-----#-#-#-------#--#--#-#----#---#-----#----------
---#-----##-------#-#---#---#----#-#-#--------------##----#---#---##----#------#---##---##----#----#
--#-------#--------------#-#-#---------#---#-#--###-------#--#---------##----#-##-##---#--------#---
-#--------#---#-#--#--#-----##-----#-##--##-----#---##---###----------------------------#--#--#----#
----#--#---#-----##-#---#----##-#-#---###----###--#-##--##--#--#--#----##--#-#--#--###-#------------
-#-----#----#-#------#---##---##---#------#####-####-#------------#-##-----#--##----#---#------##---
#-----#-#---##--#---##---#-##-#-#-#-#-#--#------------------##-#---#--##-----#--#---#------#----#---
#-#----#-----#####-#---#--##-#---##-------#-----#-##----##--#-#--#--#-#-#-##---#---#-##-------##----
--###--##--##-#-------##--#--#--##-----#-----##--#----##------#--####-##-#-#----##-##-#------#-#-#-#
-#-#-#-#-#-#---#---#---#----------##-----##---###--###---#-#---#----#-#-#--##--#-#------#--#-#--#--#
----------##---------#--#--#--#----#-----#-----#--##-#------#-#-##------###------###-------##-#--###
-#-------##--#-#-#-----------------#-#---#-#----#---#-#-#--###-------#--------#-###----#-#------#---
-#-----##-#---###-------#--#-----##--------#-#-##--#---##----#-#----#-------------#--#---###-##----#
-#-#----#---#--#-##---#---##--##----#----#--#---#--#--#----------#--#--#----------##-#-----------#-#
--#-#---#--#--#---#-#--##---#-#-#------#-#----#-------#-###--------##------#------#-##---#---#----#-
#------#-#----#----#-------#-------#---------------#--#-#-------#--#------###---#------#--##----##--
----#-------#-##-----#------#-#-###-----#----#---#--#-#--#-----#----##--#------###--#-#-#--####-----
-#------------#--#--------#--##--#-----##----#-#--#------#--------#--###-##------##----#--#--------#
-----#----#--#-----#-##----#--------#-##----#---------##--#------#----##--------##-----#-------#-#--
-###-#-#----#--#-----#---#------#--#-##--#--#----#--#---------#--#-#--#---###----#--#-------#-----##
##---#-##-#--#-#------#--##---##------##------#---##-#---#--###-##--------#-----#---##--#-----------
----#-##--##-----#-##--#-----#-------#---###--##--------#---------#-----------##-#-----#-##-------##
-##----##-#-#-#--#--#-#----#--------##----#---#-#---##--#--------#-#-#-#----#-#---------##-------#--
------#----#-##---#-#---#---#-------#-#----#-----#-----#--#--#-#-----#----##-#-#---#--#-##-##-------
---#------##---#-##--#-#---#--##-#----###----##-#---#----#--##-#-----##----#-------##--##---#-----#-
-----###--##--#-####-#-#---#-----#--#---#-#---#-#-#---------#----##--------#-#--#---#-##-#--#------#
-#----#-#----------------##---##-#-#--####-###-##---##--#---#---#-----#---#----#--##-#-#----#-------
-------#-#--##---#-----#####------#---##----#-----#-#---#---------#--###-#----#---#-----#-###---##--
--#-#-##---#-#-----------------###--###-##-#-#-###---#--##--------##-#----#-#-#-##-#--#-#---#-----#-
--#--#--###---#--#----#---###----#-##---#-------#----#--#-----#-----#-#-#-----#--##-----#---#-#-----
--#-------#------#----#----#---#-#-#-#-#-----------#-###--#---#----##---##----#-#--#-##--#-###---#--
#-#----#---##-------###---------#--######---##-#-------#---#---#-#----####----###-##---####---#--###
--#####--#--##-----#------###------#------#---##-------------#-----#---#-#-##---#----#-#-#-##---##--
-#-------#--#----#--##--------#-#--#---##--#----##-#---#---#---##---#-----#---#-----#--#-#-#------#-
##--#-#-#-##--###-##----------###-----------#------##--###-#-####---#--###--#---#--#-----#---##--#--
--#--#--#-#-######--###--#------#------#---####---------#------###--#-#-#-----------#------##--#----
##--#---#----#----#-------#--##------#----#--##-----#----#-#--####-###---##-####-##--##------##--#-#
#---#-#--#--#----------#--#---#--##-#-#-#---#----#------##-#---##---##--###-----###--##----###--##-#
---#----###--#-#-##--#--#--#-#----#-##-#----#-----------------#--------#--#-----------##--#----#--#-
-----#-----#---------#-#--#--#-#-------#-##--#-#-----S--###---#--##--#-----------#-##--------#------
#-#-#------###-#---#--##---#--#-----##-----#-###---#-#----####-----#---#--#-###--#-----#--#####----#
#---#----#-##----#--#------#---#--##-------###----#---###------#--#-#-#-#-#--#-###--#-#---#----##---
-#----#----#---#-----#--##--#---#-#----------#--#--#------#------#-##-#-#-##----#--------#--------##
---#-##----#---#-#--#-##-#------#####----------#---###--#-#-----------#---#----#--####------#-#----#
#-##-----##-##--#---#-#----##-#--#----#------#-##-#----#-#-----#---##--#-###-----------------##-#-#-
-----#-#---#-#----####-------##---####-----#--#------#-##---#-#----#----#---#----##-##------#--#-##-
#-#-#-#----#-------#----#------#-----#---#-#-#-##--#--------##-##--###------------#-#-#----#--#-----
##---#--#-#--#-------#-------#---##-#--#---##---#--#-----##--##---##--#-#-----##---#----------#-----
#-##--#-------##--------##--#--###----#----#-#---#-#--#-----#--##-#--#-----------#-##-#-#--------#-#
#--------#---#-###----#-----##-#--#-###-------#--##--##----#-------#---#----##-#---#---#-##-##-#---#
-##------#--#--#-#-#------##-#-###-#####-###--#-###----#-#--#-#-##-----#--------#--##-----#-------#-
#--##-#--#--##---#---##-#-----###--------###-#-------#----#-----###-#-----#----#--#----##---#---#-#-
--#--#-##-------#---#--#------#-#--#---#---####-#-#----#-#--#---#-#####-------------#----#-#---#--#-
-##-#--------##---#-------###-#-------#-#--##----#-#-#-##---##-#-##--###-##-------##-#--#-#-#---####
--#------##----##-##----##--#--#-##---##-#--#----#-------------------#--#-#---#-##-----###----#----#
----#--#---------------#---#-#---##--#--#--#--#-----##-#--##----#----#----#-------#-----#-#----##---
#---#---#-#--#-#--#------#----#-------#-#-##---###-#-#-----#--###-----#---#----##-----#-#--#--#--##-
--------##---#--#--#-##--#-----###------#---#-#--#----##-##-----##-#--#------#---#-#--#--#---------#
##---#--#--#---#---------#-##--------#--#-##-----------#--#---#---------#------#------###--------##-
-#---#---##-#--###-###---#--###---#---#-#--#-----#--#-----#-#--#---####-#--#----#--------#-------#--
-----#----#---#----#------##-##----#--#-#--##--##--#---##-------#----#--###-----#--#---#-#-##-------
#-----#------#----##--##--##---##----------##-#----##-##---##---#-##-#---#--#---#------#-#--#---#---
-#--#--#----#---#---##----#---##-----##-------##-#-##-----#--#--#-----#-##--#--###------#----#--##--
------#-----##---##---------#---#--#--#-#-#---#---#--##---#-#----#-------#-#-#-----#----##-#------##
-###--##-#--#--##-##--#-##-#--##------##--#-#----##------#-#-###-#-##----#-##--#--#-----#----------#
-#---#-------#--##-#--##--#-#----##-#-#--#--#--#-#-###-------#-#----#-#----------#--##----##-##-----
#----#-#-#----#----#-------##-#---------#-----###--####--------#--#-##--------###--#-#----#-##---##-
#-#----#-#---#--#-#-#-##---#-------#-##-------###-#--#-#---#---##-#-----#---#---#----###----#---#---
-----#------#-----#-#-##-#--##-----#-#--#-#---------##-#-#-#----#-#--#--#-#---##-----#-----##-#---#-
#--------###------#-#--#--##-----#-#------#-##---#-#---##-#---#---##-------#-###-----##------------#
#-#--##---#--#---#-##-#-#--#-#-------#--#----#------#-###-------#-#--##-#-#----#-#--#----#-#---#-#-#
-#--#--#-#----##-----#----##--#---#-#-#----#----##--#-----#----##--------###--#----#----#-#-###---#-
-----#-#-##----#----#---#-#-#----#----#----####-#-#--##---##---###---#---#-----###----#-------------
#----#-##-------------##---#------#-#--#--------#-#-#----###-#---------#-#----#-----#----#---#--####
##---#--#---#-#----#-#-----##-#-------##---#---#--#-------#--#-----#--#----#----#-#----#-#----#-----
#-#---#--#-##----#-#-#-#-----#---#----#--#--##---##-##--#---#-#-#-#--##------#-#-#-#------#--##---##
--------------#---------##-#-----E#-#--#-#-----#-----------#-#--##--#---#--##-####-----#---##----#-#
--#-#--------####----##-#--------#-##--------#-----#-----#-##-##--##--#--#------------##---#--------
#--------##---#####----------#----##------#-#---#-#--#----------##-#-###-#-----#--##-#----#--###-#-#
--#--#---#---#-##-----###-#-###--#--###-##----#---##---------###-#------#-----#---#--##-#-#---###---
-#---#-##-###--#----#--##-----#-#---#-----------#-#----#----------##-#--#-###-----#-#---#---###-####