?diagonal=IfAtMostOneObstacle;
-----#----###----#-##--#--------#--#--##-##-#-##--------#-#---------#----#-----##-#----#-------#----
#-#--##--------##----------------#--------------------#-#------------------##-#-#-#----####-#-##---#
-#----#--#-#---#-#---#---#######--#-##--##--###--#--#-#-----##------##-#--#---#---#--##--###--#-#-##
#--###--#---------#----#--#-------#-#-#####--#-#--###--##-#--#-#-#-----#----##---#--#----##------#--
#------#--#-#-#-####-##-----------#---#-##--#----#--#--#---#-#-----------#-----#-#---#-#---##----#--
##------#--------------#-----------#----------##-#----#---#####----#--#-#------#----#-##--------#-#-
-----##---#-##-#-##-#--#--#------#-##---##--#---###--------#-#---------#--#----#----##-#----#----#--
-#--##-#-#---#-###---------#---#-----##--#-----###----#----##---#------#-#-#----#----------###-----#
----------#--------####-###---#--##-##-------#---#-#-------##-------##-##-#-###----#---#---##-##----
--##--------#----#---#----#---#---##-#--#----#-#-----#-----#---##-#---#----#-#------#--##--#-----#--
----------#-#---#--#-------#---##-------#---##----#--#--#-----#-#-----#--#---#-#-#--#-##-------###--
-##-#-#-#---##---#----#-##-#--##---#--##----#--#---#-----#-#-#-------#----#--#--####--##---#-----###
##---#---####-#--#--------#------------#-#-----#----##---#---#--#--------###------#-#---######---##-
##-------##--##----#--#--------------------#-----#---#---##--#-------#---##------#----#-###--#-#-##-
-------#--------##-----#--#---#-----###------#-##---------#------##------##--##----#####-#---------#
------#--#-#--#----------#---#-#-#--##---#---------###---#------#--##----#--##-##-------------------
#-#-#-----#-#------#--#--###-##-#-#-#---#-----#---#--#--####--#--#--#-#--#-#------#-------##-###--#-
---#--#-#--#-#-#--#----#-------#---#-----#-##---##--#----#--##---#----#-#--#--##-#-#-#-----##---##-#
----###------#------#---###-##----#-#-##----#---#--#-----##--##-#--#--#--#-#-#----#-##---#---##--#--
##-------------#-------##-#---##--#-#--------------#---------###----#-----#--#-########--#--#-------
---#-#--#-#----------#-#--#--#--####-----#---#---#--#-#-##---#-##--------##--#-#---#---##-----#---#-
#------#-#-###---#-#--#----#-#-----------#-###-###----#----------#------------##------#-----#-#---#-
-#-##--##-#-##-##----#------#-----##-#------------#-------#----#---#---##---------------##--#---#---
-----##-#-------###---#-##---###--#-#--#----------##----#-#----##---#---#----#--##-#--------##-#----
----#-#------##----#------##----#---#-------#-----##-#--#-#----#-------#-#-#--####-------#-#---#--##
----------#-------#-----####-###---------#------#---------#---#--#---#--#-#-#------#--#------##--#-#
-----#----#--#--#---#-#-#---####----#-#---#----#-##--#-----#----#----##-------#-#--------##--##-----
#-#---------#--####----------#----#--#-##--#-##-------#--#--#----#--#--##------#-#----###---##---#-#
---------#-----#--#---------#----#-##-#------------#------#-#----#--####------###--#---####--#---#--
-#---#---##--#-#-##----#-------#-#---#-#-----##-#--##---#------#-#---#----#----------##-------#---##
---###-##-----#--#-#-#------##--#-#-###-##--#---##--#-##--####--#----##-##------#------#-###----#---
--#----#-##----------#-------##--#----#-----#-#-##-#--###-----#-#-#--##---#-#-----##-------##-##---#
####-#------#-----#---#-#---#---##-#------##--###-##-##---##-----#-#-#-#--#-#-------#------------#--
----##---#---##---#---####----------#--#-##---#----##-----#--##--#-#---#----#--#-#--------#---####--
--#--------##---#--##---###-#---#-------#--#-----------#------#---------#----#-##-----------#-----#-
--#--##----#----#-#-----------------###---#---#-----#-----#-------#-#-#----------###----##---#----##
-----#-----###--###-##-##-#--------------##-#---#-----##----###-##-#------------#-#-----------##-#--
------#---#-----#---#----####-##-#---#-----------#-----##---#--#---#--------#-#-------#----#--#-#-#-
-----###---#-----#-#-##--#---#--##----------#-#--#-#-----##-#----#------#---------#---#----#----#--#
------##---#-#--##---###-##-###---#--#----------#-#----------#-##--##--#-#---------------###--#--##-
##--#---#--#-##-#--#--######-#-#-#--##-##-------#--#---#--#-------##---#--###-##----#-##-#-----####-
-##-------#--##-------####----#-#-----#--#-------#--------#---#--##-##--#--###-##--#---#------------
-#--#----#-------##--#------------##---##-#--#-#--#-#---#-#-####---####-----#-###------##------####-
-##--###-##--##-------#--#--##----#-#----#-#-----###-----#----#-#--#--------#-----#-##--#-#---#----#
-#-#---##-#-#--#-##-####--#------##--#-#-#-#----#-#---#-------##-####--#-#-#--##-#---------#----#---
--#----#----#----#----#-------#--#----#-#-#-----###-###---------###-------#---#----#-#--#-------#---
-#-##-#-#--##-----------#-#------#---#---#-#---------#----#------#-#--#------#####--------#---#----#
--#----#-#--#-##---#--------##----##-##-#--#---#----#--#------------##---------------#--#----#--##--
####--#-##-#--#---#-#-----#----#-####--------#----#-#------------------##----##-#--#-#--#--#-#--##--
#-#----#----------#--#--#--###---#--------#-###---##-#----#---####---#--#-#---#---#---#-##-##-#---##
----#--------#------#--##----##-#-####--#--##-#------------#-#-##--#-#-----##-#-----#---#-#-----#-#-
--##--#----#--#--#----####--#--#--#---------------##-#--##-#---#-###-#-##-#-#-##--##-#-#-##-##------
#---#-##----#-#-##-##-#---##---##--#---#-#------#----#--#-------#-----#---#-##-#-#-#-#--#-###-------
--#---#--#------#--#---###----------##-#--##--#--#-#-#----#-#-#--#-#-#---#---###-----##-##-#-----###
#--#-#----#--#--#--------#-----#-#-------#---##--#-#----#-----##-#---#-##-#-##-----#-#-#----#-----#-
-----####-##-----#----#----#-------###----##-#---#--##-#-----------#-----#-##--#-#----#--#---##---#-
-##---###--##-#--#----------#-#--#--##------#--#-------#----------###--#-##-#--####---#--#--####----
#####--#-----##----#-#-----#--#----#----#--#-###---#-#-------#-#-------#----####----#-#----------###
--#-#---#---#--##------#----#-----##-##-#-#---#---------##-#--#--###---###-------####-#--#-##-#-##--
--------#-#-------#####-#--#-----##-------##--#---#-#----#-##--##------#-----#------###--##------##-
---E#-----###----------##----------#----#-#-##-##--###--###---#-----#-#--#--#---------###--#---##---
-#-------------##----#--#--###---###-#--#--#####----#---###---------#---#--##-----#---###--#--------
-##--#--#-#---#-----#-------###-----#-#----##-----#-----#####---#----#---#---#-----##-----#-#--#---S
-----###----#---#--##--##----#-#----##---#--#---##------#-#-#---------#-#----##------#--------------
##------#---#----#----#-###---#--###-#-#---#------#------#-##-------------#--#----#--#------#---#--#
#----#-------##---#-#---#--#-----#----##--#----#----#----##------#-#-------#-#-#-------##------###-#
#---#-----##-------#----#--#----#-#--#-----#----#-#-##--#---#-#--------###--##-#--##-------------#-#
#--##-----------##--#-----#---#-#-#-#-####----#-#------##-------#---##-##-#---#---##--#--#-----#--#-
#----#---#---#------#--#-###------#-#-###-#----------#-#--###-----#-#--#-------------#---##-##--##--
###--#------#-#------#------###----#-#----#-------#---###-#-#-#-----------#-----#---#------#---#----
##---#---#---##----------#----#-##--###---#-##-----###---------##-##-------#---#####-#--#----#------
----###----###-#-#--#-------------####---#-##-#--#-#-----------#-------------#-#-#--#-#---#----###--
------##-#---#----------#--------------##---------#--#--#---#----#----#-##-------#--##--#------#---#
-##---#-#-###---##-#--##-------##--#--###-#-##---##---#--#####--#------#--#---#-##--###-#-##--------
-#---#--#---##---#----#-#---#----#---##-#-----#-#--#-##--###-##----#-#-----#--------#-#-##-##-------
##--#--#----#-##---#--#-#####-----##-#---###-#---##------#------##-#--#----------##-#---#---######--
-####---#--##------#----#-#--#-##----###-----##--#----#-#--#-#-------------#-----#---#-##----------#
###--#--#--##--#-#------#------#---#-#-#-----#----#-#-------#--##----------------###-#--##-----####-
-#--#-#------#-#----------#--#---#--#--##--#-#--##------#----#----#-----#---------#----#--#-#---#-#-
-#-#-#-#---#-#--#-#---#-#--#-----##-#--------#-#----#-#-##---##--------#---------#--#----#--#----##-
----##--#---------#--#--#-#-##--###--##-#--#---#----##----------#-----#-#-#----##----###--#######-##
-#----##--#-----##-------#---#--#---#-##--#--#----#-##----------#------#--#--#-----------------#----
-------##-#----#--#---#------#---#--###--#-#-#--------#---##--#---##-##-----#-#---#--#-#-##---#-----
#-#----#-#---#-#--#--#--##---####-#---------#---##---#-#-#--##--##---#---------#-#------#-----#-#-##
#-#-##--#-#-##---#-#--------#--###------------#---------#-----###-----##-#-#-------##-##--#---#--#-#
--#--------##--#####----#####-----#----#-----#-#----#----#--#---#------#-#--#--###---#-#-####-#--#--
#-##-----#-----#-##---#-#-----------##---#---#-------#--#---#-#-##-----#--#--#-###-#-#---##-#------#
#--#--#------#-----##-#---#--##-###--#-------#-##---#------#--#------###--#-#---#------##-----#---#-
------#---##----#######---#--------#-##-#-----#-#--#-------#-#-----#-#----#-#---#-##--#---#-----##--
---##-#--#--##----#--#---#-----##------##---#-#-###--####-----#-####-#----------#---------#--------#
-#----#####--##-#-##--#---###----#---#-----#------#---##------------#-------------#-#--------#-#---#
--#-------------##-#-#--------#---#-#--##------------#-#----#--#--#--#-#-###---#--------#--##-#--#--
-------##---##--------#-##----##-#--#--#---##--##----#---#-##-----#--##--##-#-###--#-----#---#-#-#-#
##---##-------##---#--------##-##-----##------#-#--#---#-#--##--#---#-#-#--#----#--#--#--#-#--#-#-#-
-------#--##----------#----#---#-#-----#-##-#--#-#---#--#------##---#-##-------#--##-#----#-#--#----
-#--#------------------#--#----#--#-#----##-##-#-#------#-----#-#-------##--#---#---###-###---------
----------##------#----#####-----#--#------#----#-#---####-------#---------#--#--#--#-#-#-#--##---#-
#----##--###---##---------#-------#--#------####---#----#---#-#---#-----#---#-----#-#-###-#-####----
----##--###-----#--#--##-###----##-----#--##---#--#--#-#####----##------#---#----#-#--------#-#----#
------##--------#----#-------#--##-#-###---------###----##-##---#-##--##--------#--#--##------#--#--