?diagonal=IfAtMostOneObstacle;
-----#---#-#-#-##--#----#-###--#----#----#-##--###--#-----#---#-------#---#--#--#-#----####--#--#---
--#---#------#-----#-#-##--#--------##------#-#--#---#---##-#--##--#-----#-#---#-----#--#----##---#-
------##----##-###-##----#--#---#--#--###--------#--#--#--------------#-##---##--#--#-#--##------#-#
-#--#----#--##---###-#-#-#----#-##------#---#----###----#-------##---#----#---###-------#---#-#-##--
--##---#---#-#--##---------####-#-----#--#-#-#--##--##-#---------#--#-##----------##-----##---------
--#----#-#--------#-#--#--#-----#------######-----##-##---##----------##-----##-------------#-#-----
-#--------##-#-#----###--------#--##-----####--#-###----#----#-##--#-----#------#---#-#####----#----
#------#--#-####---#-#-#---#-------#-#---###-----------##-#--#-#-#---#-#-----#-#----#------#-#--#--#
---#---#-------------#---------#---###-#-##-------#-##-----#--##-----#-#--#-##-#-##--#--####--##----
-###--#--#----#---#-------#-#-#--#--#----#--#-------#--#-##---#-####-##-#---##-#---#---##-#-#------#
-#--#--##--------#--###---------------##-#-#--##---#--#-#---------##-------#--##--#--###---------#-#
#-----#--------#--#------##-------#-------###--#-#--#-#------#---#----#-#---#----#---#-#-###-#--#---
-#-----------#----#----#---#-###--#------#-----###---#-#-------#--#-#-----#----#-----#-#--##---#--##
##--------------##--------#-#----#--#----#----#--#------#-#---#------##--##---#---###-----#----##---
##-###--##-----#----#--#-###-----#--#---#--#---##----#---#-------#---#-#-#--##---#-----#----##-###--
#----#----#-#---#-------#-----#-####---#-----#--#----#-----#-------##------#-#--#-------###-##---##-
-#------##-#---------##------------------#-#--#------#--#-----#-#---#-###--#-#---#--#-#----##-------
---#--#-#-##--#-#--#---#-#-#---#-----#---#-#--#---#------#--#-#-#---#-##-##---#---#---##-#---#----##
-#------#------#-#--#-#--------##---------#------##--------#--#----#-----##-#--##-----#-#-------#--#
##--#-------###--#---#--#---#--#--##---#--###--#-#--#----##---#--##-#----#--###---#---###-###--##-##
-----#---#--#-#--#-#---#--#----###-#---##-----#------#------------#---##---#----#-#-##--------#-----
----##-#--#-###---------##--#--##------#----#-#--#------#-##--#----#----##---##-#----------#---#--#-
-#--#-#---#-#-######-#-#----#---#-----#---#-----------#---#--#--##-#-##--##----#--#--#-#-----#--#--#
--#-#------#---###-#-#-#---#--#---#-#--#-##-#-----#--#---#--#--#----#----#-#--#---#-#-#---#-----#--#
--#--#-#-#------#-------------#--###--##-#--#--------------#---#--#-----#-----#-#-#----#---#-#-#-###
--#-#------####-#--##-#---#--###----#---------#-#-#--#-#--------#------#----#--#---------#---#-#####
#-#------#-----#-----###---------#---------#---#--#-#--------##--##---#--#---#-#--#-#--#-#---#--#--#
--#---#----#--------#------------##------##-#---##---#------#---#-#--###--#-#---#-----#--####-#---#-
-----##-##---#-#---#-#-#-######--##----------#---#----------#-#---#----------#-#-----#---#-------#--
-##--#-----##----#----------#-#-##-#-##--#----#-------------##-#---------##-#--##-----#####-#--#-##-
-#--#---##-##---#--###------#-#-----##-#-#--#-###--##-##--####----#--#---#--#------#-##----#----#--#
----#--###-----#--#---##------#---#-------#--#--------##-#------#-##------#-#-----#-##-#--##-#---#--
#---#----##--#--#---###---#-#-----#-----####-#-###--#--------#-#----------#----###--##-#----#-#--#-#
#-#-------------##----#---#-##---##----#---##--------#--#---#---------#-#------#-##-------------#---
###---#-##-#--#----#---##-#-##--#-#-----##---#--S-#------#-####--#---#----#------#------#-#-##------
-#-#----##----#-#--------#-#-#-##-#---#-#---#-#-#-#-##---#-----##---##-#---##--------------#-----#--
-#--##-##----#-###--##----#-#---##----##-###-#-#-----##---#--##------#---#-#-----#--#------##-----#-
--#----#----#----------#-----#---##-------###-#------#--#--#------##-#---#----------###-#-----------
-#----#---#-####--#----#-----#-#--#-#----##---##----#-#---#---------#-#----###---#---###-##--##-#-##
#---####------#-----###-#--##-------#-----#-#----##-##--#####----#----#--#---#-##-#------#-#-#-#----
-#---##-#--##-#-##----#--##-#-#----#----#----#--#---##--#--#-#------#-#----##-###--##-#---##-----#--
--#-#-#----#-#--###-#####--#-##-#------#-----####---#-#-##--##----#----#----------#---#-----#--#--#-
--#-#---#------#-#-------#---#--#-#-----#--------#------#--#-#---#--#----#--#--#-#---#---#-#----##-#
---##---###---#---#---###--------#------#-----#--#--------#----#---------#-##--#-#--------#--###-#--
------#------#-#-#---#---#--###-----#---------###-#--##--------#--##----#-#-#-#-#--#-##-#---#-#--##-
#--#---#--#----###-##-#--#---##-------#--#---#--#--#-#-##-#-#--------##-------#--#------###---------
------#------#---##-##-#---#-#----#--#--##-#--##-----#-#--#--#------#------#-#-#-##--#------#--##-#-
------##-###-#--#--#--#---#---#----#-#--##---#----#---#-#--#--##------###-#-----##--####--#-#-##-#--
##--#----#---#---#-##-#----###--#--##----#------#--#---------#--------####-----#-#-#--#-#-#---#-#-#-
##-------#---##---#----#---#-----#-----#-#-##---#-#---#--#--#----------#---##-#####-##-##-------#---
-###--#----##--###-----#--#-#-#---#--#-----------##--#-#---------#-#----------#--##-----#-###--#--##
#-#-##--##----#-#---#-##---##-------##--#-##-###--#---#-##----#-#--#-#---#----#-#---#--###---#-#----
#------#--#----##-----#------#-#----#------#-----#-----#----#--#-----#-------#--#---#-#####----#-#-#
##---#-##--#-###-#--------##-##-----#----#---#----------#--#-#-------------#---##-----#-----##---##-
-#---##--#-------#-#----#-------###-#--##----#---#--##----#----#--#-----#------#-#--#--#-#--##-#--#-
---#-#--###-----##-##---#-#--###--#-###---------#-----#----#---#------##--#-#-##-------##--#-----#--
------#-#E-----###------#-##--#-##-------#---#---#-##----#---#-#---#-#---#---###-------##---#--#-#--
---#--##---#----#---#--##---#-#---#-----#-#-------#---#####-##--####-#---##-#-#-##--####-----#--#---
#-#--#-----##--------#-----###--------#----#--#---#---##---#-##----####---#---#------#----##-#---##-
---#-#-#----#--#-#---##---##-----------#--#-#-#-#--#-#-#---#--##--#-##-------####-#------#--#--##-#-
-####-#--#---###-###-##----##--####------#---#----#-----#---#-##---#--####----#-#-#--#-###-##-----#-
-#--#-#-#---#---###--------#-----#-#---#----#--#--#----#-#---#------#-#----------##-----------------
#--#---#-#---#-###---##-###------#-------#-#-#-----#--#--------##--##----###-##-###-##----##--#--#--
---#---#----#---#------------#------#---#---#----#-#-------#-#--#-#-----#--##-##--#-#----#-------#--
--#-##-###-#-----#---#----------#---#---#-#----##----------#-##--#--##-#--#---#----#---##---#-##---#
#--##-------#---#--#----------#--##-###---#------------#-#---#---#---###---#------#-#--#-#-#--###---
#------##--#-#---#-##---##--###-#----#--###-#-----##-------#---#-----#-----####-#-----------#-#-----
-----#-##--#--##-####---------#----------#--###-------#-----##-#-#-#--#-----#----###--#--#----------
----#----#-###---##-#-#-##------#-#-#-#---####---##---#-#--#----------##-#-------#--#---##----##--#-
-#-##----#-#-####----------##---#-----#-----------#-------##-----------------#-----##--##-##-#-#--#-
#-----##----#-##--#---#-----#--#-#-----#-----#--#-#-----------#-#-##---##-#------#---------#-##--#--
#----###--#--#---#-#-#---###--##-#------------#---------#-#--------###--#---#---##-#-###-#-#--#-----
------------#-#-#---#-##-----##-#--#---###----#-----##-#--#----#--#------##--#--#--#-##-#---#-------
-###-#-#-----####---##---#----###------#--##--------#-------#-##-#--#-#---#-#--###---###-----#------
##---#---##-#-##----#--------##--#-##-##--#-----#-#-##-#-----###------####--##-#--##-------##----#--
-----------#--#-#-#-#-#----#-##---#----#---#--#---#--#-----#-##-----#------#-#-##------#----#-#--#--
--#---#-------#--#-#----------#----#---#-------#-###--------###-#-#---#-#----------#-----#-------#-#
#-#----------#---##-###----##----#-#-#-------##---##--#--#-----#---#----#------------#------##-#-#-#
#---##--##---#--##--#-----#----#-##-#------#-#--###---##----##---#--#-##-#----#-#--####---#-#-----#-
----##-#--------#-##-#-#----##-#--------------#-##--##-#-#---#-----##--#---##---#--##----##---#----#
#------#--#--#--##-----##-##----#--#--#-----#-#--------#---##-----------------#---#-##--#---#-#--###
----##-#-----##--------#--#--#-#-#-#------#---##---#-#---#---#------#------##------#------#-#-#-----
-#-#--#----#----#----#-----##-##---#-#--#-#----#------#-##----##---#-----#-#-----#-##-#-#-##-#----#-
-######--------##---------------#---#-----#--#----#---#-#-----###--#----------#----#--#-----#-#--##-
#-#---#---#-----#-#----#-##-------#-##-------------#-#--##-----#---#####---#---------#---##-#-##----
#---####-------------------#--#-#-#-----#-###--#--###-##--###-#----#-----#-#--#-##-#----#------##-##
------##-##-------#--#---------#---#---#------#-#-#---##--##-#-#--#--##----#------#--#---##-#--#----
-#-##--##-#---#----------#-----##-#-#-----#-##-----#-#---#--#-#-#-#-----#----#-----#-------#-------#
----------##---#-#--##--##-#---##----#------------##----#-----#--------#-#--#--#---#--#-------#-----
----#-----###---#-----------#------#----#-#---#-------#-##---------#----#----#-#----#---##--#-##-#-#
--------##----#-##----#----#-##----#--##-----------##------------###-#-----#----##-----#------------
-#-#----#-#--#--#-#--##-##---##----##-----#--------#----#----#--#-#---#----##---#--#-------##-#-#---
-##--##-#-----------#--#-##----#---##-#----##-###--#--#----##-#--#-----#-#--#---------#--#---#----#-
###------#-#---##--##-##----##-##---#---------#--###--------------#-------##---##--#------##-##-----
-##--#-#----------##-#-----------#------#-------------#-##-----#----#-#---#---------###-#--#-------#
-#-----#--#------#------#-----#-----#--##--#---#-#----#---##--#-#------##--#--------#-#-------------
-----#---####------###--------#-###-#-------#------#---#------#---#-----#####--###----------##-#--#-
----#-----#------#-##-####----#-----#-##-------##---#---#-------#-##-----------#--#----###--##--#---
#--#-----#-##-###-#---------#-#--#-----#--#---#--#-##---------##-----#---#--###-#----##--##-----#---
--#--##-#-#--#-#------#-----#---#---#--#-#-#------#-#----------##-#---#---#--#####--#-------#---#--#