?diagonal=IfAtMostOneObstacle;
#-----#-#----------#-----#--#------#--#-####-#--##-#-#--##---------####-##---#------------#-#-#-----
--###-#----#--#---#-##--#--##----##-#-##---#-----#-#-#-----------#---###-#-#-#-------#--##---#--#-#-
-##--#-###-##-----#---#----#-----#####---#-#---#-#-----#---####-----#------#-----#-----#----#------#
--#-#-#--#-#--#-#----###--#--#------#-#--##-------#-##--------------#--#------#----#---##---##---#-#
-#--##---#----#-#--#-------#--#-------#-#-----##--###-#---------#----#-#---##-----#----##----#-##---
--#-##-#-#-#---#-#--#--#-#-##-----##------##-##-##-#--#-#----#---##-##-------#---------#-#--#-#-----
-#---##------------#-##-----##----#-##--#---#--###-##--#------#-#---####-----##-----#------#-#---##-
---###--###--#--------#--##-----#-----#-----#-----#----------##--#----#-####--##-----#---#-----##---
-#-----#--#-#---#---#--#--#-#--#---#--##---#---#--#-----#------------#-##--##---#-##--#-####----#--#
##----##-##--#---#---#--------##---###---#----##----#---#-##-###----#-----#--#--#---##-#-##---------
--#----#---#--#-#----#----#-###--#-------##--##--#----###-#-###----###-----#--#----#--#-#-##-#------
--#-#-#---#----#-##--------#-##--##----#-#-#--######--------#-------------#-#--------##---##-#---#--
--#-#-###---##---------#-##-#--#-------#---#-#--#-###-#--#----#---#-#---#-#-#-#-#--#-###----#--#---#
---###-#-###---------#--#------#---##-##---#--#-####---#-#---------#---#--#----##-#---#----#----##--
#-##--#-#-#----##--#----------#--#---#----#-#----##--#----#------#-------------------#-----#--------
--##------#--#-###-#------####--#--#--#-#-#-----#--#-------###----------#------#---#-----#--#---####
##----#-#-##---#--------#------#-#------#-------#-#-##----#-----------####----#-------------#-#-##--
#---------#-#-#-----------##----#--#----#-----#----------###---##--#--####--------##--#-#-#-#-#----#
-#-#----#----#---#----#--#----#--##---------#--#---#-----#-#---#-----------#-#--#---####-#--##---##-
###-#---#-----#--#-#--#-#-----#-#--#--##----#--#----##-#-#--#---##---#-#----#-#--#-#-------#---###--
#---#---###---##-##-#--#-----#-#------##-##-#-###----------#--##---##--###-----#--##----##-----#--#-
--------------#-------#----###---#--#-#-##----#---##-##---------##-----##---##--####--##-#-##-##--#-
##------------#-------#--#----#--##-#--#-----#--##---#-#-----#-#-#-------#-#-##-##--##----##-#--####
##------#-#-##-#--#-#--#----#-#----#--#------#-#---##--#-###-###--#------##-----#--##-##-#---#---#--
------#---#---------------------------#---#---#----##---#------#----#-#--#------#----------#-----#--
#---#-#---###-#-##--##---------##--##----#--#--------##-#----------#-#-----#------#----####-----#-#-
#--#--#-##---#----#-###--------------##-----###----#--#--#----#-----#---#-##-------#-###----##---#--
#-#---#-#-#---#------#---##---##---##-#---#-#-#--#-#-#-----#-#---------#--###-#------##--------###--
------###-#----#---#-#----##-------#-------#----#-##----#-#--#-#----#-#-----#-----##--#---#---#-----
#--------##--#-##--##---##---------#-#--------------------#--#------#--###--#---#-#-#-------#--#---#
-#-#-#-#---#-----###-#--#--#--#------#------#----#-#-#--#-##-------##--##-----S-###-#-###-----##--#-
-#-#---##-#------#--#-------#------------###-----------------#--#--------#----###-------#-----###--#
-#-------------------------------#--##---#-##---#-##--#-----#-###--#---#---##--#--#-##-#------#---#-
-------#---#----#-#----#--#-------#-#--#-------#-#-----#-#--#-##---------#---##---##--#--------#----
###----#---------#----#------#------##-------##-#-#-#-#-#---#--------#-#-----#----------#---------##
------##-#---##---#--#----#--###---#---#------------#----#---##------###-----#-----#-##---#--#--##-#
-##--#-#-#---#---###-----###--#-------#######---#---##-#-----#-#--###---------##---#-##-#-#-#---#-##
-#----#--#--#-#----##--#####-#---#-#----#-##---#----#-#-####----#--#-#--###-------#-##-#------##--#-
#---#--##-#--------####-##---------#---#----#--#---#--#-----##-#-#-#--##----#--#----#---#--#--------
----##-#----#-#--#-###----#--------#-----####---###-#--#-#---#--##--##-#--###-#------##-#---##-#--#-
#-###-#---###--#---#---------#-#-#----#-#--#--#-##----#-#---##-#--#----#--##-##-#-----#---------#-#-
-#----------------##------#--#--#----------#---##-#--#-##---#-##-#----#---#--------##------##----#--
#-#---##--#-#---#-##----##-#####-------#--#------#----------#----#--#-#-----##-#-##--#-###-----#-#--
-----#-----#------#----#-#---#-##-###--#---##-#------##---------#----#---###------#--#-##-###-#---##
-#-------#--#-#----------#----#-----#---##-##-#-###-#----##--#--##--#---##----------#--#---#------#-
---#--##--##-#--#-#--##---#--#----#-----#-#--##---#-##-------##-------#-----##---#----#----###--##-#
#---##----------##-------#--##-#-----#--#-#--#----##--##--#----##-----#---#-#-##--#--#------#-------
----##--#----------------#--##-#---##--##---##-----#-#---#------#-##-#--#--#-#-#-#---#---#-###-##---
#---#--------#-----#-#---#-#-#----#---####-------#-#----#-#---###-----###-#---#-#-##-#---#-##-E--##-
---------#-###--##-#----#----##-----#--#--#--##---#---#------#----##--#--#-#--#-#-#--#-#---###----#-
-----###---#-----#-##--#-#-#-#---#--#-##---#------###----#--#-#-##----#--#--------#--#---##--#-----#
---#-###-----------##-----#--#---#-#-------###-##--#---#-##---##-#----#-##--#---#-##---###--#---#---
----##----#--#--##-#---------#--#----------#--#----#--##----------#---#---#---#-#------##-#---###-#-
-##----#---#-##-----##---##-#-#----#-----#--#--##--##---#--#-----##-##-##--#---#----#---------#----#
-----#------#---#-#------#---#-------#----#----##--#----##-#--#-##---#------##-#------#--#--###--#-#
##-#----#-------#--#--------#--#-#----#--#-#-##----#-###-#---#-----#-#--##---#-#--------##-#-##--#--
--###---#---#---#-###--------------#-#--------##--###-#---#-##----#----#-#--#-##-----##-######--#--#
--##-----------#-####--##-##-#---#--#--#--------#-##--------#-----------##--------------#-##-###-#--
---#-----#--#--#--#---##-#-#---#-##-#--#---#-#-###--#-#--#--#---#-------##---#-#------##----##-#----
-#--#----#-#----#---#-##-##-##-------#---##-#-###--#---------#---#--#-#-----#####-------#---#-##----
#---#-#--#-------#-#--#-##----------#--##-----#-----#-----#-------#--##-##----#--#-----#--#-##----##
##-#-----##----##---#----#-#---#-##--##----#---#--#--#-#--#---------#-#-#--------#--#-###----#-----#
-#---##--#-##-##-------####-----#-#---##---#-#---#-#-####-#---#--#-#####--#---###---##--#-#---#--#--
---##----#--#--------#------####--#--#-------#---------#--#-#------#-----###-#---#-------##---##--#-
#--#------#-#-------#-------#--#----##------#####-----#-------#-#--#---#-----#-#--#-----#--#--####--
-###-#--##-#-----##-#-#-#---##---##------------#-----#----------#-#---###------#----------#---#---#-
-----#--##-#-------#-#----###--#--#---#--###---#--#---##------#-------------#-----#----##-#---#-----
---------------#------#-#----#--#--#---##--#------#--------##--#----#--#---#-#-----###------#-#-----
#-------#----------##--#---###------#-#----------#---#----#--#---#--#----#-#-#-#---------#-----####-
#-#-#-#--#-#---#-##--#------#---#--#-#-#--###------#-##-###----------##-----#-------#---------#-----
-----###------##-###----###-#-----#-------###------#--#--------#-###--------#####------#--##-------#
---#-#--#-----#--#---#-#----##--##--#----------#-##---------#--##-----#---#---#----------#-#--#--#--
----#---------#--#---##---------#-#-##---#--##------#----#-----#-------#---#----------###-------#---
#---#-#---#----#----#-#-##-##---##--#---##-#----##--#--------####-----#---#-#-#-##----------##-#----
---#-----------------#-#--------#-#-##---#-####--#------#-----##---#------------------#-#-##---#--#-
-#---#-#---#---------###--##-#--#-----###----#--#----#-----#---#--#-------#-####-#--##------##-##-##
#---------#----##---#-###---#----#----#-#-#----#--------------##-----#-#----------###-##-----###----
--#----------#----#-#-#--#-#---##-####--#---#----#--#-#-#--#------##-##--------#----#-----##-#--#--#
-#----#-#-##--##-##----#####---#-----#---#------#--##--##---##-#--##-#--#---------#---####-##--#----
--#-#-#---##-------####---#-####--##--#---#--------#-----------#--------#-##-----------#--##------#-
--#-#-#-##---#-------###---#--#---###--##---#---#-#--###-----###--#-#----##--##-------#---#-#----#-#
-##-#----#-##-#---#--#-----------#-----#--#-#--#--#----##-------------#-#--##----#-###-#---#---#--#-
--#---#---#--##----#-#-#--###---#--------#-----#---###----#-------#--#--##--#-#--##-#----#---##---##
---##------#---##-#----------#-#--##-#---#-#---#-#---#-----#------#--------##----#--------#--##--#--
--####-----#-#-#--#------#-#----#--###--------##---#-----##---------#--###-------###-#----#---#-#---
#----------------##-------###-###------##-----------------#------#-#--#---###----#--##--####---##--#
-----#---#----#-#----#--##--#-#--#-#--#-#--##--##-#--#----#-###-##--#-----#-----#-----#-#-#----#-##-
-##-----#--#--#---#-#-------------##--#-----##--#---#-------#-##-##--##--##--#---#-----#------##-#--
--##--------#--------#---#------#----#-----###----#-----#--#------#-----#-###-#----#--##-------#--#-
##------#---##--------#--###--#--#--#--#----#-#-#-##---#-#--#---##---#-#-#-----#---#---#-#--#--#----
-#--##---##-#---------#-#---####----#---#--#--#--##--#---##-#---#-#------------#----#--#-##----##---
---------#####--#-#----------#--------#---#-#-##---###--##--#-##-#-###-#-------##-----##-#----###---
#-#---#-------##--##--#-##-##--##--------#----#-----#------##--#---##------##--##-------####--------
-#------##---#-------#--##--------#--------------#-##-------###-#-#-------####-------#---##--##-----
--###--#----#-----#--------#-#----#---##-#-#--###-##-----##------#--#----#-#------#--#--##--#------#
-----#-#-#-##--#-#-##---#----###---#---#----#---#-#--#-#--#--##-##---##-##---#-----##----#------#-#-
#-----#--##----#-##----#-----------#-#-#-#-#-#--------#----#--##----#--#-##-#----#-#-##-----##--#---
----###----------#-----#-#--#---#----##----#-##----##---###---#-#---------#--------###------------#-
-----#---------###---#-----####-----#--#-#-#-####--------##----#--#-----##-#-#--#---#--#---#--#--##-
-----#-------##-------#-#---###-----------#---#-#--------#---#---#---#----#-----##-#-##-#--#---##---