?diagonal=IfAtMostOneObstacle;
#-#----#-#-##-------#----#-#-----#-##------#--###-##--#-##--------#--#-#####--#-----#------##--#--#-
--#-#----#-#--###-#----##-#---#--#-#-#----#-#--#---##--#--------#-##-#----##-#--####-#----------##--
#-#-----#----##--#---------##------#---#----#---------##-#-##-###-------------##---#---##-#-#--##---
-#--##-#-----#----#--------#-----#---#-###--------#-----##---##-#-#-##---#-#--------#------##--#-#-#
-----------#-#-#-----###----------------#-----##-#---##---###----#------##-##-###--#-###---##---#---
-###-#----#-#--#---####----------#--#--#----##---#-----#-#-##----#--#--#--#--------####-#-#---------
---##-#-#-------#---##-####-#----##-#-------#-#----##--#-----###-##-----#-------#--#--#----##--#--##
----#---###--#-----#-#--##-#---###-###--###-----#-#----##----##---------#---###---#-#-#-#--#-#----##
-#----##-#--##------#----##----##--#----#---------#---###-#-#-#--#-#--##----##------------------#-#-
----#-----#-##-----#----###-###----#---###---------#-#---#----#-#-####--##------##-#-------#------##
#-#------#--##----#-#----#-##----#----#--#--------#-----#--#-##-----#---##-------#-#-#-##--#---##--#
#----#----####----#--#-##---#----#------##----##----#--#--#---#------#-----#--#--#---###------####--
----#-----#--#---#-#---##----#---#-------#----#-----#--------#-#-#--#-#--------#---#-------#---#--#-
--#----------#---##-###------#------#----#---#--##-#------##-#----#----#------#---#------#---##---#-
-##-----#---#-#-----#---#-------#--#--#---------#-##----##--#----#-#----#-----#--#--#--#---#--#---##
-###-##-----#-#----#-----##--##---#------#--#-------###--------------#----------#-##--#-------------
--#---#-#-#-##-#------#----#---------------#----------##------#----#--##---###-##--##----#----##-##-
-###-#-#----#---------#-------#-#-----#----#-------#------##-#--##----#------#---#-##--####----#---#
---##---------##------##---#------####-----##-#--#-#--##----#--#-----#-###---#---------#-------###--
--------##-###-#---#--#-###-#-##-##---#-#-----#--#-#-----#---#---##--#-------------#-#-----#------#-
-------#-##---##-##-#---###------#----------#---##-##-#-##-#-------##-#--##--------#----#-#-#-------
#--##-----#---------#---##---#----#----#----##-##--#-#-----#-##------##-------###-###----#-----#----
###---#----#--#-#-#---##------------##-----#----#---#-#----#-#----#------#-#--------##-#--#--#-#-#--
--#---####-#-----#-##--##-----##-#--#---##-##----#-----#---#-###-----####---#-#-------#--##--#-##---
----#----##--#-#---#--###--#----###-#--##---#--#-#-###----##---##-#--#-##----##----#-#-#-#--#--#-#--
----------#-#--#--#-#----###-#--#--##-##---------##----#------#-------#----#-#-#-##---#-#-##-###--##
#----#----##-###---#-#-#--#---#------#--#----#--#-#--#--##---------#-#-#---#--------#-----#-#-------
--#-----#------#-----##---##-------####--#-#-##-#-------#---#--##-#-----#--###-##-#--#--#-#---#--#-#
--------#-#------#-#--##---#---##-##--#-#----#-------###-------------#--#--#--#-#---#--##-#----##--#
-----------###-----#----#---------#--------#------##-##---#-###-----##---##----#-#----#--#---#----#-
#-------#------#------#-#-#-#-##----#--#--##---#----#----#----#-#--#---#####--#---##-----------###-#
###-#--#--#--#-#-##-##---##-#--------#---#-##-------##--##---#-#---###---##-#-#------#--#---##--##--
----------#------##-------#-##-------#---#----#--##---------#-----###-#-------##-##--#----#---###-#-
---#---##---##-#-----#-#-#--#--#-#-#------###---#--#-#--#---#----##--#---#---#----------#####-------
#--#-##---#-###---#---------#------#---##-#-----#----#----#-#-#-----#-###--#--#-#---#----#----#--#--
-#--#--#------#--##---#----------#--------##-##--#---#-----###---###----#---#----#-#----#----##-----
--##--#--##--#----#-#---##-####--#------##-#-##--#-----#---#-#--####--###--#---##-----###----#------
--#--#--------#----###--#------#-#--#-#-------#-##-----#-##----#---#-#-###-#--#------##---------#---
####---------#--#------#-----###-----##-#--#-#-#-#----------#--##---##---##---#-------#--#--#-#-----
--###-----#-#-##-#--#--##-#---#---#----#--###----#-#----##-#-#-#------#----#-#--#----#----#----###--
#-####------#-##-#-#---------#-#-##------##----##---#-##-#--#------#--#---##-#----##--###-#-##---##-
##--#####---###---#---#-###----##--##---#--#---##-###--------##---------#--#-#---#-###-----##-#--#--
---------#--#-#--#--#---#---#-#-#-#-#---#--#-#----------#----#----#-##--#-#----#-----##--#--------#-
-#-##---#-----#-------##-----#--##-##-----#-#----#--#-#####----#----#-#-#-#-###-----##---#--#----#-#
---#--###-#---#-###--#--#-##---#-##--------#-----##-#------#--#-----#---#-----#----##---#--#-------#
---#---#--##--#------##--#---#----#-----##----###--#--##-#-#--#---###---#------##-#-------#---------
-####----###---#--#----#-#--#--#--##-#-----#----#-##-#-##-##-#------#--#-#---#-------##-----###---#-
-----#--#----#-------------#----#--#------##----##----#---##-#------------##-#-##-##----#----#S---#-
--##---#--##--#####--#-#-#---#--#--##----#-----##-#-#--#-------##---##--##---#----#----#------#-----
--#--#---###-----#-#-----#---##--#--##-----#-###----#-##--------##-------#--------#-##-#-#-#-------#
--#-##-#--#--#--###-#----#----####--####-------####--#-##---------#----#-#------##-##------##---#---
#-#--#--#---##--#----#--#-#--###--#----#--#--##----#-#----#------####---#--#--#-----#-##-----#-##---
-#----#-#-#---#----#--#-------#---#--#--#---##-#--#-----#---#-#---#--#----#--#------------##-#--###-
--#--####-#--#---#---##----##--------###--##---------##-----#-----###-#-####--#-#--#--#-----#-----##
---------#-------##-#-------####---#-##-#--##----#-------------#--##---##-----#----#---#--#--#------
--#------#-#--#--##--#-#--####-#---#----#----#-----#---##-#------#-#--###---------#-----#--#------##
--------##-###-#----##--------------------------####------#-###---#---#---##--#--#---#------#-------
-------###--##------#-#---##---#--#-##----#------#-#--#-##---#-------#-###--#-E-------#------------#
--#--#--#---#----------#--------#--##-##----#--####-#--#-##-----#------#---#--#-----#-#-----#--#---#
--#-#-##------###-------#-----#--#-##-#-##-----------##-#--#----#----#-#--#-#-#--###-#--#----##-----
---#--#----------##---------#--------#--#--#-----#-##-#--#----##-##--#--#-#----------#-----------#--
##--##------##-#-----#--##-#-##--------##--#-#--##-------------##-#------#-#----#----##----##-#--##-
------##-#-#--#------#--#------------###---#--#-###-#--##----#--#----####----#----#---##--#------#--
##-#-#----##--#---#----#-##-#------------#-#-#####----#-###--#----##-#-#--#------------#-##---#--#--
-------#--------#--------#---#--##----#----##---#---#-----------------#-----##-##-#---#--##-#-------
---------###-###----#----##-#--#--#-----#--##-------###-##-##--#---#--###----#--###--##--#------###-
#-----#------#-#-#----#-#--#--#-#-----###--#--#--#---------------#-----#-##---#----------#-##-------
#-###--#---------#--##---#---#-----##-------------#-----##-#--#------#-##--#------#---##---#------#-
---##-##---####--------#-#-----#-####-#-#-----#--#----------##---#-------#-#--#---#---##--#-#-----##
---##---##-#-#-#--#-----#----###----#---#--#-#--#----#-#---#--#------#---------#-###--#--#----------
-##---###-#-#--#--##--#-###--------##------#----#--##-##---#-#--#-------------#--#---#----------#-#-
--#---#----#-#-----#---#-----#------##-#-##--#----------#-----#--##--##-------#-------#--##--##----#
--#--#-------------##--#--#-#-------##-#-----####-----------------#----#-##-#--###-##-----------##--
---##--------#--#-#-###-##-##---###---#-##-##-#-----#-----###--#---#--##----###-##------##--##-#----
-#--##-#--------##--##-#----#-------#-#-#--#---#---##----#-#-----#----#---#-###------------#-##----#
#------#-#---#-----#---#-#-#-----#--##--#--##---###--#--#---------------#------#-#-#---#----#--##---
#-#--#--------#-----------#-##-----##------###----#--##-##--#-----------#--#-##------#-#-#-#-----#--
#---#----#----##-##---##-----##---###---------#-#---#--#------#---#--##-##----------#--------#-#---#
#--#---#-----------#--#-#-#-#-------####---##-##-------##-#-------#--#------------#-###--#-#--#-###-
-#---#-#-###---#-#-#--#--#--#-----#-#--#----#-#-#-#---#--#-----#-####-----#-#----##-###-#----#--##-#
-##---##--------###-#-----####--#-##--###-----##--###-----#-#---#--##-#--#-#----#----#-#----#----#--
------#-----#----#-###--##-###----#----------#------#---##-#--#--###---------###----##--#--#-#--#-#-
###--------##--##------###-#---------#-##--#----#----------#--#--#---#-#-###----#-------#-----------
-----#--#-----------#---#--##-------##------#----#------#-#----#------------#--##-##------##--##-###
--##----#---#-------##--###-#-#--#-#-#-#--#---------#----#-#-----#--##---###--###-#-----#-#-------##
--#--------#-#-#-----#---##------#-#--------#---#-##-#-----#---#-------#-##--#----#-##--#---#-#---#-
#---#----------#--##-###--------##---#------#---------#-#----##----------------#----#---#--#--#-##--
--###--------#------##------##-#-----#--#----##----#-#---##--##-#--#-----#--#----#-#-----------#---#
#-##-######-#--#-#---####--##-##---#--#--#-##-------#-##-#--------#-#-#-##--#-------##-#--##---#----
--#-----##-##--#--##-##-------#-#--#----------#---------#----##--##-##--------------#-####-###---#--
#-##-#-#---#-------##--#-#-----------#----###---##----#----#----#-#--#-####---#----------#-#-#--#---
-------#---#----##---#-##-##-----#-----#---#------#----##--#----#-------#--#--###----#--------#-----
#--###---#--#-#-#--#-#-#-------#-------------##-##-#-----##--#-#-------#-#-----#--------#--#-##--#--
----#-##----##-#---#--##-#---#-##-------###----#-##-------------#------#-###----#--#--###---#----#--
#----#-----#----------#--#-#-###------#-##-----#-##-#---------#------#------------#-#-----##-##-#---
---##--#--#-##--##----#--#--##---#-#--#-#-##---#----#---------#------------------#------#-#------#--
-##-#--###----##--#-#-#---#--#-------#-------##---#-#---#-#-#---#-------#--#--##-#-#----------#--##-
-#--#--#-##----#----#-#---#-----------#-#----#-------#-----#---##---##--#----#-#------------#---#--#
#-#--#--##-#-----#--##----#----------#--##----#--####--###--#--#---#----#--##-#--#---#-#---###--#--#
-------#-------#---#---#--#-#---------#-#-#----#--#-#--#-----#-----#----#--#-###------#--###--##----