?diagonal=IfAtMostOneObstacle;
#----#-#------#----#-###--##--##-#----#-#------#--##-#--#--#-#-----#####-##---##------------###---#-
#--##-#----#--#-###-----#----##--#--#####-----#----###--#---###-#-----#-##----#-#-#-##----#-----#-#-
----#----------#------#----#--#--##---#--#-#-##-#----#----#--#------#-#--##--#-----------#--##-----#
##--------------#-#-#--##--#-#-##--#---#-------##-----#----######-#---------#----#----##----------#-
--##-#---#-#-#--#-#-#--##--#----#--#-#---##-#-###--###---##-###--##-#-#---##-#----------------#--#--
--#-####--#---#----#-------#--#---#---###------#-------#-#--#--#------#-------##-##-###-#--#--#-##-#
--##----##--###--#-#--------##---#---##---##-#---#--#--##-----#-----#-#-----#-#-----#--##---#--#-#--
---------#----#----#-#---#-#--##----#--##------#--#-#--#--##---#----#-----#---#--------#----####----
---###---------#-##----#-#---------##-------#---#-##--#---#-#--#---#-#--##----##-#------------###-#-
-#----#-##--#----###-#---#--#----------####-#--###----#--#--#-#----###-#----------##----#----##---#-
----##-#-####-#-#----#--#----##-##-#---##-----#----#--#--##-#-----##------#---#--------#-#-------#--
###----#----##---##--#--------#--#-#-#-#-#---#-#--##------##--#--#-----###--#-------#-----#-##-###-#
--#-#-#-#-###---##--###---####----#-----------#-#---##----#----##----##-------##-------#--#-#----##-
-----#-#-##-----#---#--#---#--#----##----#----#---##---######----#----##--#-#-#----#-##-##---#-----#
#-#-------------##----#---##-#-----#-###--#-#---##---####----------#--##--#--#---------------#---##-
#----#------#-----#-#-------#---------#-#---------------#--##--#--###----#-####-----#-##-##--#-#----
#-#---#-#-----##--------#---#-#--#----#---#--#-#------#--#---###-----#------#------#----------------
------#--#--------####--###-----#-------------##-#---###-#--#-##----##-##-----##-----#--#-------#---
##---#-#--#--###-#------#-####--##-#--#----#--#-#--#-#----#------#---#--#-#----##-#---#-------#-----
#--#-#---####------#-#-###-#----#--####-##-------#----###--------###---#----###-#-#-------#--####---
-------#------#-###--###-------#--#-###--#----#--#--##----#-------#-#-----#---#--#-#--#--------##-##
--#--#-------#-#---#------------#----#-##-#-#####-#----------#--#----#--------#---#--#---#-----##---
-#-----------##--##-------#---#-#--#-##-#-------#---#-##----##-----#----#--#------#-----#---------#-
###----#-----#-#----#----##--##-#-----#-###--#-##----#----##-#----##-#-#--###-#-##---##------#---#--
-------#--#-#-----#-#--##--#-###--#------#-------#---#-#---#-#--#--#---#---##--##--#--#----#---##--#
----##-#-#-#-----#-##-###----##-#----#-#---##-------##----#--#---##--#-----#-#-------##----#----#---
---###----#-#--##----#-#####-#----##--------#-####----------#----##---------------#-----------#---#-
-##--#-#---#--##----#---#----####-----#----#------#---#####--#--#-----#----##------#-#-#----#-#--#--
#-#--#-#---##---------#-----##---#----#-------#-#--#---##--#----##-##--#-----#--###--##-###----#----
-#-#----#---#-#-##-#-#--#-----##---#-#---#-----------#-#-#-#--#-##---------#---#--#-#--#-#-------#-#
---###-------##--#--#--#----#-------#------------#-###--#---###---#---------##------#----------#-#--
#-------#--#--#------#-#--#####-#-#--#----####--#---#----###------#-#-#----###---##-#-#-----#---#---
--###-#------------#-----#------#----#--##------##-#-##--------##-----#--#-#-#--###---##--#-##-#----
--#--#-----#-##--#--##-#-#-#-#------#--#---#--#-##---#----###---#----#-##-#----###---##-#####---#---
--#---##-##---#--------#--###-------##-###--#-#-#----##--------##---#---#---#---#--##---###---##-#-#
---##-#-#-#-----#--#---------#---#-#-#-#---##----#--#-----#-#-----#----#---#---#---#----#----##--#-#
--#--#-##--#-#---#--##--#--##-------##-##---#----###-#-#---#-#-#####------------###-#------##---##--
------#--#-#--#--#-###------######-##-##---#-##--###-#-#-###----####-------#-------##-#-#------##-#-
-#-##---#----##--#-##-#-####------#----#-#---------#-#-#---##-#--#-#-###-#---------##----#-#----#--#
---##--#-#---#-#####-----#----##--#-#-#-#---------#-----------#--#--#----##-###--##---------#----#--
--#-#--------#--------#----#-#--#--#-###--#------#-------#----##-##----#-##---#-------#-----##----#-
---#--#-#S-##--#----------#--##------#-----###--##--------#-#------------#-#-------###-#-----##-##-#
-----#--###---------------#-----##---#------------#----##-##---#------##--###----#-#------#-#----##-
---##--#----##-------###------#---#-#------#--#--------##-#----------#-------####--#----------#-#-##
#--#--#--#---##--##-#-------------#-#--##---#-#----#--####-#-##-----##------###--------#-------#-#--
--#-----#-#-#----##-#-----#----------##----##--##---##--#-#-----#--#-#-#-#------#-#-#--------#--##--
----##-#-#----#-#----#-#---#---#----##--#-##------#-----#-------#------#---#---#-###-##--------#----
--#--------###--#------#--##----##------------#--##---###--------#---#-#--#-#--#-#---#---#----#-----
---#--##-----#---#-----#--#-##------#---------------#-#------#--#--------#-###-------#-#--#--#--#-#-
-##-#---##---#----##-#-#--###----------#-----------#---#---##--#---#--####--#--##-------##------#--#
-#--#-----#-#-#---###-#-#-#--#-#-##-#-#------#---#----#--#-----##----#----###-#-----#-##-------#----
---#--#--##-####-#------#---#------#-#-######-------#---#--##-----#---#--#-#-----#-#---##--#--#---#-
##--##-#------------#------#-#-##-----------#---#---#---##-#------##----#------#-----------###----#-
----#--#--------#-###----------#-#-------#----###-------#-#--#--------------##--#---##------#----#--
--#-#--#--#####-#-##-----#-#---#---##--####-----#--##-#-####-#--#--#-##---##-#--#--##---#--##-#---#-
##--##-##-#---------#-#--#-#--#---##------#-----------#--##-#---#-#-#-----#---#-------#---#-----#-#-
#-----#-#--#-----###--##--#-#------------#-#-#----#-##---------#-#----###-###------#-#----#-----#-#-
##-#---------#------------#----#----#----####-#--#-#-----#----#---#--------#-------#----------------
-------###-----#---#----------#---####----#-###-#-----#-#-#---##--#-----##---##-----###-------------
#####--#-#-------##------###-#-#--#---#-#----####--#-#------#---#---##--------###-#----#-----#-#----
--###----#----------##--#-#---------#-#-##-#---#-#-----#--#-----#-#----------##---------#--#-#---#--
-#-#-##--#--##---#----#-#--#-###------###-----#-----##--#----#----##----##-------#-#--###-#------#-#
###-#--------##-#-------#-#-#--##--##---#-#--##----###---#---------##------#--#-----#---#----#--###-
#---##--------#---#-#--#-----##-##---#-#-#-#---#-----#-##---######-#----#-#####-#---##---------#----
#-----#-#----##---#--#-#--#-##--------#--#--#--##---#-##-#-#--#----#---##-####---#-----#-#-#--##----
#-----###-##--#-#--#-#-####-#----#---##-#---###--#----------#-----#-#-#---------#--##-###----#---#--
---##---#----#-----##-#-#--------##----###-##-----#--#--##-#--------#----#------#--#--------###---#-
---#-#-----------#--#--###-##---#---#----#----#-#-----##-#-##-#---#-#-#----#-##-#------###--#--#--#-
#-----###----#-#-#----##-##-#-#---##--#--##-------#---#---#--#-#-----#----------#-#-----#---------#-
-----#--##-##--#--#-------##-------#-----------###--------#-----#-#------#-------##--###--#----#--#-
-#-#--#-------######-#------###-#-----#----#--#------##---------##--#-#--#--#---------#------#-#--#-
--#--##--##-#-------------#-#---#---#----------#-####-#----#-----#--#--#---#-------##-#---#####-----
#------##-####-##--#-#-#-#-#--#-##---##-##----#---#--##-------#-#####----##---#---#-------------#---
---###-------#-##------#---#-##--#--------###--##----#--#-#-----###---#---#-#----#----#----#-#--##-#
---#--#-----#--#-#------##------------##-##----#--#----#-------##-#----------##----##---#----------#
#------------##-#------####-##------------##--#---#----#-#----------#------#------------##------#---
-##----#--#-----------##-#--###-#-----##-#-#--------##-#-------#---###--#-#----#------------#----###
-#---#----##-#--#--##---------#-#--------##--#-#---#------#-#---#--##-#--#---#-##-------#-#-----#-#-
---#----#-###---#--#----#----#--#-----------##------#--#---##-##--##----#-------------#---##-#-----#
-#------#---#-----###---#-#----#-#-----###-----#-----#----##-#-##----#----------#---#-----#-##---#-#
-----------#---------#--#-#---#--###--#-#--##-#--#----#---#-#-###--#------------------#---#-#-------
-##-##--#------------##--#------#--#####-##----#-----#-------##--##-#--#-##-#---###---#-##-####-##--
--------###----#------####-------#-##---#------#---##-##------#----#------##-#--##--#-#------##----#
#----#---####--#--###---#-------##----#-#---###----------------##-#---------#-#--##--#-#------#---##
-------#####-#----##-#-###-#-------##---#-#---#-#-#------------##-#-----#----#--#-----#--##---------
--##-#-------##-###------------##-##-##---#-#-------#---#---#-#---------#-##--#####--###----#----#--
#----#------#--#-------------####-#-#-##--#---#----##--------##--#---#------##------#---##-------#--
#--#---#-----##------#---------#-#----#-#-#---#------------#-#-#--###-##-##--#--#---#-##-#--####----
--#-##-#---------#--#----#---#---#-#----#------#---##--##--#---#-#-#----##------#---#--------####---
---##-#---##--#---#-----##---##-###---#-##-#-#--#---#--#----#--#----#--##---#----#----#---###-#-#---
-##-#--------#-#--##--------#----#---##--#--#--#---#-#-##------#----#-----#----##------------##-####
-##-------#-----##------#-#---#--------#--##---#--#--#-#---#----------------------###-----###----#-#
##-#--#-#--#-####----#-#--------------#-#-------###----#------#-------#---#----##-----#------#-#-###
------#--------#-----------##-#--#-------###-------##----------##-#--##-------#---##----##------#--#
#---###-------#----##-#-#------#--#--#----#--#-------------####---#-##--#-----#-##--###--#--##-#-##-
--#---#-#-#-#-------##--#---####--#--#--------------#---------##-#--#----------#-##-#--#--#-------#-
-------#--###----------##-------##-#--#--#---##--#----------#----#---#------------#----#--#---#--#--
##-#---#------##--#---##----------------##-----##----#-#--#----#-#---##-#--------#-#--##--#---##----
--#--##--#-##---------#-----#---#---#----#-#-------#-###--#--------##--##---#-#---#-#--#-#--#---#--#
-#---###-#E----#---#----#--##----###-#--#------#--#----##---#-##---##----##---#--#-------#--------#-