?diagonal=IfAtMostOneObstacle;
-##-#---#--#------#----#-----##--#--#-##-##------##-#---#---#-#---#---#--#-#---#---#-#---####-#----#
-#---##-#--#-#----#---#----#--#-----#---#----#--------###-----#-#---#-#---#-#--#---#-#-#--#--#-#-##-
-------#-#---#--###-#--#---#---#--#-------#--------##-#-##----###-----#-#----#-#--#----#-#--#--#---#
---#-#-#----#-#####--##-##----#--#-#---#---#-#----##-#-------#-----------#--#-----#---#-----#---#-##
-#-----------#----#-##------#-------#---#-#-----##---#-#---------#-------------#-----#----------###-
--#-#-#--#----##--#---------------#----#--##----#--#--##----#-----#----#---##-----#------##-#--#---#
#--#---#-#---##-#------------#-#-#---#---#----##--##--#---#-##---##------#--#-#-#-##------###-----##
----##----###-----------###-#--#-##-#-#---#-#-##-#-#--#------#-----------##----------#---------#----
##-----#--##-----#--#---#-----#--##-------------##----###-##--#-#-------#--#-#-----##-###---#-#-#--#
--#-#--##-----#-----------#----#--##------#--##-#-#-----#---------#--#--##-----#-#------#---------#-
-#-#-----------#---#----#-#--##-##----#-#---##-------#--##---#-----------#--#######---####-##-#--#-#
#-##-#---#-#-#-##--####---#--##-##-----#--#-###---#---##--#-#-#-#--#-----##-------#---#----#-#--#---
##--#----#---##-----#---#-#####-----#---##--#------#---##-#-#--#----####-----##------#----#-----#--#
-------#-##-#-#--####--#-------#-#---#-----#------#---#-#----#------#----#-#-##-#------#----------#-
----#--#---#-#--#----#------#--#--#------------#------#--#--###--------#-##---##--#-#---#-##--------
----#---------#--------##--#-#---###---#--####-#------###-##--####-#-----#---##----#-#-#-----#---#--
--####-----------#-#-#--###---##-#--#----##---##----#--#---#----#-----#----#--------#-#--------#---#
-#-#--#----#---##------------#-------#--##--#--#------##--#-#-#--##--#-------#-#-#---#--###-###-----
------#-------#-#-#------##----###--#-#--------#--#----#---#---#------#----------#-##-#-#-##----#-#-
--#---##----##-#-#-#-----#-------##-##--##--#--#---#--###---#--##------#----#--##-#-#-------#--##--#
------#-#---##---------#-#-#-##--#-#-#---##-#-#-#--#---------##-#--#---#-#---------###----##--#----#
------#---#---#----#-#--#------#-###-#-------##----#--------#------##--##---##------#--#--#---------
-###-#-#---#------#-#-----------##---#----#-##-#-----#---#-#-----##-#----#---#-#--------#---#-------
--#--#--#--#-------#--#-#---#--####--##-----#---#-#-#--#--#---#-------#--#----##-----#-------#-----#
----#-----#-#--##----------#--#####---------##-#----#---#-#-----###--##---#--#--#-----####-#-------#
-----##---###-#-------#-##---#--#----#-#--#----------#--#-##---#----#-#---#-#-##--#-------####---#--
---#--#------#--------##--#----#-#-----##------#-##-##-#--##--#-##--#--#---#-###-#--#---#------##---
-----#--##-#------##--------#----##-------#------##---###--#--------##-----#-----##-##-------#---#--
----#--#-#-------##---#-##-#-#-###---#-##--#-#--#-##--#--####--------#-#-##-#----#---#--#-##---##--#
-#-#---##--##-----#--#-##-#----###---####-#----#-##----#---#-##--####-----#--#-#---##--#--#-##-----#
--##-----##--#-#-#-----#--#------#-------#-----#----------##-----------#-------#---####----#----#---
----#---##--#-##--#------#####-#-----------#-#----------#--##--#-----#-#---#-##----#-#--#-##--#---##
###-------#--#---##-----------#-----------#-#-----#------#---------#-----#------#-----#----#----#-#-
---##-----#----#---#---------#---####-------###------#---#---##----#----#-------#---------#--#-----#
------#-#-#--#-##-#---#----------#-#----#--##-#-#--##--##--##--#-----#--------##---#-#--#---#-#-----
--#-##---#-----#-#-#-#--#-#-#-------------#-#-#--##---#----#--##---#-#####----------##----------####
-##--##-----#---#-#-----#---#-#-#--##-------#--#-#-------#--------#--###---#---##---#--#--#-#---#-#-
--#-----------#----#---#--------------##-##----#---#--#--#-##---#---#--------#---------#-##-#-#-#-#-
-----##---#-#----#------##---#-#-------##--#--#------##-#------------#---##-##-#-###-------#-#-###-#
###-###-##---#-----------#---#-##-----#-#--------#--#---####--------#-##----##-#------#---------####
----#---------#-###--#--#---------#----------#-##--#-###--#-#-#-#--#-##-#---#------#--#-------------
#------##-#--####--##-#-----##-#------##-#---#-#-#-#-#-##-#-####-----#--#--##-#--#---------#----#--#
--#----##--------#--#-----##-------#--#--#------#---#--#--#-#-#--#-#-#-#--###------##-#-##-#-#----##
#--#----#-#-#--#--##---#--------##-#--#-------##---------##-##-----------#-----#------##----#-#-----
-#---###-#------#---###-#--#-##----#---#--#--###-####-----#-#--------#---------##-----------------#-
-#--#--##-------#-#-#-------------#--#--##---###--#--------#--#-------#-#---#----####--#--#------#-#
#--#----####------###----------#--------##--------#-#-##-#-#--##-------#-------#-#--------#-#---#-#-
#-----#--##------#-##-----#----#----------#-------#--#-#----#-#--##-#------------#-#-----#----------
-----------#--------##----#-###--###---##--#---#-###-#---#-----------#-#----###--#-----------------#
#-----##----##-##-----###-----#--####--#--#---#-##-##---------#----###--#-#---#-#-#---#-#-#-------#-
----#--#-#-------##-----#-----#-----#---------##--##--#-#-------#------###-#-----#--##------#---##--
---#---#--#---#--#--#--#-#---------#--#-----#-#--#-----##------#-----#---##--##-###-##-#-#-#-----##-
--#-#-----------#--##--#-###-#------#-------#---#--#----##----##------#--#-#--##---##-#-#---------#-
--####-#---------##----#-#--##-#---#--------###--#---##---#-------#--#--##-#-----#--#--###------##--
--#----#--##------#--#----##-#-#--#-#---------#-----##-----#####------------#-##---#--#-#----#-#-#-#
-----#---#-#----#---------####-#-#----####-----####--#-#--#---#-##-#--#-####-#-#-------##----#---#--
###----#--#-##---#--#---------#------##-------#--#-###---------####-#-#---####-#-----#-#----#---#---
----#--#---------#-----#-#---##--#----##---#---#--##---#--##----#-#--#-#--#-#-##-----##-#--#----#--#
##----####-#---#----------#---##-#--#---------#----#------#-#------------#-------#----#--#--------#-
#-----##-------------#---#-#--------------#-##--##--#-----#--#--#------##-----------###---#---#-#--#
--------#-------###--#---#--#----#-#---#-##--#-##-#-----#----------####-#-##-------#-##-#-------##--
--#--#--#----#----------#----#--------#----#-----##--##-##-##--#---#-#-----------##---#--#---##-----
-#--#----#-#---#--------#-----#----#--#--##--#----#--#-#----###---#----#---#----#---------#-------##
------#-#---##--#---#-##------#--##-#-#-#----#-----#-#---#-#-#----#---#####-#--#-----#----#--##--#--
--#-#---#-#---#-#----#-##--#------#-#-##---##----#---#---#-#-#------####---------##---#----#--#--#--
#----------##----#---#-##------##-#-#---#------#---#-##--#-------##-#-#-------#-----#-----#-#---#---
#-----#----##-#-##-##-##--###-------#----#--#---##-----#-----##---#----#-#--##--##-###-------#----##
####--#--S-#-#--------#--##------#-##----#-##--#--------#-#-#---#-#-----#-------------#-#-###----#-#
##-------####-#-#---###-###---------#------#--#-##---##----#--------------#-#------#-#-#----###-----
------------------#-----##----#-##-#--#-------------##----#-##----#-###-##--#-#--##------#---#-##-#-
#---#---###-#---#------#-##----##---#-#-###-#--##-----###----#--#--#-#--#----#------#------##-##-##-
----#-#---#-#---#---#-#------#------##-#---#-----#----#-#---###-#----#-#----#-#----#-------#-#------
---##-------##--------------#--#---#-#-##-#-----##--#-#-#--#--#-----------##--------#------##-###---
--#-#-#--#-----##-###------------------#------##---#-#--#--#---#---##--#-##----##-#--#-------------#
------#-##---#-#--#--#--#--###----#-#---#---#----#---#-#--#-#----##---#-#-----#--##--##-------------
#-##--#-#-------###----##----#-##----#----------##------#----#-------##-##---#-----------#---#---##-
####-#-##--#-------#--#-#--#--##-#-#-----##------------------#---##-----#--#--#--###-------#--------
#---##-#--##-#--#-----#--#--#--###---#--------#---###--#-#--##---#--#---##--#--#----#-#---#-#--#-#--
#-#-#--#--##----------#--#------##--------#-#-##--#------##-#-#---#-----#-###--#--#--#--------###---
-#-#---------##-#-------##--#-------###--#---##-#----------####----##--#-##-##--#-#-------#---#---#-
---###-#-#-#--#-##---#-----#--------#-##---#------------------#---##----###---###-##-##--##--#-#----
#-##----##---#--#-#--##------##-#--------------#--##-#-#--#-##---------##--#-#-#---#--#-##---##---##
-###-#--#-##-#-#-##--------#-------#-#---##------#-#-####--#---------###-#-----##---#------##-----#-
#---#---##-#--#-#---###--#--#---##-------#-##--#----######-#------#-#-#---#-##--#------#---####--##-
#----#-----#--#----#---#-#---#---------#-###-###--#-#------#----#--------#-###---#-#-#----##--#--#-#
-#--#------##---##-#--------##----###-#-#--####----#-----#-###-##----##----------#--#-#----#---#-#-#
--#------#-#------#-#-#-#------##--#------#---#--###----#---###--##--#----##-#----#------#----------
--##---#----#--#-----###--#-#--#-###----#-----#-#-------#--##-#--#--#-#-#--#--------#-##-#----------
#---##-----####-----------#-----#------------##-----#-##-##---#---#---###---#------##-----#----##---
--#-----###--##-##---##--###----###------####-#-##---#--###---#-------------#-##--#-#----------##---
-#-----#--#-#-----#--#------#-#--#---#---------------##----#-#-#---#--#-###-##---##------#-###---##-
#-#-#--########-#-###-----#-#-#--#---##-##-#---#----##-#--#------#---##---#-######------#--#--###-#-
#-------------###E#-----#-##-#--#-#-#--------#--##------#--#-#-##----###---------####-#-------#----#
#--#----##-#-#-#--##-#--#-----#---#-#------------##----##-----##-#--#---#------#--##-#-##-----#-##--
#--##----###-#----###-----#-#-##--##-###-----#--###-#--#--#-###----#-##----#-----#-#-##-#------#---#
---#-##--#--#---#--#----#-#--#--##--#---#--##--#----###-#-##----------##-#--#-------------##--#--##-
#-##--##--##-#-----##-#----#----##------#-####----#---#-#---##----##---#-#-#----#-#-#------#---#----
#-----#--#-----#--#-----###---###-#--#--#--#--#---#--#-#-------##----#-#####---#-----###-#-#-#-###--
---#----#---#-#---#-##-#-----#----#---------#-##---------#---------#-##----#-#-----###--#-#---#--#-#
------------#---#--#-----##-#----#--#-#-#-#-#-#-#--#--#-----#--#-##-##-#------#--#---##-#--#-#------