?diagonal=IfAtMostOneObstacle;
--#------###--##-----#--#-##-------#----##--#----##--##--#-#-----##-----#--##--#-#----------------#-
----#-----#-#---#-##-###--#--#----##--#------#----#---##--#-#-----###---##-------#---#--##-##-#--#-#
--###-##--#--#----------#-#--#--##-#---###-#--##-#-#---###---##-#####---------#----#----###-------##
---#--#-###--#-##--#-###-------##------#----#---#-###-----------------#-----####-----#-------#---#--
---#---------#--------#----##----#####----##-#-#---####-#--#----#--##-#---#--#--##-#--#--#----##--#-
-#-#-----#----#--#--##-------####------------##---##---##-------#-----#--###---##-#--##----------#--
-##-----#---------#--#----#--#------#-#------#--##-#---##---##-#-#-###-#---#-#----#-##---#--#----#-#
#--#--#--#---##----#-#--###-##--#-##----#---#--##----##----#------#------#--###--#--#-###------####-
-##---##-#----#-----#----#--###--#-##---#----#----##---#--#---#-###-#-#---#-----#--------#------#---
------#---#-#---#-###--#----#--#--#-#---#-#-----#-#-#---#--#-----------###-##-##-----#--------#-----
------##-------##-##----#----#---#-------------####---#----###---------#-##-#-##-------#---------#--
-----##--#---#---#----------------###-#-##--#--#------#--#-#-#--#---##-#-#-#--###------#---#-----#--
--##--------#---#-#-#---##--#--#--#----#--------#----##------###-#-#--#---#-----#--#--------###-#--#
-------------#-#--#----#-----#-#--#-##--#-##-----#--#--#--------#---#---#----#----##-#----#-#-#-#--#
--#-------#---#----##---##-##----#--###-----#--#-----#--#-#--#-------#-------#------#--##---##----#-
-##--#-#--#----#---#---#-#---##--##--#---###----###-------#---#-#---------#-##----#---#-#-------#-##
#--##---#-----#-##---#--#---###-#---#--------#--##-#----------#-#-##--#---------#-----#-#--#--#-----
#-------#------#-#----#-#---##--------##-##---##-##---#-#-##--#----##-##-----###----#-#--#--#-------
#-#--#----##------##--#--#--#-####---------##---#------#-#----#---------#----#-#--##--#--#---##-----
-##-##------#-#--#-#--##--#------#-----##-----------#---#------#---##-##---#--#---#-##-#------##----
-#----#---#--#------#-----------###--#-#-#----##-#-#---#-#-#---#--#-#--------####--##-S-####-----###
--------#-#---------#--#---------#----###-------##-------#---##------#------#-#####--------#-#-#--##
---#----#-###--##-----#---#------#-#--------#--#####---#-#------#--#-#-----#--#------#-#---#--------
-#--##----#-----#-##--##-----#--####------#--#----#------#----#-----#---#----#-###----##------#--#--
----#-##-##-##--####-----##----###-##--#--#--#---#---#-##---#-##-#-----#-#---#-#--#--#----###--##---
---##-##-----##--#----#----###----#-##-##-#---#---#-------#-#--#--#--#----#--#-#-------------#-#--#-
------------#----##---#-#----------###--#------#---#----------##----##-#-#-#----#------#------------
##------------#----#----#----##-----#-##-#-#--#----#-#-#-#-#--#-#---#-#-##-#--#-----###---#--##-----
----------#--#-###--------#----###-#--#--#---##-##-------##-------##-#-#-#----##-----#-##-#-------#-
-#-####-#-##--##-#---##---#-----#--------------#----##---#--#---#-----#-----#---------#-------------
-------##--#--##----------------#-#-#-#--#----#--------#--##-------------##---#------#-#-#--#-------
----#------#----#-#---#--####------#----#---##----#-#---#-#---#----#----##-#####----#-#-#--#--#-----
--#-#----#-#--#------##--#-#-#-#---#----###---######-##--#---#------##----#----##----#-#--#-#---#---
#-##---#-#-----##----#--#-##-##-------##--#-#----#--#-------##---#--#--------#------#-#-##----#--#--
-#-#----#----#----#---#-------#-----#---##------#-#--#-----#-#-#--------#------------#--##-#--#-----
--#--#---#--#-###----------####------##-##---####--#--#-#-#---#---#-#--#---##-----#----#-#--#--#----
----###-#-#-#---##---#-#--#------#-#---------#-###-#-#-#--##---#---#--#---#------#-##-----------##--
--#-------------#--#---#-----#----------#-#----##---#-----##----#---#-#--#----#---#-------##---#--#-
##---##-------------------------#-----------#-------#--##--------##--#---------------#---#---#------
#-----#-----------#--#--#--#--##--#--#--###-----#-#-#--#-----#---#-#--##----#---##-----#--#------#--
-#--------###---##-#-------#--#----#----##-#----##-------#-----#-#---##--#-------#----#-----#---#-#-
----#-#-#---##----#------##-#-#----##----#------------#----#-#---##---#-#-----#----#-#--##-#-----#-#
--#---#--#--#-#-##--#--#-#---###-#-##--#---###-##----##----#-----#-#------#-##----#------#-#-#-##---
---#----##----#--------##--###-----#--#------#-##-#-#-##-##--###---##---##----#-##-#-------#-#---#-#
-#####-----#-----#--###---####--##-#--#------###-----#-#---###----#-#----#--####-----##-------------
#-#----#--#--###-#-#----##-#-###-#-------#-------#--#----------##--#--#-#-----------#-#--#-----#-##-
#------##----###-------#-#-#--------#-#--####---#-##---#-###----------#--#-------#----##-#----##---#
#-#----#--###----#------#--#---#-#-#-------------###--#---##-----#----#---##----#-----#---#-#-#-#---
-#----#-#-#-------#-##-##---#-#---#--###-----------#-###---#---#-#------#--#-#-----------##---##---#
###----#---##--#-##--##-------#-----##--##-#----#---#--------##----#-#--#-##--##-##-------#-#-------
-#----#--#-#-#-##----#-#-----#-#-#--##-#------#--####-#-#--#---#--#-#---#--#----##----#---#----#----
#---#-#-----#---#-------#-#--#------##------#---#----###---##-----#-------##-#--#-#---------###--#-#
---#-#-#---#--#-##--#--#-#-#-#---##--#-##-###-----#----#---------#-##--#-###----###--#-#-#--#--##---
----#-#----##-#------##--#-#--##-#-----#--##--##-###----####-#-#-#--#--#----------#--#--#---#-----#-
-#------#--##---###---###-----#-----#-##-#--#-#------##----#----#-----#---#-#####-----##-#---##--#--
##-###---------####--#--#-----#--#--#-#--##-#-#-####---------#------##-----#-#---------#---#-##-----
-#-#---------#-##-##--E-#--##-----#-#-#-##--##-#--#--#-##-----#-#--#-----#--###-#---#---#------##---
#----##----##-----#---#---#-#-----#----#--##--##-----##--##---#-##-##--##------#--##--#--#------#---
-----#-#-----#----#--#--#--#---#--#---#-#-#--###-----#-#-------#-#-#-#--##--#----#----------#--#----
--#-##-----#-#---------#--##--#--#-------##-#-------#--###--#--#------#------#-#-------#--#--###--#-
--##----#-------##-------##-##-#-------#--#------#--##----#--#----#--#-###-#-#-----#--##--#----#-##-
--##-#------##--#----#------#-----------#-----#---#--#-#------#-----#----#-----##-#-#-#-#---#--##---
-#-##-#-#----#----##--#-#------#-#-##-#----#-###-----###---#-###--##---------##---#--#----#--#--#---
-#-#---#--####-#----------#-#----------#-----##---------#-####----#--------#---#-#--#-#----#------#-
---#-##-#-#-#---##--#--#--##------#------#------##----#-##--#----##----###-------###--##-#-------##-
#---#--#-#-#--#--#-##-##-##-#-#---#---#----------#-###---#----##-#-#-##----------#--------#-----##--
-##--#-#---#--#----#---------####--##--#-----#---------#-------#--##-----------#-##---#-##-#--##--##
-#--##-##-#--##--#-#--##-#---#-----##---#----------#-----##-#--#---#-#-----#-----------#---#-#---#-#
-----###-------#-###-#-#--##-------#-#--------#--#---#-#--##-#---#-#------#--#-#####-#-##-----#---#-
-#------#--#-#-#-#-------##------#------#--##----#---#---#----------#--#---#-#-----##----#-###------
##-#-----#-#---------#----#-#-#--#-##---##-#----#-#------#--#---#-#-----------#--##--#-----#-##-----
-###--#-------#-#---#-##--#-----#----#----##---#--##-#-#---##---#---####-#-------#---------#----#---
-------#---##-----#-#--#---#-#-#-#--#--#--------#-#---#----###----------#--#--#----##-#-##-#--##--#-
-#-###-----------##--##--#-#--#---#--##--##-###---#---------##------#--#-#--#-#----#--#-#--#----##--
---------###-#-##---#--#---#---#--#------#---#------#------#-------#---#---#------#---------#--##--#
-#---##-#--#-----#--#-------##-#----#--#--##--#-----##--#-#----#--#-#-#--#-#--#----#-#-##----##-###-
-#-#-----##---##-##-----------#-###----#-----##-#--###---#-#-------#-#-#####--#---##-##------#--####
-###-#-##---#-----#--##---#--#---#---##---#---#-#--#-#--#-###----------####------#--###---#-----#--#
-----#-#--###-----------#-###-#--------###-------##--#-------#--#---#-------##-------##-#-----#---#-
-#-------------------#####--#-#-#------#--#----#---#---####--##--------#----###-----###-###--#-#-#-#
----#--##------#-#-#------#-##-#----#---#-#-##-##---------#-#----#--#----##------------#--##-#-#-##-
---#----#-##----#--#---###---------##--#-##------#-##--------#-#--#----#-##--###----#-#-------#-##--
------#--------#----##--#-#-#---------#-##-##---#--#--#-##---##-#----#-#--#--##-#---#----#----------
#----#--#--#---#------#-----###--##-#----------###-##-#-#-##---------#-#--#-#-#-#---#-#-##-------#--
----#---#-#---##-----##----#-------#---#-#-#----#-#-#-#-#-##------------##----#-#-#--#-##------#-##-
--#--#--##-#----##-##-----------#-----#-------###---------#-#-#-------#--#----#--#--#---#-##---#---#
#----#--#-#--#----#---#####----#-----#-#-#----#-----###---#---------#-#------#--#-#-#--#----##----#-
-----#----##--#-#-#--------#------#----#------#-#--#--#--#-#--#-#----##------#----#--##-#---##-#----
#-----#--#---#--##------#-----##-##--####--#--#-##-#---#--#------#---#--------#-#---##-------#--#-#-
--#---#---###--#-#--#---#-#--#------###--#----##-------#-##-#-##----#-#-------###-#--#--#-#-####---#
#-------#-#-#------#----------###-##-#-#----#----#---#----#--------------##------#-##--##--#---##-#-
----#-----#-----#---####--#-#-##------------##-##--#--#-##-#---#-##-----##----###----#--#-----#----#
----------#-#--------#####------#-------###----#---#----#--------##-#----#---###-----#--#--###--##--
----#--##-----------------####-###--##---###-##-----#-#----#--#---###-------#-------#-------#--#--#-
--#---##-#-----###-#------###---#--#--##-----#---#-------#------#--###---#-#----##--#----##---#--##-
#---#--#-##------#-------#----##-#-----#----#---#--#--#---#-----##---#---##-#---#--#--------#------#
---#-----------#-#-#--#--##-#-----#-------##-#----#------#----#-------#-##-----###------#----------#
----#---#--#-#--#-#-#-----#----#-#-#-----##-------#---####--------###--------#--#--##-----#--#-#----
###-------#----#-#--####-#-#-#-------#-###----------#-#----#---##--##---------#--#-----##-#-#---#---
#---###----##-----------#-##---###-#----#--#--####-#----##----------###--#-------###--#-###------#--