----------------------------------------------------------------------------------------------------
#----#----#----#----#----#----#----#----#----#----#----#----#----#----#----#----#----#----#----#----
--#-#--#-#--#-#--#-#--#-#--#-#--#-#--#-#--#-#--#-#--#-#--#-#--#-#--#-#--#-#--#-#--#-#--#-#--#-#--#-#
##---##---##---##---##---##---##---##---##---##---##---##---##---##---##---##---##---##---##---##---
-#----#----#----#----#----#----#----#----#----#----#----#----#----#----#----#----#----#----#----#---
----------------------------------------------------------------------------------------------------
#----#----#----#----#----#----#----#----#----#----#----#----#----#----#----#----#----#----#----#----
--#-#--#-#--#-#--#-#--#-#--#-#--#-#--#-#--#-#--#-#--#-#--#-#--#-#--#-#--#-#--#-#--#-#--#-#--#-#--#-#
##---##---##---##---##---##---##---##---##---##---##---##---##---##---##---##---##---##---##---##---
-#----#----#----#----#----#----#----#----#----#----#----#----#----#----#----#----#----#----#----#---
----------------------------------------------------------------------------------------------------
#----#----#----#----#----#----#----#----#----#----#----#----#----#----#----#----#----#----#----#----
--#-#--#-#--#-#--#-#--#-#--#-#--#-#--#-#--#-#--#-#--#-#--#-#--#-#--#-#--#-#--#-#--#-#--#-#--#-#--#-#
##---##---##---##---##---##---##---##---##---##---##---##---##---##---##---##---##---##---##---##---
-#----#----#----#----#----#----#----#----#----#----#----#----#----#----#----#----#----#----#----#---
----------------------------------E-----------------------------------------------------------------
#----#----#----#----#----#----#----#----#----#----#----#----#----#----#----#----#----#----#----#----
--#-#--#-#--#-#--#-#--#-#--#-#--#-#--#-#--#-#--#-#--#-#--#-#--#-#--#-#--#-#--#-#--#-#--#-#--#-#--#-#
##---##---##---##---##---##---##---##---##---##---##---##---##---##---##---##---##---##---##---##---
-#----#----#----#----#----#----#----#----#----#----#----#----#----#----#----#----#----#----#----#---
----------------------------------------------------------------------------------------------------
#----#----#----#----#----#----#----#----#----#----#----#----#----#----#----#----#----#----#----#----
--#-#--#-#--#-#--#-#--#-#--#-#--#-#--#-#--#-#--#-#--#-#--#-#--#-#--#-#--#-#--#-#--#-#--#-#--#-#--#-#
##---##---##---##---##---##---##---##---##---##---##---##---##---##---##---##---##---##---##---##---
-#----#----#----#----#----#----#----#----#----#----#----#----#----#----#----#----#----#----#----#---
----------------------------------------------------------------------------------------------------
#----#----#----#----#----#----#----#----#----#----#----#----#----#----#----#----#----#----#----#----
--#-#--#-#--#-#--#-#--#-#--#-#--#-#--#-#--#-#--#-#--#-#--#-#--#-#--#-#--#-#--#-#--#-#--#-#--#-#--#-#
##---##---##---##---##---##---##---##---##---##---##---##---##---##---##---##---##---##---##---##---
-#----#----#----#----#----#----#----#----#----#----#----#----#----#----#----#----#----#----#----#---
----------------------------------------------------------------------------------------------------
#----#----#----#----#----#----#----#----#----#----#----#----#----#----#----#----#----#----#----#----
--#-#--#-#--#-#--#-#--#-#--#-#--#-#--#-#--#-#--#-#--#-#--#-#--#-#--#-#--#-#--#-#--#-#--#-#--#-#--#-#
##---##---##---##---##---##---##---##---##---##---##---##---##---##---##---##---##---##---##---##---
-#----#----#----#----#----#----#----#----#----#----#----#----#----#----#----#----#----#----#----#---
----------------------------------------------------------------------------------------------------
#----#----#----#----#----#----#----#----#----#----#----#----#----#----#----#----#----#----#----#----
--#-#--#-#--#-#--#-#--#-#--#-#--#-#--#-#--#-#--#-#--#-#--#-#--#-#--#-#--#-#--#-#--#-#--#-#--#-#--#-#
##---##---##---##---##---##---##---##---##---##---##---##---##---##---##---##---##---##---##---##---
-#----#----#----#----#----#----#----#----#----#----#----#----#----#----#----#----#----#----#----#---
----------------------------------------------------------------------------------------------------
#----#----#----#----#----#----#----#----#----#----#----#----#----#----#----#----#----#----#----#----
--#-#--#-#--#-#--#-#--#-#--#-#--#-#--#-#--#-#--#-#--#-#--#-#--#-#--#-#--#-#--#-#--#-#--#-#--#-#--#-#
##---##---##---##---##---##---##---##---##---##---##---##---##---##---##---##---##---##---##---##---
-#----#----#----#----#----#----#----#----#----#----#----#----#----#----#----#----#----#----#----#---
----------------------------------------------------------------------------------------------------
#----#----#----#----#----#----#----#----#----#----#----#----#----#----#----#----#----#----#----#----
--#-#--#-#--#-#--#-#--#-#--#-#--#-#--#-#--#-#--#-#--#-#--#-#--#-#--#-#--#-#--#-#--#-#--#-#--#-#--#-#
##---##---##---##---##---##---##---##---##---##---##---##---##---##---##---##---##---##---##---##---
-#----#----#----#----#----#----#----#----#----#----#----#----#----#----#----#----#----#----#----#---
----------------------------------------------------------------------------------------------------
#----#----#----#----#----#----#----#----#----#----#----#----#----#----#----#----#----#----#----#----
--#-#--#-#--#-#--#-#--#-#--#-#--#-#--#-#--#-#--#-#--#-#--#-#--#-#--#-#--#-#--#-#--#-#--#-#--#-#--#-#
##---##---##---##---##---##---##---##---##---##---##---##---##---##---##---##---##---##---##---##---
-#----#----#----#----#----#----#----#----#----#----#----#----#----#----#----#----#----#----#----#---
----------------------------------------------------------------------------------------------------
#----#----#----#----#----#----#----#----#----#----#----#----#----#----#----#----#----#----#----#----
--#-#--#-#--#-#--#-#--#-#--#-#--#-#--#-#--#-#--#-#--#-#--#-#--#-#--#-#--#-#--#-#--#-#--#-#--#-#--#-#
##---##---##---##---##---##---##---##---##---##---##---##---##---##---##---##---##---##---##---##---
-#----#----#----#----#----#----#----#----#----#----#----#----#----#----#----#----#----#----#----#---
----------------------------------------------------------------------------------------------------
#----#----#----#----#----#----#----#----#----#----#----#----#----#----#----#----#----#----#----#----
--#-#--#-#--#-#--#-#--#-#--#-#--#-#--#-#--#-#--#-#--#-#--#-#--#-#--#-#--#-#--#-#--#-#--#-#--#-#--#-#
##---##---##---##---##---##---##---##---##---##---##---##---##---##---##---##---##---##---##---##---
-#----#----#----#----#----#----#----#----#----#----#----#----#----#----#----#----#----#----#----#---
----------------------------------------------------------------------------------------------------
#----#----#----#----#----#----#----#----#----#----#----#----#----#----#----#----#----#----#----#----
--#-#--#-#--#-#--#-#--#-#--#-#--#-#--#-#--#-#--#-#--#-#--#-#--#-#--#-#--#-#--#-#--#-#--#-#--#-#--#-#
##---##---##---##---##---##---##---##---##---##---##---##---##---##---##---##---##---##---##---##---
-#----#----#----#----#----#----#----#----#----#----#----#----#----#----#----#----#----#----#----#---
----------------------------------------------------------------------------------------------------
#----#----#----#----#----#----#----#----#----#----#----#----#----#----#----#----#----#----#----#----
--#-#--#-#--#-#--#-#--#-#--#-#--#-#--#-#--#-#--#-#--#-#--#-#--#-#--#-#--#-#--#-#--#-#--#-#--#-#--#-#
##---##---##---##---##---##---##---##---##---##---##---##---##---##---##---##---##---##---##---##---
-#----#----#----#----#----#----#----#----#----#----#----#----#----#----#----#----#----#----#----#---
----------------------------------------------------------------------------------------------------
#----#----#----#----#----#----#----#----#----#----#----#----#----#----#----#----#----#----#----#----
--#-#--#-#--#-#--#-#--#-#--#-#--#-#--#-#--#-#--#-#--#-#--#-#--#-#--#-#--#-#--#-#--#-#--#-#--#-#--#-#
##---##---##---##---##---##---##---##---##---##---##---##---##---##---##---##---##---##---##---##---
-#----#----#----#----#----#----#----#----#----#----#----#----#----#----#----#----#----#----#----#---
----------------------------------------------------------------------------------------------------
#----#----#----#----#----#----#----#----#----#----#----#----#----#----#----#----#----#----#----#----
--#-#--#-#--#-#--#-#--#-#--#-#--#-#--#-#--#-#--#-#--#-#--#-#--#-#--#-#--#-#--#-#--#-#--#-#--#-#--#-#
##---##---##---##---##---##---##---##---##---##---##---##---##---##---##---##---##---##---##---##---
-#----#----#----#----#----#----#----#----#----#----#----#----#----#----#----#----#----#----#----#---
----------------------------------------------------------------------------------------------------
#----#----#----#----#----#----#----#----#----#----#----#----#----#----#----#----#----#----#----#----
--#-#--#-#--#-#--#-#--#-#--#-#--#-#--#-#--#-#--#-#--#-#--#-#--#-#--#-#--#-#--#-#--#-#--#-#--#-#--#-#
##---##---##---##---##---##---##---##---##---##---##---##---##---##---##---##---##---##---##---##---
-#----#----#----#----#----#----#----#----#----#----#----#----#----#----#----#----#----#----#----#---
----------------------------------------------------------------------------------------------------
#----#----#----#----#----#----#----#----#----#----#----#----#----#----#----#----#----#----#----#----
--#-#--#-#--#-#--#-#--#-#--#-#--#-#--#-#--#-#--#-#--#-#--#-#--#-#--#-#--#-#--#-#--#-#--#-#--#-#--#-#
##---##---##---##---##---##---##---##---##--S##---##---##---##---##---##---##---##---##---##---##---
-#----#----#----#----#----#----#----#----#----#----#----#----#----#----#----#----#----#----#----#---
----------------------------------------------------------------------------------------------------
#----#----#----#----#----#----#----#----#----#----#----#----#----#----#----#----#----#----#----#----
--#-#--#-#--#-#--#-#--#-#--#-#--#-#--#-#--#-#--#-#--#-#--#-#--#-#--#-#--#-#--#-#--#-#--#-#--#-#--#-#
##---##---##---##---##---##---##---##---##---##---##---##---##---##---##---##---##---##---##---##---
-#----#----#----#----#----#----#----#----#----#----#----#----#----#----#----#----#----#----#----#---