#----#----#----#----#----#----#----#----#----#----#----#----#----#----#----#----#----#----#----#----
--#----#----#----#----#----#----#----#----#----#----#----#----#----#----#----#----#----#----#----#--
---#----#----#----#----#----#----#----#----#----#----#----#----#----#----#----#----#----#----#----#-
-#-#--#-#--#-#--#-#--#-#--#-#--#-#--#-#--#-#--#-#--#-#--#-#--#-#--#-#--#-#--#-#--#-#--#-#--#-#--#-#-
-###--###--###--###--###--###--###--###--###--###--###--###--###--###--###--###--###--###--###--###-
#----#----#----#----#----#----#----#----#----#----#----#----#----#----#----#----#----#----#----#----
--#----#----#----#----#----#----#----#----#----#----#----#----#----#----#----#----#----#----#----#--
---#----#----#----#----#----#----#----#----#----#----#----#----#----#----#----#----#----#----#----#-
-#-#--#-#--#-#--#-#--#-#--#-#--#-#--#-#--#-#--#-#--#-#--#-#--#-#--#-#--#-#--#-#--#-#--#-#--#-#--#-#-
-###--###--###--###--###--###--###--###--###--###--###--###--###--###--###--###--###--###--###--###-
#----#----#----#----#----#----#----#----#----#----#----#----#----#----#----#----#----#----#----#----
--#----#----#----#----#----#----#----#----#----#----#----#----#----#----#----#----#----#----#----#--
---#----#----#----#----#----#----#----#----#----#----#----#----#----#----#----#----#----#----#----#-
-#-#--#-#--#-#--#-#--#-#--#-#--#-#--#-#--#-#--#-#--#-#--#-#--#-#--#-#--#-#--#-#--#-#--#-#--#-#--#-#-
-###--###--###--###--###--###--###--###--###--###--###--###--###--###--###--###--###--###--###--###-
#----#----#----#----#----#----#----#----#----#----#----#----#----#----#----#----#----#----#----#----
--#----#----#----#----#----#----#----#----#----#----#----#----#----#----#----#----#----#----#----#--
---#----#----#----#----#----#----#----#----#----#----#----#----#----#----#----#----#----#----#----#-
-#-#--#-#--#-#--#-#--#-#--#-#--#-#--#-#--#-#--#-#--#-#--#-#--#-#--#-#--#-#--#-#--#-#--#-#--#-#--#-#-
-###--###--###--###--###--###--###--###--###--###--###--###--###--###--###--###--###--###--###--###-
#----#----#----#----#----#----#----#----#----#----#----#----#----#----#----#----#----#----#----#----
--#----#----#----#----#----#----#----#----#----#----#----#----#----#----#----#----#----#----#----#--
---#----#----#----#----#----#----#----#----#----#----#----#----#----#----#----#----#----#----#----#-
-#-#--#-#--#-#--#-#--#-#--#-#--#-#--#-#--#-#--#-#--#-#--#-#--#-#--#-#--#-#--#-#--#-#--#-#--#-#--#-#-
-###--###--###--###--###--###--###--###--###--###--###--###--###--###--###--###--###--###--###--###-
#----#----#----#----#----#----#----#----#----#----#----#----#----#----#----#----#----#----#----#----
--#----#----#----#----#----#----#----#----#----#----#----#----#----#----#----#----#----#----#----#--
---#----#----#----#----#----#----#----#----#----#----#----#----#----#----#----#----#----#----#----#-
-#-#--#-#--#-#--#-#--#-#--#-#--#-#--#-#--#-#--#-#--#-#--#-#--#-#--#-#--#-#--#-#--#-#--#-#--#-#--#-#-
-###--###--###--###--###--###--###--###--###--###--###--###--###--###--###--###--###--###--###--###-
#----#----#----#----#----#----#----#----#----#----#----#----#----#----#----#----#----#----#----#----
--#----#----#----#----#----#----#----#----#----#----#----#----#----#----#----#----#----#----#----#--
---#----#----#----#----#----#----#----#----#----#----#----#----#----#----#----#----#----#----#----#-
-#-#--#-#--#-#--#-#--#-#--#-#--#-#--#-#--#-#--#-#--#-#--#-#--#-#--#-#--#-#--#-#--#-#--#-#--#-#--#-#-
-###--###--###--###--###--###--###--###--###--###--###--###--###--###--###--###--###--###--###--###-
#----#----#----#----#----#----#----#----#----#----#----#----#----#----#----#----#----#----#----#----
--#----#----#----#----#----#----#----#----#----#----#----#----#----#----#----#----#----#----#----#--
---#----#----#----#----#----#----#----#----#----#----#----#----#----#----#----#----#----#----#----#-
-#-#--#-#--#-#--#-#--#-#--#-#--#-#--#-#--#-#--#-#--#-#--#-#--#-#--#-#--#-#--#-#--#-#--#-#--#-#--#-#-
-###--###--###--###--###--###--###--###--###--###--###--###--###--###--###--###--###--###--###--###-
#----#----#----#----#----#----#----#----#----#----#----#----#----#----#----#----#----#----#----#----
--#----#----#----#----#----#----#----#----#----#----#----#----#----#----#----#----#----#----#----#--
---#----#----#----#----#----#----#----#----#----#----#----#----#----#----#----#----#----#----#----#-
-#-#--#-#--#-#--#-#--#-#--#-#--#-#--#-#--#-#--#-#--#-#--#-#--#-#--#-#--#-#--#-#--#-#--#-#--#-#--#-#-
-###--###--###--###--###--###--###--###--###--###--###--###--###--###--###--###--###--###--###--###-
#----#----#----#----#----#----#----#----#----#----#----#----#----#----#----#----#----#----#----#----
--#----#----#----#----#----#----#----#----#----#----#----#----#----#----#----#----#----#----#----#--
---#----#----#----#----#----#----#----#----#----#----#----#----#----#----#----#----#--E-#----#----#-
-#-#--#-#--#-#--#-#--#-#--#-#--#-#--#-#--#-#--#-#--#-#--#-#--#-#--#-#--#-#--#-#--#-#--#-#--#-#--#-#-
-###--###--###--###--###--###--###--###--###--###--###--###--###--###--###--###--###--###--###--###-
#----#----#----#----#----#----#----#----#----#----#----#----#----#----#----#----#----#----#----#----
--#----#----#----#----#----#----#----#----#----#----#----#----#----#----#----#----#----#----#----#--
---#----#----#----#----#----#----#----#----#----#----#----#----#----#----#----#----#----#----#----#-
-#-#--#-#--#-#--#-#--#-#--#-#--#-#--#-#--#-#--#-#--#-#--#-#--#-#--#-#--#-#--#-#--#-#--#-#--#-#--#-#-
-###--###--###--###--###--###--###--###--###--###--###--###--###--###--###--###--###--###--###--###-
#----#----#----#----#----#----#----#----#----#----#----#----#----#----#----#----#----#----#----#----
--#----#----#----#----#----#----#----#----#----#----#----#----#----#----#----#----#----#----#----#--
---#----#----#----#----#----#----#----#----#----#----#----#----#----#----#----#----#----#----#----#-
-#-#--#-#--#-#--#-#--#-#--#-#--#-#--#-#--#-#--#-#--#-#--#-#--#-#--#-#--#-#--#-#--#-#--#-#--#-#--#-#-
-###--###--###--###--###--###--###--###--###--###--###--###--###--###--###--###--###--###--###--###-
#----#----#----#----#----#----#----#----#----#----#----#----#----#----#----#----#----#----#----#----
--#----#----#----#----#----#----#----#----#----#----#----#----#----#----#----#----#----#----#----#--
---#----#----#----#----#----#----#----#----#----#----#----#----#----#----#----#----#----#----#----#-
-#-#--#-#--#-#--#-#--#-#--#-#--#-#--#-#--#-#--#-#--#-#--#-#--#-#--#-#--#-#--#-#--#-#--#-#--#-#--#-#-
-###--###--###--###--###--###--###--###--###--###--###--###--###--###--###--###--###--###--###--###-
#----#----#----#----#----#----#----#----#----#----#----#----#----#----#----#----#----#----#----#----
--#----#----#----#----#----#----#----#----#----#----#----#----#----#----#----#----#----#----#----#--
---#----#----#----#----#----#----#----#----#----#----#----#----#----#----#----#----#----#----#----#-
-#-#--#-#--#-#--#-#--#-#--#-#--#-#--#-#--#-#--#-#--#-#--#-#--#-#--#-#--#-#--#-#--#-#--#-#--#-#--#-#-
-###--###--###--###--###--###--###--###--###--###--###--###--###--###--###--###--###--###--###--###-
#----#----#----#----#----#----#----#----#----#----#----#----#----#----#----#----#----#----#----#----
--#----#----#----#----#----#----#----#----#----#----#----#----#----#----#----#----#----#----#----#--
---#----#----#----#----#----#----#----#S---#----#----#----#----#----#----#----#----#----#----#----#-
-#-#--#-#--#-#--#-#--#-#--#-#--#-#--#-#--#-#--#-#--#-#--#-#--#-#--#-#--#-#--#-#--#-#--#-#--#-#--#-#-
-###--###--###--###--###--###--###--###--###--###--###--###--###--###--###--###--###--###--###--###-
#----#----#----#----#----#----#----#----#----#----#----#----#----#----#----#----#----#----#----#----
--#----#----#----#----#----#----#----#----#----#----#----#----#----#----#----#----#----#----#----#--
---#----#----#----#----#----#----#----#----#----#----#----#----#----#----#----#----#----#----#----#-
-#-#--#-#--#-#--#-#--#-#--#-#--#-#--#-#--#-#--#-#--#-#--#-#--#-#--#-#--#-#--#-#--#-#--#-#--#-#--#-#-
-###--###--###--###--###--###--###--###--###--###--###--###--###--###--###--###--###--###--###--###-
#----#----#----#----#----#----#----#----#----#----#----#----#----#----#----#----#----#----#----#----
--#----#----#----#----#----#----#----#----#----#----#----#----#----#----#----#----#----#----#----#--
---#----#----#----#----#----#----#----#----#----#----#----#----#----#----#----#----#----#----#----#-
-#-#--#-#--#-#--#-#--#-#--#-#--#-#--#-#--#-#--#-#--#-#--#-#--#-#--#-#--#-#--#-#--#-#--#-#--#-#--#-#-
-###--###--###--###--###--###--###--###--###--###--###--###--###--###--###--###--###--###--###--###-
#----#----#----#----#----#----#----#----#----#----#----#----#----#----#----#----#----#----#----#----
--#----#----#----#----#----#----#----#----#----#----#----#----#----#----#----#----#----#----#----#--
---#----#----#----#----#----#----#----#----#----#----#----#----#----#----#----#----#----#----#----#-
-#-#--#-#--#-#--#-#--#-#--#-#--#-#--#-#--#-#--#-#--#-#--#-#--#-#--#-#--#-#--#-#--#-#--#-#--#-#--#-#-
-###--###--###--###--###--###--###--###--###--###--###--###--###--###--###--###--###--###--###--###-
#----#----#----#----#----#----#----#----#----#----#----#----#----#----#----#----#----#----#----#----
--#----#----#----#----#----#----#----#----#----#----#----#----#----#----#----#----#----#----#----#--
---#----#----#----#----#----#----#----#----#----#----#----#----#----#----#----#----#----#----#----#-
-#-#--#-#--#-#--#-#--#-#--#-#--#-#--#-#--#-#--#-#--#-#--#-#--#-#--#-#--#-#--#-#--#-#--#-#--#-#--#-#-
-###--###--###--###--###--###--###--###--###--###--###--###--###--###--###--###--###--###--###--###-
#----#----#----#----#----#----#----#----#----#----#----#----#----#----#----#----#----#----#----#----
--#----#----#----#----#----#----#----#----#----#----#----#----#----#----#----#----#----#----#----#--
---#----#----#----#----#----#----#----#----#----#----#----#----#----#----#----#----#----#----#----#-
-#-#--#-#--#-#--#-#--#-#--#-#--#-#--#-#--#-#--#-#--#-#--#-#--#-#--#-#--#-#--#-#--#-#--#-#--#-#--#-#-
-###--###--###--###--###--###--###--###--###--###--###--###--###--###--###--###--###--###--###--###-