#----#----#----#----#----#----#----#----#----#----#----#----#----#----#----#----#----#----#----#----
#----#----#----#----#----#----#----#----#----#----#----#----#----#----#----#----#----#----#----#----
--#----#----#----#----#----#----#----#----#----#----#----#----#----#----#----#----#----#----#----#--
#----#----#----#----#----#----#----#----#----#----#----#----#----#----#----#----#----#----#----#----
---##---##---##---##---##---##---##---##---##---##---##---##---##---##---##---##---##---##---##---##
#----#----#----#----#----#----#----#----#----#----#----#----#----#----#----#----#----#----#----#----
#----#----#----#----#----#----#----#----#----#----#----#----#----#----#----#----#----#----#----#----
--#----#----#----#----#----#----#----#----#----#----#----#----#----#----#----#----#----#----#----#--
#----#----#----#----#----#----#----#----#----#----#----#----#----#----#----#----#----#----#----#----
---##---##---##---##---##---##---##---##---##---##---##---##---##---##---##---##---##---##---##---##
#----#----#----#----#----#----#----#----#----#----#----#----#----#----#----#----#----#----#----#----
#----#----#----#----#----#----#----#----#----#----#----#----#----#----#----#----#----#----#----#----
--#----#----#----#----#----#----#----#----#----#----#----#----#----#----#----#----#----#----#----#--
#----#----#----#----#----#----#----#----#----#----#----#----#----#----#----#----#----#----#----#----
---##---##---##---##---##---##---##---##---##---##---##---##---##---##---##---##---##---##---##---##
#----#----#----#----#----#----#----#----#----#----#----#----#----#----#-S--#----#----#----#----#----
#----#----#----#----#----#----#----#----#----#----#----#----#----#----#----#----#----#----#----#----
--#----#----#----#----#----#----#----#----#----#----#----#----#----#----#----#----#----#----#----#--
#----#----#----#----#----#----#----#----#----#----#----#----#----#----#----#----#----#----#----#----
---##---##---##---##---##---##---##---##---##---##---##---##---##---##---##---##---##---##---##---##
#----#----#----#----#----#----#----#----#----#----#----#----#----#----#----#----#----#----#----#----
#----#----#----#----#----#----#----#----#----#----#----#----#----#----#----#----#----#----#----#----
--#----#----#----#----#----#----#----#----#----#----#----#----#----#----#----#----#----#----#----#--
#----#----#----#----#----#----#----#----#----#----#----#----#----#----#----#----#----#----#----#----
---##---##---##---##---##---##---##---##---##---##---##---##---##---##---##---##---##---##---##---##
#----#----#----#----#----#----#----#----#----#----#----#----#----#----#----#----#----#----#----#----
#----#----#----#----#----#----#----#----#----#----#----#----#----#----#----#----#----#----#----#----
--#----#----#----#----#----#----#----#----#----#----#----#----#----#----#----#----#----#----#----#--
#----#----#----#----#----#----#----#----#----#----#----#----#----#----#----#----#----#----#----#----
---##---##---##---##---##---##---##---##---##---##---##---##---##---##---##---##---##---##---##---##
#----#----#----#----#----#----#----#----#----#----#----#----#----#----#----#----#----#----#----#----
#----#----#----#----#----#----#----#----#----#----#----#----#----#----#----#----#----#----#----#----
--#----#----#----#----#----#----#----#----#----#----#----#----#----#----#----#----#----#----#----#--
#----#----#----#----#----#----#----#----#----#----#----#----#----#----#----#----#----#----#----#----
---##---##---##---##---##---##---##---##---##---##---##---##---##---##---##---##---##---##---##---##
#----#----#----#----#----#----#----#----#----#----#----#----#----#----#----#----#----#----#----#----
#----#----#----#----#----#----#----#----#----#----#----#----#----#----#----#----#----#----#----#----
--#----#----#----#----#----#----#----#----#----#----#----#----#----#----#----#----#----#----#----#--
#----#----#----#----#----#----#----#----#----#----#----#----#----#----#----#----#----#----#----#----
---##---##---##---##---##---##---##---##---##---##---##---##---##---##---##---##---##---##---##---##
#----#----#----#----#----#----#----#----#----#----#----#----#----#----#----#----#----#----#----#----
#----#----#----#----#----#----#----#----#----#----#----#----#----#----#----#----#----#----#----#----
--#----#----#----#----#----#----#----#----#----#----#----#----#----#----#----#----#----#----#----#--
#----#----#----#----#----#----#----#----#----#----#----#----#----#----#----#----#----#----#----#----
---##---##---##---##---##---##---##---##---##---##---##---##---##---##---##---##---##---##---##---##
#----#----#----#----#----#----#----#----#----#----#----#----#----#----#----#----#----#----#----#----
#----#----#----#----#----#----#----#----#----#----#----#----#----#----#----#----#----#----#----#----
--#----#----#----#----#----#----#----#----#----#----#----#----#----#----#----#----#----#----#----#--
#----#----#----#----#----#----#----#----#----#----#----#----#----#----#----#----#----#----#----#----
---##---##---##---##---##---##---##---##---##---##---##---##---##---##---##---##---##---##---##---##
#----#----#----#----#----#----#----#----#----#----#----#----#----#----#----#----#----#----#----#----
#----#----#----#----#----#----#----#----#----#----#----#----#----#----#----#----#----#----#----#----
--#----#----#----#----#----#----#----#----#----#----#----#----#----#----#----#----#----#----#----#--
#----#----#----#----#----#----#----#----#----#----#----#----#----#----#----#----#----#----#----#----
---##---##---##---##---##---##---##---##---##---##---##---##---##---##---##---##---##---##---##---##
#----#----#----#----#----#----#----#----#----#----#----#----#----#----#----#----#----#----#----#----
#----#----#----#----#----#----#----#----#----#----#----#----#----#----#----#----#----#----#----#----
--#----#----#----#----#----#----#----#----#----#----#----#----#----#----#----#----#----#----#----#--
#----#----#----#----#----#----#----#----#----#----#----#----#----#----#----#----#----#----#----#----
---##---##---##---##---##---##---##---##---##---##---##---##---##---##---##---##---##---##---##---##
#----#----#----#----#----#----#----#----#----#----#----#----#----#----#----#----#----#----#----#----
#----#----#----#----#----#----#----#----#----#----#----#----#----#----#----#----#----#----#----#----
--#----#----#----#----#----#----#----#----#----#----#----#----#----#----#----#----#----#----#----#--
#----#----#----#----#----#----#----#----#----#----#----#----#----#----#----#----#----#----#----#----
---##---##---##---##---##---##---##---##---##---##---##---##---##---##---##---##---##---##---##---##
#----#----#----#----#----#----#----#----#----#----#----#----#----#----#----#----#----#----#----#----
#----#----#----#----#----#----#----#----#----#----#----#----#----#----#----#----#----#----#----#----
--#----#----#----#----#----#----#----#----#----#----#----#----#----#----#----#----#----#----#----#--
#----#----#----#----#----#----#----#----#----#----#----#----#----#----#----#----#----#----#----#----
---##---##---##---##---##---##---##---##---##---##---##---##---##---##---##---##---##---##---##---##
#----#----#----#----#----#----#----#----#----#----#----#----#----#----#----#----#----#----#----#----
#----#----#----#----#----#----#----#----#----#----#----#----#----#----#----#----#----#----#----#----
--#----#----#----#----#----#----#----#----#----#----#----#----#----#----#----#----#----#----#----#--
#----#----#----#----#----#----#----#----#----#----#----#----#----#----#----#----#----#----#----#----
---##---##---##---##---##---##---##---##---##---##---##---##---##---##---##---##---##---##---##---##
#----#----#----#----#----#----#----#----#----#----#----#----#----#----#----#----#----#----#----#----
#----#----#----#----#----#----#----#----#----#----#----#----#----#----#----#----#----#----#----#----
--#----#----#----#----#----#----#----#----#----#----#----#----#----#----#----#----#----#----#----#--
#----#----#----#----#----#----#----#----#----#----#----#----#----#----#----#----#----#----#----#----
---##---##---##---##---##---##---##---##---##---##---##---##---##---##---##---##---##---##---##---##
#----#----#----#----#----#----#----#----#----#----#----#----#----#----#----#----#----#----#----#----
#----#----#----#----#----#----#----#----#----#----#----#----#----#----#----#----#----#----#----#----
--#----#----#----#----#----#----#----#----#----#----#----#----#----#----#----#----#----#----#----#--
#----#----#----#----#----#----#----#----#----#----#----#----#----#----#----#----#----#----#----#----
---##---##---##---##---##---##---##---##---##---##---##---##---##---##---##---##---##---##---##---##
#----#----#----#----#----#----#----#----#----#----#----#----#----#----#----#----#----#----#----#----
#----#----#----#----#----#----#----#----#----#----#----#----#----#----#----#----#----#----#----#----
--#----#----#----#----#----#----#----#----#----#----#----#----#----#----#----#----#----#----#----#--
#----#----#----#----#----#----#----#----#----#----#----#----#----#----#----#----#----#----#----#----
---##---##---##---##---##---##---##---##---##---##---##---##---##---##---##---##---##---##---##---##
#----#----#----#----#----#----#----#----#----#----#----#----#----#----#----#----#----#----#----#----
#----#----#----#----#----#----#----#----#----#----#----#----#----#----#----#----#----#----#----#----
--#----#----#----#----#----#----#----#----#----#----#----#----#----#----#----#----#----#----#----#--
#----#----#----#----#----#----#----#----#----#----#----#----#----#----#E---#----#----#----#----#----
---##---##---##---##---##---##---##---##---##---##---##---##---##---##---##---##---##---##---##---##
#----#----#----#----#----#----#----#----#----#----#----#----#----#----#----#----#----#----#----#----
#----#----#----#----#----#----#----#----#----#----#----#----#----#----#----#----#----#----#----#----
--#----#----#----#----#----#----#----#----#----#----#----#----#----#----#----#----#----#----#----#--
#----#----#----#----#----#----#----#----#----#----#----#----#----#----#----#----#----#----#----#----
---##---##---##---##---##---##---##---##---##---##---##---##---##---##---##---##---##---##---##---##