##---##---##---##---##---##---##---##---##---##---##---##---##---##---##---##---##---##---##---##---
-#----#----#----#----#----#----#----#----#----#----#----#----#----#----#----#----#----#----#----#---
----------------------------------------------------------------------------------------------------
-#----#----#----#----#----#----#----#----#----#----#----#----#----#----#----#----#----#----#----#---
-##---##---##---##---##---##---##---##---##---##---##---##---##---##---##---##---##---##---##---##--
##---##---##---##---##---##---##---##---##---##---##---##---##---##---##---##---##---##---##---##---
-#----#----#----#----#----#----#----#----#----#----#----#----#----#----#----#----#----#----#----#---
----------------------------------------------------------------------------------------------------
-#----#----#----#----#----#----#----#----#----#----#----#----#----#----#----#----#----#----#----#---
-##---##---##---##---##---##---##---##---##---##---##---##---##---##---##---##---##---##---##---##--
##---##---##---##---##---##---##---##---##---##---##---##---##---##---##---##---##---##---##---##---
-#----#----#----#----#----#----#----#----#----#----#----#----#----#----#----#----#----#----#----#---
----------------------------------------------------------------------------------------------------
-#----#----#----#----#----#----#----#----#----#----#----#----#----#----#----#----#----#----#----#---
-##---##---##---##---##---##---##---##---##---##---##---##---##---##---##---##---##---##---##---##--
##---##---##---##---##---##---##---##---##---##---##---##---##---##---##---##---##---##---##---##---
-#----#----#----#----#----#----#----#----#----#----#----#----#----#----#----#----#----#----#----#---
----------------------------------------------------------------------------------------------------
-#----#----#----#----#----#----#----#----#----#----#----#----#----#----#----#----#----#----#----#---
-##---##---##---##---##---##---##---##---##---##---##---##---##---##---##---##---##---##---##---##--
##---##---##---##---##---##---##---##---##---##---##---##---##---##---##---##---##---##---##---##---
-#----#----#----#----#----#----#----#----#----#----#----#----#----#----#----#----#----#----#----#---
----------------------------------------------------------------------------------------------------
-#----#----#----#----#----#----#----#----#----#----#----#----#----#----#----#----#----#----#----#---
-##---##---##---##---##---##---##---##---##---##---##---##---##---##---##---##---##---##---##---##--
##---##---##---##---##---##---##---##---##---##---##---##---##---##---##---##---##---##---##---##---
-#----#----#----#----#----#----#----#----#----#----#----#----#----#----#----#----#----#----#----#---
----------------------------------------------------------------------------------------------------
-#----#----#----#----#----#----#----#----#----#----#----#----#----#----#----#----#----#----#----#---
-##---##---##---##---##---##---##---##---##---##---##---##---##---##---##---##---##---##---##---##--
##---##---##---##---##---##---##---##---##---##---##---##---##---##---##---##---##---##---##---##---
-#----#----#----#----#----#----#----#----#----#----#----#----#----#----#----#----#----#----#----#---
----------------------------------------------------------------------------------------------------
-#----#----#----#----#----#----#----#----#----#----#----#----#----#----#----#----#----#----#----#---
-##---##---##---##---##---##---##---##---##---##---##---##---##---##---##---##---##---##---##---##--
##---##---##---##---##---##---##---##---##---##---##---##---##---##---##---##---##---##---##---##---
-#----#----#----#----#----#----#----#----#----#----#----#----#----#----#----#----#----#----#----#---
----------------------------------------------------------------------------------------------------
-#----#----#----#----#----#----#----#----#----#----#----#----#----#----#----#----#----#----#----#---
-##---##---##---##---##---##---##---##---##---##---##---##---##---##---##---##---##---##---##---##--
##---##---##---##---##---##---##---##---##---##---##---##---##---##---##---##---##---##---##---##---
-#----#----#----#----#----#----#----#----#----#----#----#----#----#----#----#----#----#----#----#---
----------------------------------------------------------------------------------------------------
-#----#----#----#----#----#----#----#----#----#----#----#----#----#----#----#----#----#----#----#---
-##---##---##---##---##---##---##---##---##---##---##---##---##---##---##---##---##---##---##---##--
##---##---##---##---##---##---##---##---##---##---##---##---##---##---##---##---##---##---##---##---
-#----#----#----#----#----#----#----#----#----#----#----#----#----#----#----#----#----#----#----#---
----------------------------------------------------------------------------------------------------
-#----#----#----#----#----#----#----#----#----#----#----#----#----#----#----#----#----#----#----#---
-##---##---##---##---##---##---##---##---##---##---##---##---##---##---##---##---##---##---##---##--
##---##---##---##---##---##---##---##---##---##---##---##---##---##---##---##---##---##---##---##---
-#----#----#----#----#----#----#----#----#----#----#----#----#----#----#----#----#----#----#----#---
----------------------------------------------------------------------------------------------------
-#----#----#----#----#----#----#----#----#----#----#----#----#----#----#----#----#----#----#----#---
-##---##---##---##---##---##---##---##---##---##---##---##---##---##---##---##---##---##---##---##--
##---##---##---##---##---##---##---##---##---##---##---##---##---##---##---##---##---##---##---##---
-#----#----#----#----#----#----#----#----#----#----#----#----#----#----#----#----#----#----#----#---
----------------------------------------------------------------------------------------------------
-#----#----#----#----#----#----#----#----#----#----#----#----#----#----#----#----#----#----#----#---
-##---##---##---##---##---##---##---##---##---##---##---##---##---##---##---##---##---##---##---##--
##---##---##---##---##---##---##---##---##---##---##---##---##---##---##---##---##---##---##---##---
-#----#----#----#----#----#----#----#----#----#----#----#----#----#----#----#----#----#----#----#---
----------------------------------------------------------------------------------------------------
-#----#----#----#----#----#----#----#----#----#----#----#----#----#----#----#----#----#----#----#---
-##---##---##---##---##---##---##---##---##---##---##---##---##---##---##---##---##---##---##---##--
##---##---##---##---##---##---##---##---##---##---##--E##---##---##---##---##---##---##---##---##---
-#----#----#----#----#----#----#----#----#----#----#----#----#----#----#----#----#----#----#----#---
----------------------------------------S-----------------------------------------------------------
-#----#----#----#----#----#----#----#----#----#----#----#----#----#----#----#----#----#----#----#---
-##---##---##---##---##---##---##---##---##---##---##---##---##---##---##---##---##---##---##---##--
##---##---##---##---##---##---##---##---##---##---##---##---##---##---##---##---##---##---##---##---
-#----#----#----#----#----#----#----#----#----#----#----#----#----#----#----#----#----#----#----#---
----------------------------------------------------------------------------------------------------
-#----#----#----#----#----#----#----#----#----#----#----#----#----#----#----#----#----#----#----#---
-##---##---##---##---##---##---##---##---##---##---##---##---##---##---##---##---##---##---##---##--
##---##---##---##---##---##---##---##---##---##---##---##---##---##---##---##---##---##---##---##---
-#----#----#----#----#----#----#----#----#----#----#----#----#----#----#----#----#----#----#----#---
----------------------------------------------------------------------------------------------------
-#----#----#----#----#----#----#----#----#----#----#----#----#----#----#----#----#----#----#----#---
-##---##---##---##---##---##---##---##---##---##---##---##---##---##---##---##---##---##---##---##--
##---##---##---##---##---##---##---##---##---##---##---##---##---##---##---##---##---##---##---##---
-#----#----#----#----#----#----#----#----#----#----#----#----#----#----#----#----#----#----#----#---
----------------------------------------------------------------------------------------------------
-#----#----#----#----#----#----#----#----#----#----#----#----#----#----#----#----#----#----#----#---
-##---##---##---##---##---##---##---##---##---##---##---##---##---##---##---##---##---##---##---##--
##---##---##---##---##---##---##---##---##---##---##---##---##---##---##---##---##---##---##---##---
-#----#----#----#----#----#----#----#----#----#----#----#----#----#----#----#----#----#----#----#---
----------------------------------------------------------------------------------------------------
-#----#----#----#----#----#----#----#----#----#----#----#----#----#----#----#----#----#----#----#---
-##---##---##---##---##---##---##---##---##---##---##---##---##---##---##---##---##---##---##---##--
##---##---##---##---##---##---##---##---##---##---##---##---##---##---##---##---##---##---##---##---
-#----#----#----#----#----#----#----#----#----#----#----#----#----#----#----#----#----#----#----#---
----------------------------------------------------------------------------------------------------
-#----#----#----#----#----#----#----#----#----#----#----#----#----#----#----#----#----#----#----#---
-##---##---##---##---##---##---##---##---##---##---##---##---##---##---##---##---##---##---##---##--
##---##---##---##---##---##---##---##---##---##---##---##---##---##---##---##---##---##---##---##---
-#----#----#----#----#----#----#----#----#----#----#----#----#----#----#----#----#----#----#----#---
----------------------------------------------------------------------------------------------------
-#----#----#----#----#----#----#----#----#----#----#----#----#----#----#----#----#----#----#----#---
-##---##---##---##---##---##---##---##---##---##---##---##---##---##---##---##---##---##---##---##--