####-####-####-####-####-####-####-####-####-####-####-####-####-####-####-####-####-####-####-####-
#----#----#----#----#----#----#----#----#----#----#----#----#----#----#----#----#----#----#----#----
----------------------------------------------------------------------------------------------------
#----#----#----#----#----#----#----#----#----#----#----#----#----#----#----#----#----#----#----#----
--##---##---##---##---##---##---##---##---##---##---##---##---##---##---##---##---##---##---##---##-
####-####-####-####-####-####-####-####-####-####-####-####-####-####-####-####-####-####-####-####-
#----#----#----#----#----#----#----#----#----#----#----#----#----#----#----#----#----#----#----#----
----------------------------------------------------------------------------------------------------
#----#----#----#----#----#----#----#----#----#----#----#----#----#----#----#----#----#----#----#----
--##---##---##---##---##---##---##---##---##---##---##---##---##---##---##---##---##---##---##---##-
####-####-####-####-####-####-####-####-####-####-####-####-####-####-####-####-####-####-####-####-
#----#----#----#----#----#----#----#----#----#----#----#----#----#----#----#----#----#----#----#----
----------------------------------------------------------------------------------------------------
#----#----#----#----#----#----#----#----#----#----#----#----#----#----#----#----#----#----#----#----
--##---##---##---##---##---##---##---##---##---##---##---##---##---##---##---##---##---##---##---##-
####-####-####-####-####-####-####-####-####-####-####-####-####-####-####-####-####-####-####-####-
#----#----#----#----#----#----#----#----#----#----#----#----#----#----#----#----#----#----#----#----
----------------------------------------------------------------------------------------------------
#----#----#----#----#----#----#----#----#----#----#----#----#----#----#----#----#----#----#----#----
--##---##---##---##---##---##---##---##---##---##---##---##---##---##---##---##---##---##---##---##-
####-####-####-####-####-####-####-####-####-####-####-####-####-####-####-####-####-####-####-####-
#----#----#----#----#----#----#----#----#----#----#----#----#----#----#----#----#----#----#----#----
----------------------------------------------------------------------------------------------------
#----#----#----#----#----#----#----#----#----#----#----#----#----#----#----#----#----#----#----#----
--##---##---##---##---##---##---##---##---##---##---##---##---##---##---##---##---##---##---##---##-
####-####-####-####-####-####-####-####-####-####-####-####-####-####-####-####-####-####-####-####-
#----#----#----#----#----#----#----#----#----#----#----#----#----#----#----#----#----#----#----#----
----------------------------------------------------------------------------------------------------
#----#----#----#----#----#----#----#----#----#----#----#----#----#----#----#----#----#----#----#----
--##---##---##---##---##---##---##---##---##---##---##---##---##---##---##---##---##---##---##---##-
####-####-####-####-####-####-####-####-####-####-####-####-####-####-####-####-####-####-####-####-
#----#----#----#----#----#----#----#----#----#----#----#----#----#----#----#----#----#----#----#----
----------------------------------------------------------------------------------------------------
#----#----#----#----#----#----#----#----#----#----#----#----#----#----#----#----#----#----#----#----
--##---##---##---##---##---##---##---##---##---##---##---##---##---##---##---##---##---##---##---##-
####-####-####-####-####-####-####-####-####-####-####-####-####-####-####-####-####-####-####-####-
#----#----#----#----#----#----#----#----#----#----#----#----#----#----#----#----#----#----#----#----
----------------------------------------------------------------------------------------------------
#----#----#----#----#----#----#----#----#----#----#----#----#----#----#----#----#----#----#----#----
--##---##---##---##---##---##---##---##---##---##---##---##---##---##---##---##---##---##---##---##-
####-####-####-####-####-####-####-####-####-####-####-####-####-####-####-####-####-####-####-####-
#----#----#----#----#----#----#----#----#----#----#----#----#----#----#----#----#----#----#----#----
----------------------------------------------------------------------------------------------------
#----#----#----#--E-#----#----#----#----#----#----#----#----#----#----#----#----#----#----#----#----
--##---##---##---##---##---##---##---##---##---##---##---##---##---##---##---##---##---##---##---##-
####-####-####-####-####-####-####-####-####-####-####-####-####-####-####-####-####-####-####-####-
#----#----#----#----#----#----#----#----#----#----#----#----#----#----#----#----#----#----#----#----
----------------------------------------------------------------------------------------------------
#----#----#----#----#----#----#----#----#----#----#----#----#----#----#----#----#----#----#----#----
--##---##---##---##---##---##---##---##---##---##---##---##---##---##---##---##---##---##---##---##-
####-####-####-####-####-####-####-####-####-####-####-####-####-####-####-####-####-####-####-####-
#----#----#----#----#----#----#----#----#----#----#----#----#----#----#----#----#----#----#----#----
----------------------------------------------------------------------------------------------------
#----#----#----#----#----#----#----#----#----#----#----#----#----#----#----#----#----#----#----#----
--##---##---##---##---##---##---##---##---##---##---##---##---##---##---##---##---##---##---##---##-
####-####-####-####-####-####-####-####-####-####-####-####-####-####-####-####-####-####-####-####-
#----#----#----#----#----#----#----#----#----#----#----#----#----#----#----#----#----#----#----#----
----------------------------------------------------------------------------------------------------
#----#----#----#----#----#----#----#----#----#----#----#----#----#----#----#----#----#----#----#----
--##---##---##---##---##---##---##---##---##---##---##---##---##---##---##---##---##---##---##---##-
####-####-####-####-####-####-####-####-####-####-####-####-####-####-####-####-####-####-####-####-
#----#----#----#----#----#----#----#----#----#----#----#----#----#-S--#----#----#----#----#----#----
----------------------------------------------------------------------------------------------------
#----#----#----#----#----#----#----#----#----#----#----#----#----#----#----#----#----#----#----#----
--##---##---##---##---##---##---##---##---##---##---##---##---##---##---##---##---##---##---##---##-
####-####-####-####-####-####-####-####-####-####-####-####-####-####-####-####-####-####-####-####-
#----#----#----#----#----#----#----#----#----#----#----#----#----#----#----#----#----#----#----#----
----------------------------------------------------------------------------------------------------
#----#----#----#----#----#----#----#----#----#----#----#----#----#----#----#----#----#----#----#----
--##---##---##---##---##---##---##---##---##---##---##---##---##---##---##---##---##---##---##---##-
####-####-####-####-####-####-####-####-####-####-####-####-####-####-####-####-####-####-####-####-
#----#----#----#----#----#----#----#----#----#----#----#----#----#----#----#----#----#----#----#----
----------------------------------------------------------------------------------------------------
#----#----#----#----#----#----#----#----#----#----#----#----#----#----#----#----#----#----#----#----
--##---##---##---##---##---##---##---##---##---##---##---##---##---##---##---##---##---##---##---##-
####-####-####-####-####-####-####-####-####-####-####-####-####-####-####-####-####-####-####-####-
#----#----#----#----#----#----#----#----#----#----#----#----#----#----#----#----#----#----#----#----
----------------------------------------------------------------------------------------------------
#----#----#----#----#----#----#----#----#----#----#----#----#----#----#----#----#----#----#----#----
--##---##---##---##---##---##---##---##---##---##---##---##---##---##---##---##---##---##---##---##-
####-####-####-####-####-####-####-####-####-####-####-####-####-####-####-####-####-####-####-####-
#----#----#----#----#----#----#----#----#----#----#----#----#----#----#----#----#----#----#----#----
----------------------------------------------------------------------------------------------------
#----#----#----#----#----#----#----#----#----#----#----#----#----#----#----#----#----#----#----#----
--##---##---##---##---##---##---##---##---##---##---##---##---##---##---##---##---##---##---##---##-
####-####-####-####-####-####-####-####-####-####-####-####-####-####-####-####-####-####-####-####-
#----#----#----#----#----#----#----#----#----#----#----#----#----#----#----#----#----#----#----#----
----------------------------------------------------------------------------------------------------
#----#----#----#----#----#----#----#----#----#----#----#----#----#----#----#----#----#----#----#----
--##---##---##---##---##---##---##---##---##---##---##---##---##---##---##---##---##---##---##---##-
####-####-####-####-####-####-####-####-####-####-####-####-####-####-####-####-####-####-####-####-
#----#----#----#----#----#----#----#----#----#----#----#----#----#----#----#----#----#----#----#----
----------------------------------------------------------------------------------------------------
#----#----#----#----#----#----#----#----#----#----#----#----#----#----#----#----#----#----#----#----
--##---##---##---##---##---##---##---##---##---##---##---##---##---##---##---##---##---##---##---##-
####-####-####-####-####-####-####-####-####-####-####-####-####-####-####-####-####-####-####-####-
#----#----#----#----#----#----#----#----#----#----#----#----#----#----#----#----#----#----#----#----
----------------------------------------------------------------------------------------------------
#----#----#----#----#----#----#----#----#----#----#----#----#----#----#----#----#----#----#----#----
--##---##---##---##---##---##---##---##---##---##---##---##---##---##---##---##---##---##---##---##-