#-#--#-#--#-#--#-#--#-#--#-#--#-#--#-#--#-#--#-#--#-#--#-#--#-#--#-#--#-#--#-#--#-#--#-#--#-#--#-#--
----------------------------------------------------------------------------------------------------
--##---##---##---##---##---##---##---##---##---##---##---##---##---##---##---##---##---##---##---##-
----------------------------------------------------------------------------------------------------
##---##---##---##---##---##---##---##---##---##---##---##---##---##---##---##---##---##---##---##---
#-#--#-#--#-#--#-#--#-#--#-#--#-#--#-#--#-#--#-#--#-#--#-#--#-#--#-#--#-#--#-#--#-#--#-#--#-#--#-#--
----------------------------------------------------------------------------------------------------
--##---##---##---##---##---##---##---##---##---##---##---##---##---##---##---##---##---##---##---##-
----------------------------------------------------------------------------------------------------
##---##---##---##---##---##---##---##---##---##---##---##---##---##---##---##---##---##---##---##---
#-#--#-#--#-#--#-#--#-#--#-#--#-#--#-#--#-#--#-#--#-#--#-#--#-#--#-#--#-#--#-#--#-#--#-#--#-#--#-#--
----------------------------------------------------------------------------------------------------
--##---##---##---##---##---##---##---##---##---##---##---##---##---##---##---##---##---##---##---##-
----------------------------------------------------------------------------------------------------
##---##---##---##---##---##---##---##---##---##---##---##---##---##---##---##---##---##---##---##---
#-#--#-#--#-#--#-#--#-#--#-#--#-#--#-#--#-#--#-#--#-#--#-#--#-#--#-#--#-#--#-#--#-#--#-#--#-#--#-#--
----------------------------------------------------------------------------------------------------
--##---##---##---##---##---##---##---##---##---##---##---##---##---##---##---##---##---##---##---##-
----------------------------------------------------------------------------------------------------
##---##---##---##---##---##---##---##---##---##---##-S-##---##---##---##---##---##---##---##---##---
#-#--#-#--#-#--#-#--#-#--#-#--#-#--#-#--#-#--#-#--#-#--#-#--#-#--#-#--#-#--#-#--#-#--#-#--#-#--#-#--
----------------------------------------------------------------------------------------------------
--##---##---##---##---##---##---##---##---##---##---##---##---##---##---##---##---##---##---##---##-
----------------------------------------------------------------------------------------------------
##---##---##---##---##---##---##---##---##---##---##---##---##---##---##---##---##---##---##---##---
#-#--#-#--#-#--#-#--#-#--#-#--#-#--#-#--#-#--#-#--#-#--#-#--#-#--#-#--#-#--#-#--#-#--#-#--#-#--#-#--
----------------------------------------------------------------------------------------------------
--##---##---##---##---##---##---##---##---##---##---##---##---##---##---##---##---##---##---##---##-
----------------------------------------------------------------------------------------------------
##---##---##---##---##---##---##---##---##---##---##---##---##---##---##---##---##---##---##---##---
#-#--#-#--#-#--#-#--#-#--#-#--#-#--#-#--#-#--#-#--#-#--#-#--#-#--#-#--#-#--#-#--#-#--#-#--#-#--#-#--
----------------------------------------------------------------------------------------------------
--##---##---##---##---##---##---##---##---##---##---##---##---##---##---##---##---##---##---##---##-
----------------------------------------------------------------------------------------------------
##---##---##---##---##---##---##---##---##---##---##---##---##---##---##---##---##---##---##---##---
#-#--#-#--#-#--#-#--#-#--#-#--#-#--#-#--#-#--#-#--#-#--#-#--#-#--#-#--#-#--#-#--#-#--#-#--#-#--#-#--
----------------------------------------------------------------------------------------------------
--##---##---##---##---##---##---##---##---##---##---##---##---##---##---##---##---##---##---##---##-
----------------------------------------------------------------------------------------------------
##---##---##---##---##---##---##---##---##---##---##---##---##---##---##---##---##---##---##---##---
#-#--#-#--#-#--#-#--#-#--#-#--#-#--#-#--#-#--#-#--#-#--#-#--#-#--#-#--#-#--#-#--#-#--#-#--#-#--#-#--
----------------------------------------------------------------------------------------------------
--##---##---##---##---##---##---##---##---##---##---##---##---##---##---##---##---##---##---##---##-
----------------------------------------------------------------------------------------------------
##---##---##---##---##---##---##---##---##---##---##---##---##---##---##---##---##---##---##---##---
#-#--#-#--#-#--#-#--#-#--#-#--#-#--#-#--#-#--#-#--#-#--#-#--#-#--#-#--#-#--#-#--#-#--#-#--#-#--#-#--
----------------------------------------------------------------------------------------------------
--##---##---##---##---##---##---##---##---##---##---##---##---##---##---##---##---##---##---##---##-
----------------------------------------------------------------------------------------------------
##---##---##---##---##---##---##---##---##---##---##---##---##---##---##---##---##---##---##---##---
#-#--#-#--#-#--#-#--#-#--#-#--#-#--#-#--#-#--#-#--#-#--#-#--#-#--#-#--#-#--#-#--#-#--#-#--#-#--#-#--
----------------------------------------------------------------------------------------------------
--##---##---##---##---##---##---##---##---##---##---##---##---##---##---##---##---##---##---##---##-
----------------------------------------------------------------------------------------------------
##---##---##---##---##---##---##---##---##---##---##---##---##---##---##---##---##---##---##---##---
#-#--#-#--#-#--#-#--#-#--#-#--#-#--#-#--#-#--#-#--#-#--#-#--#-#--#-#--#-#--#-#--#-#--#-#--#-#--#-#--
----------------------------------------------------------------------------------------------------
--##---##---##---##---##---##---##---##---##---##---##---##---##---##---##---##---##---##---##---##-
----------------------------------------------------------------------------------------------------
##---##---##---##---##---##---##---##---##---##---##---##---##---##---##---##---##---##---##---##---
#-#--#-#--#-#--#-#--#-#--#-#--#-#--#-#--#-#--#-#--#-#--#-#--#-#--#-#--#-#--#-#--#-#--#-#--#-#--#-#--
----------------------------------------------------------------------------------------------------
--##---##---##---##---##---##---##---##---##---##---##---##---##---##---##---##---##---##---##---##-
----------------------------------------------------------------------------------------------------
##---##---##---##---##---##---##---##---##---##---##---##---##---##---##---##---##---##---##---##---
#-#--#-#--#-#--#-#--#-#--#-#--#-#--#-#--#-#--#-#--#-#--#-#--#-#--#-#--#-#--#-#--#-#--#-#--#-#--#-#--
----------------------------------------------------------------------------------------------------
--##---##---##---##---##---##---##---##---##---##---##---##---##---##---##---##---##---##---##---##-
----------------------------------------------------------------------------------------------------
##---##---##---##---##---##---##---##---##---##---##---##---##---##---##---##---##---##---##---##---
#-#--#-#--#-#--#-#--#-#--#-#--#-#--#-#--#-#--#-#--#-#--#-#--#-#--#-#--#-#--#-#--#-#--#-#--#-#--#-#--
----------------------------------------------------------------------------------------------------
--##---##---##---##---##---##---##---##---##---##---##---##---##---##---##---##---##---##---##---##-
----------------------------------------------------------------------------------------------------
##---##---##---##---##---##---##---##---##---##---##---##---##---##---##---##---##---##---##---##---
#-#--#-#--#-#--#-#--#-#--#-#--#-#--#-#--#-#--#-#--#-#--#-#--#-#--#-#--#-#--#-#--#-#--#-#--#-#--#-#--
----------------------------------------------------------------------------------------------------
--##---##---##---##---##---##---##---##---##---##---##---##---##---##---##---##---##---##---##---##-
---------------------------------------------------------------------------------------E------------
##---##---##---##---##---##---##---##---##---##---##---##---##---##---##---##---##---##---##---##---
#-#--#-#--#-#--#-#--#-#--#-#--#-#--#-#--#-#--#-#--#-#--#-#--#-#--#-#--#-#--#-#--#-#--#-#--#-#--#-#--
----------------------------------------------------------------------------------------------------
--##---##---##---##---##---##---##---##---##---##---##---##---##---##---##---##---##---##---##---##-
----------------------------------------------------------------------------------------------------
##---##---##---##---##---##---##---##---##---##---##---##---##---##---##---##---##---##---##---##---
#-#--#-#--#-#--#-#--#-#--#-#--#-#--#-#--#-#--#-#--#-#--#-#--#-#--#-#--#-#--#-#--#-#--#-#--#-#--#-#--
----------------------------------------------------------------------------------------------------
--##---##---##---##---##---##---##---##---##---##---##---##---##---##---##---##---##---##---##---##-
----------------------------------------------------------------------------------------------------
##---##---##---##---##---##---##---##---##---##---##---##---##---##---##---##---##---##---##---##---
#-#--#-#--#-#--#-#--#-#--#-#--#-#--#-#--#-#--#-#--#-#--#-#--#-#--#-#--#-#--#-#--#-#--#-#--#-#--#-#--
----------------------------------------------------------------------------------------------------
--##---##---##---##---##---##---##---##---##---##---##---##---##---##---##---##---##---##---##---##-
----------------------------------------------------------------------------------------------------
##---##---##---##---##---##---##---##---##---##---##---##---##---##---##---##---##---##---##---##---
#-#--#-#--#-#--#-#--#-#--#-#--#-#--#-#--#-#--#-#--#-#--#-#--#-#--#-#--#-#--#-#--#-#--#-#--#-#--#-#--
----------------------------------------------------------------------------------------------------
--##---##---##---##---##---##---##---##---##---##---##---##---##---##---##---##---##---##---##---##-
----------------------------------------------------------------------------------------------------
##---##---##---##---##---##---##---##---##---##---##---##---##---##---##---##---##---##---##---##---