---#-#-------#--#-------#---#---#-----#--#----##---#--#-###-#-----#-------#-###-#----#--##----------
-----###-##--#-#-#----###------#--#-#-##-#---#----#---#-##-#-#-####---##-##-----#----#-----#----###-
--#-#-#-------#---#------#--#--####---#----#---#-#---##------##-####----#-#-----#--#-----------##---
#----#------#--#-----#-###--##---#-----#--#-#---#------#---------#-#----##---##---------#####--####-
-#-##--#------##---#---##-##----###-#-##-###---#-----#--#---#--#---#------#-------#--##----##-#-##--
#-----------###-##----####--#-#-#####--#------#-#---##-#-###----#---##----####-#---#-#-----------#--
--#---##---------#--#-##---#-###--##--#---#-#--------#--#----##--#----#-#-#----###---###-------###-#
---#------#------###---####---#-#--------#-----###------#####-#--#-#--#--#---#-#---#-----#-###-###--
#-----#----------#-###--##--------#---#-#----#-------#-#-##-##----##-#-----------------#----#----##-
-#--#--#-----###--------#--#--##-##-###---###-#---#-##---#---------------#----------#--##-#--#--###-
------------#----#-#----#--#-#--#-------##----#--#--#-#--#--#-#-#--#-#--#-----#-----#-#-------#-#-##
#------##--#-#------------##------#-##----#--#--------##-#--###-----#-#------#-------#----#--#-###-#
--------#-------####--#---#-#-------##---#-##----#--------------###--------##--#---------#-##-#-----
----##-#-##--###---#---#--#----#-##--#---##--##--#----#-#-#-#-#----#--##--#------###---#--#----#---#
-#-#---#-#-##-------##----##----#--#----#---##----##--#------##------##--##-#--##-#---#--#-------###
-----------#---##---#---#-##-#--##--#-#-#--#---##-#-##--#-#--##-#---#----#-----#---------##-##-##---
-#-------------#----#-#---#----#-#-----------#------#-#-#--#--#--##----------#----#-------------#-#-
-####--##---#------#-#---#-##--#------###---#-#--------#-------------#-----#---#--#--#--#---##-##---
----#-#--#----#---#-------------#-##---#--##-#-##-#---#--#---#-#----#-##--#-----#-###--##--#--###--#
---#--#--#-####-#-#--##-----##-#--#----##---##----------------------#-----##-----###--#---###----#-#
-----##------#-----#---##-----#--------#--##-#----##------#--#--#------##-#-#-#--#-###-#--#----##-##
-#------#---##----##-------------#-##---##----#-#-#-----#-#--##----#---#--------#------#--#---------
#--#----#----#------#--------------#----#-##----#-------#--#--#-##---#-##-##---#--#---##-----#-#----
---#---#----##-----#--#-#---------#-#--#-#-#-------#---------#-----#--#-##------#------------#-#----
--#----#-#-#--#--#----#-#-#-#---####---#--#----#-#-##--------#--#--#-----#----##---###--#--#-----#--
-##---#----##-#------##--##---#----##-##-#-------#-----------####--#---##-----##---#--#-##--------#-
---#--###---#-----##--#--#-#------#----------#--#--####----#----#---#-#-#-#---#--#-#---#--##--------
#----------#---##---#--#------##-#----#----------#--#-----------###----#--##--#--##--------#-##---#-
#---#-#---#-##----##---##-#-----#-#--#--##--#----------#--#-----###--#--#-------##--#---#-#----##---
-----##-#------##--#---#----#---#--#-----##--#--#-#--##------#-----##-#--------#-#####-----#--###--#
##-----------#-#-##-#--##--##-#-#-#--#---#-#------#---##----------#-#-----##-##--#-#-#----#--#----#-
-#-#-#-#-------------#-----------##---#----#--#-#----#-#----###----#---#E-##-#---#--###-----#####--#
-#---#--------#--#----#-#------###-#-#--#-#------------#-#########-##---#-###-#--##-----#------##---
#####--#-----##---#-#-#---#-----#--##-#--##-####----####-#------#-#--#-##--------------###-#----#---
------#-#-#--#--#--#-#----#---#---#---###----###-------#----##-----##-#---#-------###--#------#--#--
#-------##-----#----#-#---#-#-##---##--###-##---##--#-#----##--###-------#---#--#----------#-#---##-
---------#-#-#---#-#-----#-#--#----#---#-#-#--#-----#-##---##-##--------#---------#-------#---#----#
---#---#---------#----##-------#-#---#-#--#------##-#-##------###-###-#-#-#-----#-#-------#---------
----##-#-##-#----##----#-#------#--#---#-#-------##--#---------#--#--#--#-##--#----#--#----#-#--#-#-
#-#--#-------#--#----#----##-###-##--##-#---##----------#####-##---------#-#----###-##-#-#--##----##
#-------#----#-------##-##---#--#------##--###---#-------####---#-#-##---##--#--##-#---------#-#----
###-#-----#-----#-------#----#-#---#-#-----#--#-##--#------#--##----#----------#--#----#-#-------#--
-------#-#--#--#--------#-#-------#-----#--#-#-#-----#--#--------###-------------##---##--------###-
#-##-#-##--------#--#-----#-#-#---#--#--------------#------#-#--##-------###------#---#---##--#-##--
#-#--------#----#--#---###---#--#----------#-####-----##-----#------#--------##---#----#--#--#-#----
#-#-##----#------------#----#--#--#--#---#--#---#--#---##-##-------#-----#-#----###-#--#--#-#---##--
-###-----##-###---####-----------#-##-#----------#----#######--------#--------#-###-#--#-#-####-##--
#----#--#----#-#-------#-------#--------##-#--#-#-###-##-#-#----#-###------##---###--#---#----#--#-#
----#-#-#--###--#-#-#--##---#--#-#--#-#--#--------#----#-###---#-------#------#---#------#-#-#-#----
---#----#--###-----##-#-----##---#-----#-----#------##-###--#---------#--#---#-#--#----##-#-###----#
#-#-#--#----##----------##-#-#-#-#--##------#-#-#-#--#--#-#------#-#-------------##--#-----------##-
---#----#-#-#--#-----------#-#----#-#----#--#---#-------#-#---##--#----#-------------#-----#--#-##--
-###-#--#-##-###--#----#-#--##--#--#-##---#--#-#-----#-##-----#-#------#--#-#--####--#--#-#-#--#----
-#--####-###-#---##-#-###----#--#----#--#----------#-#---#----#-#----#----#--#-----#-#---#---####-##
-#--#-#------##-#---#-#-#-#--------#--------###--#----#--#-#--------#-------#--##-##-#--#---#-----#-
--##-#-###---------#-#--#----#---######--------##--###-####--#---##----#-----------#----#---##-#####
----#--#----#-#--#-#---#-##--#--------#----------#---##--#---------#-#---#----##----------#---#---##
--#---#--#-------##------##--#-#-#-#----##-----#-#-##-#-##--#-------##----------------------#-#-####
--###-------#-----###-#-----#----##--##-#--#----------##-##-#--#---#-####---###----------#-----####-
#-#---#----------#----------#-------#----------------#-#--#-----#---#-#--------#--##--##------###--#
-##-#------#---####-#------#------##--#---#----------#----#-#-#-#-----####--#-----#-###-----#---###-
--#--#--------------#--#---##------------##--#----#--#--##-#-----#-----#-#--#----#-#---#-###---#--#-
------#-#-#--##---------#-------##--#-#--##--#---##---#-#-----#-----#------#-#--#--#----##-#-#--##--
--------#-------#---##----------#########-#-----------#----#---#--####--#--#--##---##--#-#--#--#----
---#-#####-------#------#-------##--##-#------#----#-#----#---#---#---------##----##---#---#---#----
--#--##---#--#--#--##-#----#-##------###-----#----###---#-#-#---------#--#-----#--#-##----#-------#-
-------##-------##-#-#-#-#-------##-#--#------####--------##--#-#-#-###------#-#------#----#-#----#-
###-##-----###--#--#-----#--#####-##---------##--##-##----#-#-#-----#----##----#-###---#-#---#--#---
----#----##---####----#----##-#----------#-######---#--#--#-------##---#-#---#---------#--------#---
-##--#-##-##-#--##---#-###-#---------###--#-###-------#----#----##--#-#------#---------#---#--#---#-
-------#--##-----------#-###---##-#-#--##---##---#--#----------#-#--#--#-##-#--#-####---#-##----#--#
--#-#---#----------#---#---##--#------#-#-##-##--#--#---#--#---#-#---#---#------#--#----#--#--------
-##-#---#---#--#------###-##-#--#---------#---###--#-#-------#---##------###--#--------#---####-#---
-----#---##-#-----##-#####--#--##--#----------#-----##-----##--#--#-----#-##---##-##----##-#--##----
-#-##--#--##--##---#-----#-#-#---------#---------##--#-----##-#------#---##----#-#--#--------------#
#----##----------##-#--#--##----##--###-------#--#-------##------#-#--#---######-#-#--#--#----------
#------##----##-#-#---#---##-#-#--------#--##---##------#------#---#------##-##-#----#----###-#-##--
---#-#-----##---####----##------##---#-##---##---#----#--#-##-##--#---##--#---#--#----#---------#-##
-#--#-#--##-#---###-##-----##----#--##--#-----##----#-#-#-------#-#---#--#-------####------#--#-###-
-----#---##------#------#--####-#----#-####-##-#-#-#---#--###---#--##---#-#----##---##---#---#------
--#----#--#---#--#-##-----#-#----#---#-------##--##----#---------------#----#----#----#-#--------#--
##-----#--#-##-#-----##-##----#--#---------#-----#-##-#---#--##-#--#--###-----#-#-----#-------#-#-##
####-##--#---#-#-##--#--#--##-#------##--#---#--##--------------##---------------#--#---------------
##----#-#---##-#---#-###-###---#-------#--#----##-----#-#--##-----#-#-#---#---#--#--##----#----##-#-
---##---------#-----#------#----#-----#-#--#--#----#--#-##--#---------#----##-------#---------------
###---####------#-#-#---###--#-#------#-------##-----#------##-##----#-#--#----##-#---#---#--#-#---#
----##-##-------##--#---##--#--#---##-#-#-#---#-------#---#----#----------###------#-----###-###-#--
--#---#-#-#----#---###------#--##----#-###-#--#--#-##--------##-#--------#--------###-#-#---##------
---#---------##-#-#-##--##---##-##--###---##-#----#------#-#---#---#--##-##-#-#-#--###----#-##-#----
--#--#-------#-----#-#-----#--#----##---------###----------#-#--#--#------##-#-----#--##-#----##----
--#-##----#---##-------#--###-----------#----#---#---##--##--#---#--##------#---#-###--#---#------#-
#---#-##-#-----------#-##-#--#------------------------##-#----##--##--#--#--###------------##----#-#
-##-#-#-#---##--------#-#-----#-----#-------#-#-##----#-----#-#--#--#------#------#----##--#----#---
-#-------##--#-----##-----###--###----###---#----##---##----#----#---##----S----###----#----#---####
-----#-#---------#-##-----##-##--#-#--#-------##------#-##---###-------------##-#-#-#-#------#-#---#
-##---#----#-##--#-#---------###-------###--###---#-#---#-#--#-##--#-#--#-----#-##--#-#-------#-----
--------#-----#--#--##---#---#-#----##-#---#------#--##--#--#----#-----#----#------------#--#-------
###----------#--##----#---#---#--#-#---------#----##------#-##----#-------#---------#----#---####--#
-##-#---#-#----##--#---#---------------#-##--#-#-#-#--##--#-#--#-#-#----#-#-------#--#--------------
--------###-#-##----#-#----#-#--#-----------#-#-#---#----#---#--------#--##-------#----#---##-------