#--#-#--#-#--#-#--#-#--#-#--#-#--#-#--#-#--#-#--#-#--#-#--#-#--#-#--#-#--#-#--#-#--#-#--#-#--#-#--#-
-#----#----#----#----#----#----#----#----#----#----#----#----#----#----#----#----#----#----#----#---
----#----#----#----#----#----#----#----#----#----#----#----#----#----#----#----#----#----#----#----#
#----#----#----#----#----#----#----#----#----#----#----#----#----#----#----#----#----#----#----#----
----#----#----#----#----#----#----#----#----#----#----#----#----#----#----#----#----#----#----#----#
#--#-#--#-#--#-#--#-#--#-#--#-#--#-#--#-#--#-#--#-#--#-#--#-#--#-#--#-#--#-#--#-#--#-#--#-#--#-#--#-
-#----#----#----#----#----#----#----#----#----#----#----#----#----#----#----#----#----#----#----#---
----#----#----#----#----#----#----#----#----#----#----#----#----#----#----#----#----#----#----#----#
#----#----#----#----#----#----#----#----#----#----#----#----#----#----#----#----#----#----#----#----
----#----#----#----#----#----#----#----#----#----#----#----#----#----#----#----#----#----#----#----#
#--#-#--#-#--#-#--#-#--#-#--#-#--#-#--#-#--#-#--#-#--#-#--#-#--#-#--#-#--#-#--#-#--#-#--#-#--#-#--#-
-#----#----#----#----#----#----#----#----#----#----#----#----#----#----#----#----#----#----#----#---
----#----#----#----#----#----#----#----#----#----#----#----#----#----#----#----#----#----#----#----#
#----#----#----#----#----#----#----#----#----#----#----#----#----#----#----#----#----#----#----#----
----#----#----#----#----#----#----#----#----#----#----#----#----#----#----#----#----#----#----#----#
#--#-#--#-#--#-#--#-#--#-#--#-#--#-#--#-#--#-#--#-#--#-#--#-#--#-#--#-#--#-#--#-#--#-#--#-#--#-#--#-
-#----#----#----#----#----#----#----#----#----#----#----#----#----#----#----#----#----#----#----#---
----#----#----#----#----#----#----#----#----#----#----#----#----#----#----#----#----#----#----#----#
#----#----#----#----#----#----#----#----#----#----#----#----#----#----#----#----#----#----#----#----
----#----#----#----#----#----#----#----#----#----#----#----#----#----#----#----#----#----#----#----#
#--#-#--#-#--#-#--#-#--#-#--#-#--#-#--#-#--#-#--#-#--#-#--#-#--#-#--#-#--#-#--#-#--#-#--#-#--#-#--#-
-#----#----#----#----#----#----#----#----#----#----#----#----#----#----#----#----#----#----#----#---
----#----#----#----#----#----#----#----#----#----#----#----#----#----#----#----#----#----#----#----#
#----#----#----#----#----#----#----#----#----#----#----#----#----#----#----#----#----#----#----#----
----#----#----#----#----#----#----#----#----#----#----#----#----#----#----#----#----#----#----#----#
#--#-#--#-#--#-#--#-#--#-#--#-#--#-#--#-#--#-#--#-#--#-#--#-#--#-#--#-#--#-#--#-#--#-#--#-#--#-#--#-
-#----#----#----#----#----#----#----#----#----#----#----#----#----#----#----#----#----#----#----#---
----#----#----#----#----#----#----#----#----#----#----#----#----#----#----#----#----#----#----#----#
#----#----#----#----#----#----#----#----#----#----#----#----#----#----#----#----#----#----#----#----
----#----#----#----#----#----#----#----#----#----#----#----#----#----#----#----#----#----#----#----#
#--#-#--#-#--#-#--#-#--#-#--#-#--#-#--#-#--#-#--#-#--#-#--#-#--#-#--#-#--#-#--#-#--#-#--#-#--#-#--#-
-#----#----#----#----#----#----#----#----#----#----#----#----#----#----#----#----#----#----#----#---
----#----#----#----#----#----#----#----#----#----#----#----#----#----#----#----#----#----#----#----#
#----#----#----#----#----#----#----#----#----#----#----#----#----#----#----#----#----#----#----#----
----#----#----#----#----#----#----#----#----#----#----#----#----#----#----#----#----#----#----#----#
#--#-#--#-#--#-#--#-#--#-#--#-#--#-#--#-#--#-#--#-#--#-#--#-#--#-#--#-#--#-#--#-#--#-#--#-#--#-#--#-
-#----#----#----#----#----#----#----#----#----#----#----#----#----#----#----#----#----#----#----#---
----#----#----#----#----#----#----#----#----#----#----#----#----#----#----#----#----#----#----#----#
#----#----#----#----#----#----#----#----#----#----#----#----#----#----#----#----#----#----#----#----
----#----#----#----#----#----#----#----#----#----#----#----#----#----#----#----#----#----#----#----#
#--#-#--#-#--#-#--#-#--#-#--#-#--#-#--#-#--#-#--#-#--#-#--#-#--#-#--#-#--#-#--#-#--#-#--#-#--#-#--#-
-#----#----#----#----#----#----#----#----#----#----#----#----#----#----#----#----#----#----#----#---
----#----#----#----#----#----#----#----#----#----#----#----#----#----#----#----#----#----#----#----#
#----#----#----#----#----#----#----#----#----#----#----#----#----#----#----#----#----#----#----#----
----#----#----#----#----#----#----#----#----#----#----#----#----#----#----#----#----#----#----#----#
#--#-#--#-#--#-#--#-#--#-#--#-#--#-#--#-#--#-#--#-#--#-#--#-#--#-#--#-#--#-#--#-#--#-#--#-#--#-#--#-
-#----#----#----#----#----#----#----#----#----#----#----#----#----#----#----#----#----#----#----#---
----#----#----#----#----#----#--E-#----#----#----#----#----#----#----#----#----#----#----#----#----#
#----#----#----#----#----#----#----#----#----#----#----#----#----#----#----#----#----#----#----#----
----#----#----#----#----#----#----#----#----#----#----#----#----#----#----#----#----#----#----#----#
#--#-#--#-#--#-#--#-#--#-#--#-#--#-#--#-#--#-#--#-#--#-#--#-#--#-#--#-#--#-#--#-#--#-#--#-#--#-#--#-
-#----#----#----#----#----#----#----#----#----#----#----#----#----#----#----#----#----#----#----#---
----#----#----#----#----#----#----#----#----#----#----#----#----#----#----#----#----#----#----#----#
#----#----#----#----#----#----#----#----#----#----#----#----#----#----#----#----#----#----#----#----
----#----#----#----#----#----#----#----#----#----#----#----#----#----#----#----#----#----#----#----#
#--#-#--#-#--#-#--#-#--#-#--#-#--#-#--#-#--#-#--#-#--#-#--#-#--#-#--#-#--#-#--#-#--#-#--#-#--#-#--#-
-#----#----#----#----#----#----#----#----#----#----#----#----#----#S---#----#----#----#----#----#---
----#----#----#----#----#----#----#----#----#----#----#----#----#----#----#----#----#----#----#----#
#----#----#----#----#----#----#----#----#----#----#----#----#----#----#----#----#----#----#----#----
----#----#----#----#----#----#----#----#----#----#----#----#----#----#----#----#----#----#----#----#
#--#-#--#-#--#-#--#-#--#-#--#-#--#-#--#-#--#-#--#-#--#-#--#-#--#-#--#-#--#-#--#-#--#-#--#-#--#-#--#-
-#----#----#----#----#----#----#----#----#----#----#----#----#----#----#----#----#----#----#----#---
----#----#----#----#----#----#----#----#----#----#----#----#----#----#----#----#----#----#----#----#
#----#----#----#----#----#----#----#----#----#----#----#----#----#----#----#----#----#----#----#----
----#----#----#----#----#----#----#----#----#----#----#----#----#----#----#----#----#----#----#----#
#--#-#--#-#--#-#--#-#--#-#--#-#--#-#--#-#--#-#--#-#--#-#--#-#--#-#--#-#--#-#--#-#--#-#--#-#--#-#--#-
-#----#----#----#----#----#----#----#----#----#----#----#----#----#----#----#----#----#----#----#---
----#----#----#----#----#----#----#----#----#----#----#----#----#----#----#----#----#----#----#----#
#----#----#----#----#----#----#----#----#----#----#----#----#----#----#----#----#----#----#----#----
----#----#----#----#----#----#----#----#----#----#----#----#----#----#----#----#----#----#----#----#
#--#-#--#-#--#-#--#-#--#-#--#-#--#-#--#-#--#-#--#-#--#-#--#-#--#-#--#-#--#-#--#-#--#-#--#-#--#-#--#-
-#----#----#----#----#----#----#----#----#----#----#----#----#----#----#----#----#----#----#----#---
----#----#----#----#----#----#----#----#----#----#----#----#----#----#----#----#----#----#----#----#
#----#----#----#----#----#----#----#----#----#----#----#----#----#----#----#----#----#----#----#----
----#----#----#----#----#----#----#----#----#----#----#----#----#----#----#----#----#----#----#----#
#--#-#--#-#--#-#--#-#--#-#--#-#--#-#--#-#--#-#--#-#--#-#--#-#--#-#--#-#--#-#--#-#--#-#--#-#--#-#--#-
-#----#----#----#----#----#----#----#----#----#----#----#----#----#----#----#----#----#----#----#---
----#----#----#----#----#----#----#----#----#----#----#----#----#----#----#----#----#----#----#----#
#----#----#----#----#----#----#----#----#----#----#----#----#----#----#----#----#----#----#----#----
----#----#----#----#----#----#----#----#----#----#----#----#----#----#----#----#----#----#----#----#
#--#-#--#-#--#-#--#-#--#-#--#-#--#-#--#-#--#-#--#-#--#-#--#-#--#-#--#-#--#-#--#-#--#-#--#-#--#-#--#-
-#----#----#----#----#----#----#----#----#----#----#----#----#----#----#----#----#----#----#----#---
----#----#----#----#----#----#----#----#----#----#----#----#----#----#----#----#----#----#----#----#
#----#----#----#----#----#----#----#----#----#----#----#----#----#----#----#----#----#----#----#----
----#----#----#----#----#----#----#----#----#----#----#----#----#----#----#----#----#----#----#----#
#--#-#--#-#--#-#--#-#--#-#--#-#--#-#--#-#--#-#--#-#--#-#--#-#--#-#--#-#--#-#--#-#--#-#--#-#--#-#--#-
-#----#----#----#----#----#----#----#----#----#----#----#----#----#----#----#----#----#----#----#---
----#----#----#----#----#----#----#----#----#----#----#----#----#----#----#----#----#----#----#----#
#----#----#----#----#----#----#----#----#----#----#----#----#----#----#----#----#----#----#----#----
----#----#----#----#----#----#----#----#----#----#----#----#----#----#----#----#----#----#----#----#
#--#-#--#-#--#-#--#-#--#-#--#-#--#-#--#-#--#-#--#-#--#-#--#-#--#-#--#-#--#-#--#-#--#-#--#-#--#-#--#-
-#----#----#----#----#----#----#----#----#----#----#----#----#----#----#----#----#----#----#----#---
----#----#----#----#----#----#----#----#----#----#----#----#----#----#----#----#----#----#----#----#
#----#----#----#----#----#----#----#----#----#----#----#----#----#----#----#----#----#----#----#----
----#----#----#----#----#----#----#----#----#----#----#----#----#----#----#----#----#----#----#----#
#--#-#--#-#--#-#--#-#--#-#--#-#--#-#--#-#--#-#--#-#--#-#--#-#--#-#--#-#--#-#--#-#--#-#--#-#--#-#--#-
-#----#----#----#----#----#----#----#----#----#----#----#----#----#----#----#----#----#----#----#---
----#----#----#----#----#----#----#----#----#----#----#----#----#----#----#----#----#----#----#----#
#----#----#----#----#----#----#----#----#----#----#----#----#----#----#----#----#----#----#----#----
----#----#----#----#----#----#----#----#----#----#----#----#----#----#----#----#----#----#----#----#