---#-#-------#--#------#---#------####-#----#-----##-#--------#---###--##-#--------#----#--##---#---
-----#----#-#-##---------#-##-#-#-#-----#---#---#------#--#---#---#------##-#----#-##------##-#--#--
--#----#-----#--#--##---#-#--#-###-###---##----##--#--#----------#-#---##--#---#------#-#--#-----#-#
--#-##------#-##-----###-------------###--------##------#--##-#-##-----#-----#---#-#----##--#-####--
--##-----#---#--###--#--#---###---------#--#---#--#---------------#-##-#-###--#-#--#--##--##-------#
#---#-#--#-----#------#---#-#---##--#----#-#-----#--#----###----------#-##----#--------#-##-#---#---
----#-#---##------#---#--##--#-#-----#-##-#-#-#-##--##-------#---##--##---##-------#-#----------#-#-
--------#-----##---#----#--##------#-----#-##---#-#----######----#-#---#---#--##-#-----#--#-##-----#
------#-----------#---#-#-#-#---##----------##--#--#----#------------#---##--#----#----#------#-----
#--#--#------#-#---##---#---------#-----#--#-##--#----------##--#---#--##--###---#--#-##---##-#-----
#--##--#-#------#--#---#---#--#----##--#-##--#-##---#------##-##-#-----##-##-#-#-----#-##---##------
----###-#--#-#-----#-----##--#---#-------##--##----#---#-#-#----#--#-----##-##--------#-#--#-#-##---
#-#-----##-#--#---#-##--##-##--##-#------#-#-#--#---#--------#--#-##----#---#-------#---#-#----#--##
#-#---#-#-#------#-#-#-#-#--------###---##---#-#-##--##------##--------#-#---#--#---#---#---#-#--#--
#-####----#-#---#-#---#-#-#--##--#--##-#-##-#----#-#--#--------#---------#-#-#------#--#------#-----
--------------------##---#--#--#---------#----#--#--------#--#-#-#-##-----###-------####--#------##-
-------#--##-----#-##--#--#-##--#-##-#------#-###--#-#-----##---##----#------#-#--#--#-#-----#---#--
----##-----##-------#---##--#-##-##--#--#-----#-###-##--#-----#--#-#-----#--#----#-------##-#--###-#
---###---#--#-#--#--##-#--#-----#--#-#-#---#-#-#-----###-#---#--#----####--#-#-##---###-##-#---###--
--#---####-#---###-##--#--##-##---------#---#---##----#----#---#---------#--#---#--#-#-###-##----#--
--#----------#---#---#------#----#---##---#--####---#-##----#-#-----#-#--##----#----###-------##----
-#-----#----#-##-----##------###-#--#--#-----#---#----#-#-#-#---#------------#-##-----##---##-##---#
-------#-----##------#------#--#--##-##-#----##----#--#-----##-----#-----#------#-##-----#-#-#------
-##-----#----#------#----#---------------#----------##--#---#------##--#--#-------#---#--##---------
-#----#----#-#-----#--#--------#-##-##-#----#-------#--#####----#----------###-#-#--##--####-##--#--
#----###-----------#-------#-#-####--#------##--#-#--##---##------##--#---------#----##------#---##-
----#-#-#------#---#----#---#-#--##-------##-#-#-#--#--#-###-----#-#--#--#-----#------------------#-
------##--#-------#-#-##-#--#-##-##-#----#-#-#---------##-----#---#----#--#------------#--#-##----#-
###--##--#-#----#---#-#-#----##----#---------#---------#-#--------#-#-#-###----#-#----#--##-####--#-
-#-----#--##---#--#---#-#-#---#------#----#--#---#-#--#-##-##-#-----#-##---#-#-#--##-#---#-#--###--#
--#-#----#----#-#-##----##--#-----------#-#--###------#-----#-#-##-#----#--#-#---##--#------#-----#-
------##--#-##------###---#---##-###-------#--#--#---------------#---#---#######--#--------------#-#
---#-#-----#-##---#----#--------#---##-#--###--#---#--#-----##-#------#---------#-#--#--------#-#---
#---##----##-##--###-----##-#----------------#-##-#--#-#--------------#----#------#-#-#--#----------
--#-##--#----#--##-#-------#-##-#----#--#----#-------------#------#----#---#----#------#--###-----#-
--#--#-#----####---##-----#------#--------#----#------##---###-#----------###--#####----#-------#--#
-#---#-#----#----#-#------#-##-#---------#-#-----####------#-#-----##---#----------------#-#--#---#-
#--#---#----#-------##--------##--##--#-------#-##-#----#---#-----------#-------#-#---#------#--#-#-
###-#------#-#--#-###-#-##--#-##----#---------#-------#--#-----#--##--#--##---#-------#-#-----#---#-
-#-###-#---#--#-----#--#------##----####-------#-##----#-##----#-##-------------##---#-###---####-#-
------#-####-##------#-#----#####-------#--##--##---##-##-###-------#-##--------#-----#--#--#-#----#
-----#--#-##-#-#-#---#--#----#-#--###----#-#----#--##------#--##-#---##--##------#---------#---#----
#-#--#---#----#----###---#-#---#---#---#----#--#----#--#--#-#--------#-#-#---###------###-#---S##--#
#----#------#---##-#------#----------#-##-###-#---#-#---#--#-#---###--#----#--#-#---###--#-----#-##-
----#----#---#-##-------#-#--#------#--#-##-##-------#---#-----#-#-----#-------#--#-#--#--#--#-##---
-#---#----##-#---#--#-#----##-#---#---#-#--##---------------###-###---#--##----------###---#--##---#
----#------#-#------##-#-#------------#------#----##---#-------#----#-#-------#---#-##---#-----#----
--#--------------#------#-#---#--#-#-#-----##--##---------###----#-#--####----###----##-##--##--##--
-##-------#-#--------------#-##-#--##---##-#---------#-##--#----#---#------#---#--#--###-#----#-#-#-
-#-#-------#-------#---#-#-#----#----#----##-#-----#-##----#----#-#-------###--#---#-#-----#####-#--
-#-#-----#------#--#--#-#--##---#-----#------#-#--##--##--------#-------#--#------------#----#---#--
---#-#----#-#-#-#-#--#--#-------#--###------#--#--#--#----------##---#------------##-#---##-----#-#-
--#---#--#--###------#-------##--------##-------#----#--#------#-#-#--#-###------###----#----#-#----
#-##-#---#-#--#-#-##-#--#----#-#--#---#----#-#-#---#-#-#-#-####-#-#-#-#-#----##-#--#--##--#--#---###
##-------#--#---#---#---#---#-#-##-----------#--------#-#--###--##-#-#-#-#-#---#-#------##--#-##----
----#-#--------------#--#----##-##---------#-#-----#-#-##-###---#---#-----#-----E#--#-----#-----#--#
--#-----##----#--------#---------#--##------#####--#-#--#-#----#--##-####-#-----#--#---##---#-----##
-------#-#---#-#-#--#----------#------#-#---##-#---#-###-##-----##-#--#-##--##---#---#----#-------#-
-#-#--#####-----###--###--##--#-----##--------#--#-#-#----#-##----#-#----#----##---#--#---#--#-#--#-
----#----##--##-###-----###-#-#-###------#--#-##-------##--#---#---#-----#-#-------#-###------------
---#-----###--##-#----#--###----##--#-##-#-##-#------#-#----------##--####-----#----#-##--##-##-----
---###-##--#-#-###--#---------##-----##---#--#---#---###-#-----#--#--#-##--#--#-----####--#-##--#---
#-#---#-#----##-##-##-#---------##-###----#----#-------##--#---#-#-#--#----#------#---#-##---------#
----#-----##----#-#-##-##-###-------##-----#---##-#-#---#--#---------#-#---#-#---##--#--#---#--#--#-
#--#-----#--##---#-#--#-##-#--#----#----#-----#--#--------#-#---#-##--##----#--#------##----##--#-#-
-#-###-##----------#--##-#-------#--#-#------##---#--#--#--#-#-#-###-#--------####-#-#-----##--#--#-
#---#---#--#--#-##--------#----######--#-#-#----###----#-------#-#--#----#-#-#---------#----#-------
-###-#--#--#---------#--#--#-#-##-------#-------##--------#----#--#####-------##-#---#-##-##--#-----
---#-##-----#--###-#---#--#--#--#--####---##-#--#--#---#-#--#-##-#-##---#---#---#----##--#-----#----
-#------##----#---##--#--#---##---#----##----#-------------#----##---#-------#-#--#--#--#--#---##---
-------#--------------##------#---##-#--####-#--#-#---#-#----#-#-----##------##---------------##--#-
--#---##------##---#-----#-------#---#-----#------#--#-#--#-###----#----------#-#-------#----#----##
#-------#--#-###---#----#-#---###-----#######--------#------#------------#--------#--------#---#-###
-----#---#----------------------#-#-#-----##--###----##-####-#--#--------------#-####-#-##----##-###
-##----###------------#-#---------##-##-#------#--#-##-----###-#--#--#-#-#--#--##--#---##--###-#--#-
-#----------##--####-##---##-#---#---###-#-#--#---#--#-#--##-----#-##----##-#------#-#-----##-#--#--
--#--------#-##-----------##-----#---##---###-##-##-#-#----##--------#------#--#---#-#--------#--#-#
---#---##-###--#----##---#-#--#-------#--#---#-##-#--#-#--#-----###-##-#-----#--#------#--#--#---#--
#-#----##-----###--#---#----###-#-#--------------#-----------#----#----#-#-#-----#------##-##---#---
#---##--#---#--#-#----------###------#---##----#----#-##-#####------------#----#####---###--#---#--#
-#---#--##-##----#---#-------#--#-###-#-----#-##---#-#----##-#--#---#--#----#--#------##--------##--
--##---#----##-#--#----#-#-----#--#--------#--#--##-----#-#----#--#-#-----#-#-###---##-#----##----##
#----#---#-#-#--##-#----###----------#-#-##---#----------##--##----#-##----#-#---#---------#-###----
--#-------#-------#-##-------#--##-----##--#----#-----#-#------#---##-------#-------##-------#----#-
--##-###---#--##---#--##--####--#------#-#----#--##-##-#--#-#---#-----###-##--#-----#-#-------#-----
---#------####--#-#------------#--------------#-#-#---##-#-#-----##--#------#--#--#-#--###----------
--#-##--#--##-#-------#--------###-####--##--##-#-----##---#--#---##--#-----#----#------#---------#-
##-#----#-##----##----#--#--------#-##---#------#---#----------------#-##--#--#----#--#---#-###-----
##----#-#----------#-#--#---#-#---##--#-#--#-#-#---#---##--#--#------##-----------##--#----##-----##
-##----#------#------#-----#-#-#-#-----##----#-#----#---##------#--##--------#--#-#--#----#-----####
-##---#---------#---##--#----#------#---#--####--##--#---##-####-####-#-###--------#--#-#--#--------
---#-#----##--#-------#-------##-----#--#-#---------##-------##-###---##--#---#---#-#-#--#-#----#---
---######--#--#--###-#--####-#--#--------#--###----#-#--#---#----#-----#-#-#---##---###-###-#--#-##-
#-#---##------#-------#-----##-#-#--#-----#-#------#--#--------#---##-##---------------#-#-#--#-###-
-#---#-#---#----------#-#--------#---##-#--#----------------#--##-#----#--#-#---##----------##-#----
----#-###--##----##----#--#-#-##--------###-----##---#----###--#-#-##-----#--------#-#----#-----#---
#-#-###----#-#------#-----#-#----#------#----#---#--#--##-------#---------#---##---#-#--#-#--#--##-#
##-#--------#-----#------#-#----#--##-###--#----#-#---###-#----#--##-#-#-##-#-#---#--#-------#--#---
-#-##--------#--##---#--#--#-#-#----#---#----#--#-#-----------------#--#--#-----#---#---#------#--##
------#---#-#------#---##---------#-##---#--#--#---#--##--------#-#---####-#------------------#-----