#--##--#----##-##-#----#---##-----##-#---##-#--#-----#-#--#-#----#--#----#-----#--#--###--#---#----#
----##--#-#-#-#---#-#--#---#-#--###-----#--###----#-#----##--#---##---#------#-#----#####-----------
---##--##--#---#--####---------#--------#-#-#-##-------------#-#-#--#---#-----#---#----#-####--##-#-
#----#--#---#-#-----#-------##-#-#------#-##-#-#---##-#--#-------#-##---#-----#---##------#----###-#
----#--------###-------------#---------###--##-----#-----#-#--##------#------#---#--------#------##-
----#-----#-#---#----#-#---#-#-------###-##----##--#####---#-#---#--#----#----##---##---------##-#--
-#----------##-------#-#-----#---##---#--------#-----##------#-#-------#-------#-#-#---#-##-----#-#-
---#----#--#--------#---#-----#-#--#--#---#------#------#--##-----#---#-#--#---##--####------#--#---
-#--#-------###--#-------##------##--#-#----###-##-###-#--##----------#-----#---##---#-#-#--#-------
##--------#----#-#--#-#-#---#--#------#------###--#---#---#--##---#---------#-#-----###-#----------#
#-#--#----------#-#---##-##------#-#--#-##-##--#-------#--#-###-#--##---#---#---#--#----#---#---##-#
---##-#-#-##-####-----##-#-#-#--##----#-----##--#-#----#------#-##---#---##-#---#-----#-###--##-----
###--##---#--#--#--#---#--#--#--------------##--#-----##--#------#---###-#--#--##--#--###--#----#--#
##---##-##--#--##-##----##--#-----####--##------#--###--###----#----#----#-#-#-#---------#---#---#--
-#-#---#--#--###-#--#---#-----#--#-#----#-#-##-#--------#--------#-#-#------##--#-##----#---###-#-#-
----------##----#-###--#--##-###-------------#--#-#--#-#-#---#---###--##-#-#--------#-----#-----##-#
#---#-#-#---#--#--#-----##-#--#--------------#--#---------#----#------#-----##---##----------#-#--##
-----#-----##--#---##----#-#----#--------------#-#--#---#--#-#-------##--#-##-#----#-#-#--#-----##--
##----#--#-----#--#-#-#-##--#----##----#--##-#---#-#-#-##---------#--#-#------##-#-###-------#---##-
---####---#-#--##---#-----#--#-#--#-#-------#--#---#---#-##--#----#---###-------------------#-------
---#--#-#--###--#------#-#-#------##--------#-#--#--####--------------#-#--#---#--###--#-#--#---#---
##--#--#---#-----##--#-#-##---#--##----#----#-#-#--#--#-##----##-#--#---#-#--#----#--------##-##-#--
-##--#------#-------#--#--#----#-#------#--------###---#---------------#---##-----###---#-##--#-##--
#-----------###-----##--#-###---#-----##-##-------------#----#-#--#--#--####--#-#-#----#-#-##-#---#-
-----##---#-##----#####------##--##---#----#-#----#-#--#----#----#-#------##----##-#-#---------#----
-#---#--#--------#-##-#-##--------------------#------#-#-----#----##------------#-#-###-###-#----#--
----###--------#--#-##-#-#-#--####-#---------##-##----#-#---###------##---#-----#-#------#--#-##----
#-#-####---------#-#-----------#-##--#-####---##-----##-----------##----###-#-#------#-----#------#-
-------#----##-#--#----#-------#--##-#-----##-#-##--------#--------###----------#----#-#-----##---#-
----##-#-------##--#--#--##-------#----S--#--###--------#---##------###------##-#--#--#--#-#-#------
--------####----------#-----------#---#----#-----#--##---##----#-#-###--##-#------####-------#--#---
-#----------#--#----#-#-##--###--#--#-#-----#-####-----#---#--#---#--#-#---------#--#-#--------##-##
-#--#-###-##--#---#-----##--#--#--#------##-#---------#-------#--##--####-----##-##---#---#-------#-
#--------------#-----#--##-#-###----#---#---#-##-#---------#--------#---#--#-##--#--##-----#-----#--
---#---#--------------#------#---#-#-##-##--#-#---#--####-###--#---##-##-#------#-#--##-##-#----#---
###------###----#----##-#--#-#---#--#-----##--------#-##---#----#-----##-#------######-#---#----#---
###---#-E--#---#--#---####-------#----##-#-------##---#--------#--#---#--#----##--#-#------#--------
##--#--##----#---##--#------#-##----------#---#----###--#-------#---##-----#-#-----#----------##--#-
-------##-###-#----#----#-###-#-##-#---#--#--#----##-#---#-----------#-#-##--#-###-----##---#---#-#-
#---###-#--------#-#---#--------#--------#----##----------##----###---#--##----#----#-##--#---###--#
##--#--##--##---##----#---#------#--#----###---#-#---#-##-##-#--##-###----#--#-#-#---#----------##-#
#----#-----##-#-#-#---#--#####-------##---####--#----------##-----------#-###----#-#---#---##---#---
---#--#-#----###-----#--#-##-#--------#-#------#--------#-#-----#----#-#----#---##----#----------#--
-#----#-#-#-##----------#------#-##--###-#-----#####-##----#----#-#-##--#---#-#-----#-##-----#-#----
-#---#----##----##----#-#---#--------##---#--#-##------##-##-------##-----------#####-##----#--#-##-
##-----------#---#---#-------#-#-###--------#--#---#--#----#----#-----#---------#---#-#-------#--#--
##-##-#----####------#---#-##-#----------#-#----#---#-#---##---------##--#--#---#---###----#---#----
-#------#----#-#-----#-#-#--##-------------##-#---##--#---#-##----###---#------#--#----#-#-#-#-----#
-#----------#-#--#--#-#-#----#-##---##----#--#-#--###------#--#-#-----##--#----#--#------------#--#-
#-#-------#----#-#-#--##--##-----##---#---#--#-------#----------###----#-###---#-----#-#------#---#-
-#-----###-##--#---#--------#-#-----#-#--##-#------###-----------##---###-#--##-#---#--------#-----#
-#-----#----##-#-#------#----#--##-##--##------##-----------------------#-------#--#--##--#---##-#-#
-###---###-#-###--##---#------##-#---------#---####-#-#-#--------#------------------#-------#-#-----
---##-##--#-##-#-#--######------#------#-#-#-##-----#---#----#-#-##------#-##----#---#-##--#------#-
----#---------#-----#---###-------#-#-###------#---##-#-#####--#----##--##-----#---#-##-#---#-------
#------##-#-#---#-##---#-------------##----##--#--#--#-----#-#------##----#-----#---#----#---#-##---
##--##--#-----#---#---##--------#---#-#----#-------------##------#-#----####--#-#-#---#-------#---##
-------#-------#-----#---#--------###---##------#---#-------#-#--###--#--------#-#-####--------#-#--
--#------##---#-----#--#----#-#-----#-------##-----------#-#-----#----###-#--------#-##------------#
##--#----#--#-----#-#--#--#---#-##--#--###-#-#--#----------#---#---#-----#----#-#--------##----#----
-#--###-#-----#-#-#---------#--##-#------#-#-------#--###--#---#----##---##--#---###----###-----#--#
-##-#-#---#-----#-------##-#-------------#-#-------#--##----##--#-#------###-##--------##---###-##-#
-#--#----------#----------#------#----#-##--------#-##-##-##---#--#--#-#-----###----------#---------
---#-----#---###--#----####-####--##--#----#---#--#--######-#--##--#-----#-#------####-----#--#-----
-##-----###------#--#-####-#--#-----------####-#--------#-#-----#---##-#---#--#---#--#--#----#-##---
---#----#-----#-#-----#---#--#-------#-#--------##---#-#----#--#-#-#--------#-#-#-----------##------
---#-##--#-----#--##--#--------#---------------##-##-#---###-#--#-----#--##-#-#--#-#-#--#-#-##-----#
---##---###---#-###---#-------#-------#--#-#--##--###-#-#------#-#-----#---#-#---#---#--#--#----#-#-
-#--#-----###--#-#-------###----#----#---#------#---#-#-#-------##----#----------#---#-####---#---##
-#----#-#--##-##--##-#-#####----#----#---------###--#---##-----#---##---------#-------##------#--##-
##-##---##-#-##-#----#----#------#-#-----###-------#--#---------##------#---#-------#--#----#--#--#-
----#---#------#--#-------------###----###-----#-----#----#--#-#----###---#-#-------#-------#--#---#
##-#-#-#--#---#----#---#-#--#-#----------#----#-----------#-#----------#--#-##----------#--#---##---
--#---#---#----#-#------###-----#---##-###-------------#---##-#--#-###-#----#--#-----##-----##---#-#
------##--##-#------#-#---##-#-#---##--###-#--#-##-#--#----#--#-##-#-----#---##-##-----#--#----###--
-##-----#---####-###--------#-----#---------#-#---#-##---#--#--------#-#---#----#--#-##--#--#--###--
--###-##-##-#---##-#----#----##-#-------#----#--####-#-##-#-------#--######-##-###-#-#-#-#-##-##----
#-#--#-##--#---------------#---#---#-#------###----------#--#-#-#-----#--#-##-####---#-##-#-##--##--
-##-----#----#---#####---##--#-#--#----------###-----#--#-##--#----#-----#---#--#-#---#----#----#---
--#--#--------#---##--#---#-#-##----#----##-------#--#-#--#--###---------#----#------------#-#------
#---###-#-#-##----------#-#----------------------#--#-#-----##----#-------##------###----##----#-#--
##---#--------###-------#---------------##--#-------#-#---#-#--####-#--#-#--#---#---#-------#----#--
--------##----##---#-#----##----#--#-##-----####---#---#--#-#---#------###--#-#-#-#--##---#-##--####
#-#--#-##----------------#---#--#--###--#-###-#-#-#-##------#---##--###-#-----#-----#----##-#-------
###----------#-#-------###---#----#-##-#-#---#--#-###-###----#--#--#--------##-####-#---###-#--##---
#---##---------------#-#--#---#-----#---#-----#-#-##---#---------#-----#--##--###-##-------#--#-##--
--#--#####---###--------------#--#---#-##-#-#-##---##----------#----##-##-#-#----#----#----#--#--#--
---------#-----------#---#-#--###--#--------##---------#-#-------#-#-#-----#------#---#--#----#-#--#
-##----#-##-####--#---##-#--------#----#------###--#--##------##-----#--#-#-----#---##-#---##-#--#--
#-##----#-##----#-####-#------##-----#----#-##-----#---#--#--#--#----#--#---#---###--#-----##-##----
-#--##-#---###-#---#--#-#---#--#--#--###-##--------#-##-#--#--##--##---#-----##--##--#-#----#-------
---#-#--##--###----#--##--##------#-##-#---#---#-##-#-#------------##---#---#-----###------#----#--#
-#-----------------#--#-------#--#--#---------#--#--------##----#------#--#-#-------###---#---#-----
------#-#---#--#-##-#----#--#---##-#-----#-#-----------#----#----#--#-#--###--##-#--#-----#-###-##-#
#-------##----------##-###-#--------##--##-######----#--#------#-#--#-#---##-#----##-#------##-#----
-##-#-#--#------##--#-#--#---#-#-#--#-------#--#---#----#--####-##------#-#-------#------#-#-----#--
--#---##-##---------#-#-#-#-#-#-##--#---#------#-#-------#-#----#-#--##-#--#-#-----#--##--#--#---###
##---#------#-----#-----#---#--#-#-#-----##-#--#----#---#------#-####-#----#---#-#----#----##---##--
---#--##------#--#----##--####-#-#---#-----#--#--##---------#-#-#------#-#----#--#-#-##----##-------
#-##--#-##---#---#--#---###----##-#-----------#-#---#--#-----#-----#--#--------#----#-----#--#------