--#-#--#-#--#-#--#-#--#-#--#-#--#-#--#-#--#-#--#-#--#-#--#-#--#-#--#-#--#-#--#-#--#-#--#-#--#-#--#-#
#----#----#----#----#----#----#----#----#----#----#----#----#----#----#----#----#----#----#----#----
--#-#--#-#--#-#--#-#--#-#--#-#--#-#--#-#--#-#--#-#--#-#--#-#--#-#--#-#--#-#--#-#--#-#--#-#--#-#--#-#
---##---##---##---##---##---##---##---##---##---##---##---##---##---##---##---##---##---##---##---##
----------------------------------------------------------------------------------------------------
--#-#--#-#--#-#--#-#--#-#--#-#--#-#--#-#--#-#--#-#--#-#--#-#--#-#--#-#--#-#--#-#--#-#--#-#--#-#--#-#
#----#----#----#----#----#----#----#----#----#----#----#----#----#----#----#----#----#----#----#----
--#-#--#-#--#-#--#-#--#-#--#-#--#-#--#-#--#-#--#-#--#-#--#-#--#-#--#-#--#-#--#-#--#-#--#-#--#-#--#-#
---##---##---##---##---##---##---##---##---##---##---##---##---##---##---##---##---##---##---##---##
----------------------------------------------------------------------------------------------------
--#-#--#-#--#-#--#-#--#-#--#-#--#-#--#-#--#-#--#-#--#-#--#-#--#-#--#-#--#-#--#-#--#-#--#-#--#-#--#-#
#----#----#----#----#----#----#----#----#----#----#----#----#----#----#----#----#----#----#----#----
--#-#--#-#--#-#--#-#--#-#--#-#--#-#--#-#--#-#--#-#--#-#--#-#--#-#--#-#--#-#--#-#--#-#--#-#--#-#--#-#
---##---##---##---##---##---##---##---##---##---##---##---##---##---##---##---##---##---##---##---##
----------------------------------------------------------------------------------------------------
--#-#--#-#--#-#--#-#--#-#--#-#--#-#--#-#--#-#--#-#--#-#--#-#--#-#--#-#--#-#--#-#--#-#--#-#--#-#--#-#
#----#----#----#----#----#----#----#----#----#----#----#----#----#----#----#----#----#----#----#----
--#-#--#-#--#-#--#-#--#-#--#-#--#-#--#-#--#-#--#-#--#-#--#-#--#-#--#-#--#-#--#-#--#-#--#-#--#-#--#-#
---##---##---##---##---##---##---##---##---##---##---##---##---##---##---##---##---##---##---##---##
----------------------------------------------------------------------------------------------------
--#-#--#-#--#-#--#-#--#-#--#-#--#-#--#-#--#-#--#-#--#-#--#-#--#-#--#-#--#-#--#-#--#-#--#-#--#-#--#-#
#----#----#----#----#----#----#----#----#----#----#----#----#----#----#----#----#----#----#----#----
--#-#--#-#--#-#--#-#--#-#--#-#--#-#--#-#--#-#--#-#--#-#--#-#--#-#--#-#--#-#--#-#--#-#--#-#--#-#--#-#
---##---##---##---##---##---##---##---##---##---##---##---##---##---##---##---##---##---##---##---##
----------------------------------------------------------------------------------------------------
--#-#--#-#--#-#--#-#--#-#--#-#--#-#--#-#--#-#--#-#--#-#--#-#--#-#--#-#--#-#--#-#--#-#--#-#--#-#--#-#
#----#----#----#----#----#----#----#----#----#----#----#----#----#----#----#----#----#----#----#----
--#-#--#-#--#-#--#-#--#-#--#-#--#-#--#-#--#-#--#-#--#-#--#-#--#-#--#-#--#-#--#-#--#-#--#-#--#-#--#-#
---##---##---##---##---##---##---##---##---##---##---##---##---##---##---##---##---##---##---##---##
----------------------------------------------------------------------------------------------------
--#-#--#-#--#-#--#-#--#-#--#-#--#-#--#-#--#-#--#-#--#-#--#-#--#-#--#-#--#-#--#-#--#-#--#-#--#-#--#-#
#----#----#----#----#----#----#----#----#----#----#----#----#----#----#----#----#----#----#----#----
--#-#--#-#--#-#--#-#--#-#--#-#--#-#--#-#--#-#--#-#--#-#--#-#--#-#--#-#--#-#--#-#--#-#--#-#--#-#--#-#
---##---##---##---##---##---##---##---##---##---##---##---##---##---##---##---##---##---##---##---##
----------------------------------------------------------------------------------------------------
--#-#--#-#--#-#--#-#--#-#--#-#--#-#--#-#--#-#--#-#--#-#--#-#--#-#--#-#--#-#--#-#--#-#--#-#--#-#--#-#
#----#----#----#----#----#----#----#----#----#----#----#----#----#----#----#----#----#----#----#----
--#-#--#-#--#-#--#-#--#-#--#-#--#-#--#-#--#-#--#-#--#-#--#-#--#-#--#-#--#-#--#-#--#-#--#-#--#-#--#-#
---##---##---##---##---##---##---##---##---##---##---##---##---##---##---##---##---##---##---##---##
----------------------------------------------------------------------------------------------------
--#-#--#-#--#-#--#-#--#-#--#-#--#-#--#-#--#-#--#-#--#-#--#-#--#-#--#-#--#-#--#-#--#-#--#-#--#-#--#-#
#----#----#----#----#----#----#----#----#----#----#----#----#----#----#----#----#----#----#----#----
--#-#--#-#--#-#--#-#--#-#--#-#--#-#--#-#--#-#--#-#--#-#--#-#--#-#--#-#--#-#--#-#--#-#--#-#--#-#--#-#
---##---##---##---##---##---##---##---##---##---##---##---##---##---##---##---##---##---##---##---##
----------------------------------------------------------------------------------------------------
--#-#--#-#--#-#--#-#--#-#--#-#--#-#--#-#--#-#--#-#--#-#--#-#--#-#--#-#--#-#--#-#--#-#--#-#--#-#--#-#
#----#----#----#----#----#----#----#----#----#----#----#----#----#----#----#----#----#----#----#----
--#-#--#-#--#-#--#-#--#-#--#-#--#-#--#-#--#-#--#-#--#-#--#-#--#-#--#-#--#-#--#-#--#-#--#-#--#-#--#-#
---##---##---##---##---##---##---##---##---##---##---##---##---##---##---##---##---##---##---##---##
----------------------------------------------------------------------------------------------------
--#-#--#-#--#-#--#-#--#-#--#-#--#-#--#-#--#-#--#-#--#-#--#-#--#-#--#-#--#-#--#-#--#-#--#-#--#-#--#-#
#----#----#----#----#----#----#----#----#----#----#----#----#----#----#----#----#----#----#----#----
--#-#--#-#--#-#--#-#--#-#--#-#--#-#--#-#--#-#--#-#--#-#--#-#--#-#--#-#--#-#--#-#--#-#--#-#--#-#--#-#
---##---##---##---##---##---##---##---##---##---##---##---##---##---##---##---##---##---##---##---##
----------------------------------------------------------------------------------------------------
--#-#--#-#--#-#--#-#--#-#--#-#--#-#--#-#--#-#--#-#--#-#--#-#--#-#--#-#--#-#--#-#--#-#--#-#--#-#--#-#
#----#----#----#----#----#----#----#----#----#----#----#----#----#----#----#----#----#----#----#----
--#-#--#-#--#-#--#-#--#-#--#-#--#-#E-#-#--#-#--#-#--#-#--#-#--#-#--#-#--#-#--#-#--#-#--#-#--#-#--#-#
---##---##---##---##---##---##---##---##---##---##---##---##---##---##---##---##---##---##---##---##
----------------------------------------------------------------------------------------------------
--#-#--#-#--#-#--#-#--#-#--#-#--#-#--#-#--#-#--#-#--#-#--#-#--#-#--#-#--#-#--#-#--#-#--#-#--#-#--#-#
#----#----#----#----#----#----#----#----#----#----#----#----#----#----#----#----#----#----#----#----
--#-#--#-#--#-#--#-#--#-#--#-#--#-#--#-#--#-#--#-#--#-#--#-#--#-#--#-#--#-#--#-#--#-#--#-#--#-#--#-#
---##---##---##---##---##---##---##---##---##---##---##---##---##---##---##---##---##---##---##---##
----------------------------------------------------------------------------------------------------
--#-#--#-#--#-#--#-#--#-#--#-#--#-#--#-#--#-#--#-#--#-#--#-#--#-#--#-#--#-#--#-#--#-#--#-#--#-#--#-#
#----#----#----#----#----#----#----#----#----#----#----#----#----#----#----#----#----#----#----#----
--#-#--#-#--#-#--#-#--#-#--#-#--#-#--#-#--#-#--#-#--#-#--#-#--#-#--#-#--#-#--#-#--#-#--#-#--#-#--#-#
---##---##---##---##---##---##---##---##---##---##---##---##---##---##---##---##---##---##---##---##
----------------------------------------------------------------------------------------------------
--#-#--#-#--#-#--#-#--#-#--#-#--#-#--#-#--#-#--#-#--#-#--#-#--#-#--#-#--#-#--#-#--#-#--#-#--#-#--#-#
#----#----#----#----#----#----#----#----#----#----#----#----#----#----#----#----#----#----#----#----
--#-#--#-#--#-#--#-#--#-#--#-#--#-#--#-#--#-#--#-#--#-#--#-#--#-#--#-#--#-#--#-#--#-#--#-#--#-#--#-#
---##---##---##---##---##---##---##---##---##---##---##---##---##---##---##---##---##---##---##---##
----------------------------------------------------------------------------------------------------
--#-#--#-#--#-#--#-#--#-#--#-#--#-#--#-#--#-#--#-#--#-#--#-#--#-#--#-#--#-#--#-#--#-#--#-#--#-#--#-#
#----#----#----#----#----#----#----#----#----#----#----#----#----#----#----#----#----#----#----#----
--#-#--#-#--#-#--#-#--#-#--#-#--#-#--#-#--#-#--#-#--#-#--#-#--#-#--#-#--#-#--#-#--#-#--#-#--#-#--#-#
---##---##---##---##---##---##---##---##---##---##---##---##---##---##---##---##---##---##---##---##
----------------------------------------------------------------------------------------------------
--#-#--#-#--#-#--#-#--#-#--#-#--#-#--#-#--#-#--#-#--#-#--#-#--#-#--#-#--#-#--#-#--#-#--#-#--#-#--#-#
#----#----#----#----#----#----#----#----#----#----#----#----#----#----#----#----#----#----#----#----
--#-#--#-#--#-#--#-#--#-#--#-#--#-#--#-#--#-#--#-#--#-#--#-#--#-#--#-#--#-#--#-#--#-#--#-#--#-#--#-#
---##---##---##---##---##---##---##---##---##---##---##---##---##---##---##---##---##---##---##---##
----------------------------------------------------------------------------------------------------
--#-#--#-#--#-#--#-#--#-#--#-#--#-#--#-#--#-#--#-#--#-#--#-#--#-#--#-#--#-#--#-#--#-#--#-#--#-#--#-#
#----#----#----#----#----#----#----#-S--#----#----#----#----#----#----#----#----#----#----#----#----
--#-#--#-#--#-#--#-#--#-#--#-#--#-#--#-#--#-#--#-#--#-#--#-#--#-#--#-#--#-#--#-#--#-#--#-#--#-#--#-#
---##---##---##---##---##---##---##---##---##---##---##---##---##---##---##---##---##---##---##---##
----------------------------------------------------------------------------------------------------
--#-#--#-#--#-#--#-#--#-#--#-#--#-#--#-#--#-#--#-#--#-#--#-#--#-#--#-#--#-#--#-#--#-#--#-#--#-#--#-#
#----#----#----#----#----#----#----#----#----#----#----#----#----#----#----#----#----#----#----#----
--#-#--#-#--#-#--#-#--#-#--#-#--#-#--#-#--#-#--#-#--#-#--#-#--#-#--#-#--#-#--#-#--#-#--#-#--#-#--#-#
---##---##---##---##---##---##---##---##---##---##---##---##---##---##---##---##---##---##---##---##
----------------------------------------------------------------------------------------------------
--#-#--#-#--#-#--#-#--#-#--#-#--#-#--#-#--#-#--#-#--#-#--#-#--#-#--#-#--#-#--#-#--#-#--#-#--#-#--#-#
#----#----#----#----#----#----#----#----#----#----#----#----#----#----#----#----#----#----#----#----
--#-#--#-#--#-#--#-#--#-#--#-#--#-#--#-#--#-#--#-#--#-#--#-#--#-#--#-#--#-#--#-#--#-#--#-#--#-#--#-#
---##---##---##---##---##---##---##---##---##---##---##---##---##---##---##---##---##---##---##---##
----------------------------------------------------------------------------------------------------