#--#-#--#-#--#-#--#-#--#-#--#-
--#----#----#----#----#----#--
----#----#----#----#----#----#
--#-#--#-#--#-#--#-#--#-#--#-#
------------------------------
#--#-#--#-#--#-#--#-#--#-#--#-
--#----#----#----#----#----#--
----#----#----#----#----#----#
--#-#--#-#--#-#--#-#--#-#--#-#
------------------------------
#--#-#--#-#--#-#--#-#--#-#--#-
--#----#----#----#----#----#--
----#----#----#----#----#----#
--#-#--#-#--#-#--#-#--#-#--#-#
------------------------------
#--#-#--#-#--#-#--#-#--#-#--#-
--#----#----#----#----#----#--
----#----#----#----#----#----#
--#-#--#-#--#-#--#-#--#-#--#-#
-------------------S----------
#--#-#--#-#--#-#--#-#--#-#--#-
--#--E-#----#----#----#----#--
----#----#----#----#----#----#
--#-#--#-#--#-#--#-#--#-#--#-#
------------------------------
#--#-#--#-#--#-#--#-#--#-#--#-
--#----#----#----#----#----#--
----#----#----#----#----#----#
--#-#--#-#--#-#--#-#--#-#--#-#
------------------------------