-------#-#-----##------#----##--##-#-##---#----#-##-##-------------#-###----------#---#-#---##------
--#-----#--#---#---------#--------#-#-#--#-#-#####---#-#---#-#--#-----#-----#-#--##----##-----------
---#-##----------#--##-#-#-##--##----#--#-#-##--###---#----#--#-#----#--#-------------###-##--#-#-#-
-##-----------#----#-----------------------------#-#--#-#--#--#--------#---#---#-----##---#-##-----#
----#-#------###-#------##-------#----#----#-#-###---#-----#----#-----#--#-#---#-#-----#-#-#--#----#
---##--#--#---#--#-------##--#--#------------###--#-##-#-----##-----###---##--#-----------###-------
---#-#----------------#-#-#---#----#-----##----#-###--#-##-----#-#-----#----###--#--##-----#---#----
#-----#-#---###---------------#-#-#-#-----###----#-#-----#--#-----###-----------#---#----------#-#--
#---------##-##----#-#-----------#-##----#--#----####-##-#--#--###-----#-#------------#-----###-----
-----#-----#--#--#--#---#------##------#-------###--#--#--#-#-#----#------###---##-#--#-##---------#
#--#-----#--#--#-#------##-#-#---#--##--#-#---------#------------#-----#--------#---#--#-#--#-#--##-
##-------#-#--------#--####---#-----#--#-#-##--#--#----#-#---#---###----#---##----------------#--#-#
-----####--###--###--#-##-#-#--#---##-##-###---------#---#---------###-##--#------#--####-#--#---##-
----#-----#-##---##--------##----------##-#-#--##--#--##--##--------##----#--#----###----##-#-#---#-
-----#--#-#-----#---###--#---#---#----#-------##---#--------##--###--#-#-#####---#----#----##-##-#-#
-#----##-#-#-#--#-##--#--##---##----#-#---#----#----#-#-----#--###-#--##----#-----##----##-#-------#
#-#---#-#----##--#--#--#----##-#----#--------#--------S----#--------#---------##--#----------#----#-
-#-#-----#---####--------##-------###-----##----#------#---#-------##----#-#-#-#-#--#-#-#-##----#-#-
#-#----#---##-#-#--#-###-----##-#-#-----#--#--#-#---##---#-#--------#-#-#------##---------#--#-#--##
-#-------#--#-#--#--#-##-#---#-----#-#-#####--------#--#-------##--#-##-#-######---#-#------#----#-#
-#------#-#-----###--------#---#-###-#--#-----#---#----##-#-#-#-----#-#--------------#--#------##--#
#-------##-----##----#-###--------#-#-----#---#----#-#-##----##--#----##---##--##----------##---#---
--##-----##-#-#--#---#-####-#-----#-####---#-#--##----####-###-------#--####-----------#------------
#----------#----####-----##-##-#--###-#-###--#----#----##--##--##-------------#-#--#------##----#-#-
-#---##----#-#-#-#--##----##-#-##---#-#------#--#-----###--#--#-#---#--##-#---#---------###---###-#-
--#---#-####-#--#---#-#-##--#-----#----#-----#--#------#-------#------#----#-##-#-#-------#----#--#-
--#---###-##-#------##--#------#-#---###-#----#-#-##-----#----#----##---------#----#---#-----#------
--#------#-------##--------#-#------#--#####----#-##------#---#-----#-##----##-#-----##-------------
--#--------#----##----#---#-###--#--#----###-#-##--###-##--##------######--#--#---#-#----------#---#
---##---#-----------#-##--###-#------#-----#--###-#-----##--##---#-#####--#--------#-#---#--##------
#-----#------#------#-#-----#--#-###--#--------#---##---##-#-------###-#------#------------#---#----
------#-#--##--#--#--------##--#-----#----#---#-##------###--------###------##---#---#-#-#--##--#---
-#-##-##-#-------------#----#-###----#-#-----##-#-#-#----##---#--#--##---#----###--#---##-##-----#--
-----#-----#------##-------#---##-#-#--#--#--#---###--##----#-#------#---#-#----------##---#-#--#---
#-#--#---#----#-#-#-#-----##--------------######---#----#---##-#-#--######--#-##--#--#-##------#-#--
#####-#----#-----#--#-#----##------#----#--------#-##---#--#-----####-##-#----#---#---#-#-##-----#-#
---------#------------##-##---#-#---#----#-------#--##---##----###-##----#-#----###--#--#-##----#---
-#-##-#--####----#---#---##-------------#---#-----#---#-####-----##------------------###-------##-#-
-----#--#-#----##--------##--#-##---#---#-#-#-#-#---------------##---#-#-------#----##----#------#-#
---#---##---#-##-----##-------#-----#-#-#-##-----##-##---#----##-#--#--#--#--#-##-##--##----#--#----
#-----#-###-#----#--------#--#-----#-#-#--#-#---######---#--#--#-----#--#-##-#-#-#----###-###----#-#
--##---###-#--------#-#--#-#--#--#####-------#-#----##---###-#--#####--#----#--#-###-#-###-#-#-----#
----#---#-#-#-#---#----##------#---##-#-#-#-#------#--#--#-#-#-##-#---#---#-----##--#--#---##-#----#
-#-#-#-##---#--------##-----#--#-#------#-----------##----#----#------#----#-----#--#----#----------
---#-#-#--###----#--#-#-#--#--#---#--#--------#---##-##--#-#####----#--#####---#----##----#-#----##-
--##--##-#-#-#---#----##-#----##-#--#-####-#-----##-###---------#--#-#--------#--##---#-#------#----
---#--##--##--#-------#-#--#-----#####----#--##-##---#-#--#-#-----#---###-###-#----------#----------
-#----#----#-#--##--#-------#-#----#--##-----####--#----##--##---#--##---#---##--#--#-#-------##--#-
#-#-##-#-----#-#--#-#---#-#-#----###-#---------##------#--##-###--#---##-----#-#----#-#-----#---#---
-##-#-##-##-#-------#------#----#--#----##--#-#----#---#---#------##-#--------#-----#-##----------#-
--#--##-#---#-#-##-----#----#---####-----#--#-##-------#-#----#---#-#--#-----##-#-----#---#-##-###-#
-#-#--#-##-#-##----#---###--------###----#---#--#-#----------#-#------##----#---#-#--#----#------#--
-------#-##--#-#-#--------#####---##--#---#--#------##-#-------#-------#-----##--#-----##-#---#--#--
--------------#-##----#----#--#-------#----#-#-#-###-----#-----#----##--#--#--#--#----#--#-#-----#-#
------#--------#-#--#---------##----#-#------#-#----#--#--------#---#-###-##---#----###-##----##-#-#
-##---#----##---#---------#-#-------#--#####--###--#--###--------#---#--#--##---##---------#--#--##-
--#---###-#-#--#--#--#--###--#------#------##----#-----#-##----#--#--##----##---#-#-----##-###------
-#----######-----#---#-##-##-##-------##-##-------------------#---#-----------#-------#--###---##-#-
-#------#-#--#----#------#-#-#----#----#-##--#--#-#--##-----------------##----------###----#--##-###
------------------------##-----##------##--#-###---#--#----#---#-#---##-#-#-###-#---#---#--##-------
-#---------###-----##------#--##---#-#--###----------#---#---#-###-----#------#----###-#-#-####-#--#
--##-----##----##------------#--##-#--###---#--#----#----#--#-#---##-----#---#--#--#--#-##------#-#-
#####-##------#-#-##-------##--##-###----#-#--#--###-----#-------#-----#-#---#-#-#-----------#--#---
--#---####------#---#-####-#------###---#---#---------#-#------#-----#-----------#--##-###---#-#----
#-####-----#----#-#---##--###--#-----#--#----#--####-##-#--#-----##-#-#-#--------#----##########-##-
----#-##--#-##-###------#-#-#--#-#-#----------#--#----#-#--#---#-####-#--------#---####--##-###-----
-#------#-#-##-##--#--#--##--#----#-#------#----#---#-#---#-#----#--#--#-------#--###---#-####------
--#-----#-#-#--#--#---#---#---#------#--#-#-----#-#---#--#-#----###---#---#---##-#---#---#----#----#
#--------##--#--#---##--##-------#-#-#-#-##--##-#-----#----###-##---------#--#-#--------#------#----
----#--#-#-#-----#-#------##-#--##------------------#-#---##-#--#-####-----##----##------##-----#-#-
--#------#---#-#-#-#-#-####-----#---------#--#----###---##---------##-------#------#-#-----#-----#--
-----#---#-##--------##---#-#---------###--------#-#-----##----#---#---##--#--#-------##----#--#---#
-#-###--------##---###-----#----#----##-----#-----##-----##-#--##---#--##-#-----#-#----#-#----#-#---
-----#---#--#-#--#-######---##----#--#------#-------#---#-----#--###-#--##-------#-#--#----##-##-#--
---#---#-----#-----#-----##----#--##-#-###---#--#----#-#-#--#-------#------#--------#--#-#--#---#---
##--#-#-#-----##--------#-###---#-----------##-----------------##---------------#-------------####--
---##--#-#--##--#--#-#--##--#-##--#------------##-------#--------------##-----------#----###---##-#-
-----#---#-#----#---##-----#--##-#-------------##-----##--#--------------##---##--#----##------##-#-
###-#----#---#---#-----#-#-##---##------------#----##-#--####---#-------------##--#-#-------#-#-#--#
--###-##--#--#----#--#--#-#--##----#-#----##------------#--##-----##---#--#--#----##----#---###--##-
---#----------##--------#--##--#-------#-##--#---##-##----------#-#-#--#---##-##-#-------#-#----#---
#-#--##-----##-#-#---###----###---------##---#--#--#---#-##--##---#----------#----------#-##---##-##
-#-##-------#-----##-----#--#-#--##---#---##----#-###-----#-----##-##---------#--##--##--------##--#
##--#-#-#--#------#-#-#-#--#-----##--#--#-#--###-#---###--#-----#-----#-------####----##--#-----#---
#---#-#--#--##--#-------------#--#-----###------##--------#-##-###---------##---#-##-----##----#----
---#----##----#-------#--##---###-----###----#-#-------#-#-----##-#---#-----#----#-----#-----#-#----
#-#-#--##-----#-----#---------##-##-#-E---#-#---#--#-#---#-----#--#-#---#--------#---##-----###-#--#
--#----#------#---#--#--#####-------##--------#-#--#-------#-#-#-###---##------#-----#-#------------
-#--#-#-#---#-###---####-##-----###-----------##-##-#--#------#-#--#-------#-#-#--------#-#--#---##-
#---#---#-#--#-#---#----##---#---##----#####-#--#-----#---#---------#-----------##----#-#--#-##-----
--#----------------###-----#-----#--#--##-----###-##-------#---###-#--###----------##----------#----
----##----#-#-------#------#--#--#--#-##--##------#---#-#-#-----#------###---#-##--#--###-#-----#---
#--#--#-------#---#---#-----#-#--#--##---#------#------#---------#--##------#----#--#---#-##-#-----#
-------#-##-#-###--------#-----#-#---##-#---#---##---#-----##--------##-#--#----##--------####----#-
#----##----###------#---#-##--##---#-----------#-#-----#-#--#--###-#-##----#----#-#----#--#-##-#----
#------#-#--#---#---------#-#-##----#--#------#-###---#------##-#--#-------#--------##-#------##---#
-----#-##-#-#--#--#--#####-#----#-------------#-#---#--------#------#-#-----------#--#----#-#-------
---#------####---#-----#---##-#-#---#-##---##-#------------#-#--##-##-------#-#----#----#------#-#--
##-----------#-----#-#---#-#------##--##-##----#-------#-#------####-------###--#----##---#--###-##-
--------------#-----#----#-##--#--#--#-#---#------------#---#--------#-----#--##---##----#-#-#----#-