---##---##---##---##---##---##---##---##---##---##---##---##---##---##---##---##---##---##---##---##
#--###--###--###--###--###--###--###--###--###--###--###--###--###--###--###--###--###--###--###--##
--#----#----#----#----#----#----#----#----#----#----#----#----#----#----#----#----#----#----#----#--
----------------------------------------------------------------------------------------------------
#----#----#----#----#----#----#----#----#----#----#----#----#----#----#----#----#----#----#----#----
---##---##---##---##---##---##---##---##---##---##---##---##---##---##---##---##---##---##---##---##
#--###--###--###--###--###--###--###--###--###--###--###--###--###--###--###--###--###--###--###--##
--#----#----#----#----#----#----#----#----#----#----#----#----#----#----#----#----#----#----#----#--
----------------------------------------------------------------------------------------------------
#----#----#----#----#----#----#----#----#----#----#----#----#----#----#----#----#----#----#----#----
---##---##---##---##---##---##---##---##---##---##---##---##---##---##---##---##---##---##---##---##
#--###--###--###--###--###--###--###--###--###--###--###--###--###--###--###--###--###--###--###--##
--#----#----#----#----#----#----#----#----#----#----#----#----#----#----#----#----#----#----#----#--
----------------------------------------------------------------------------------------------------
#----#----#----#----#----#----#----#----#----#----#----#----#----#----#----#----#----#----#----#----
---##---##---##---##---##---##---##---##---##---##---##---##---##---##---##---##---##---##---##---##
#--###--###--###--###--###--###--###--###--###--###--###--###--###--###--###--###--###--###--###--##
--#----#----#----#---E#----#----#----#----#----#----#----#----#----#----#----#----#----#----#----#--
----------------------------------------------------------------------------------------------------
#----#----#----#----#----#----#----#----#----#----#----#----#----#----#----#----#----#----#----#----
---##---##---##---##---##---##---##---##---##---##---##---##---##---##---##---##---##---##---##---##
#--###--###--###--###--###--###--###--###--###--###--###--###--###--###--###--###--###--###--###--##
--#----#----#----#----#----#----#----#----#----#----#----#----#----#----#----#----#----#----#----#--
----------------------------------------------------------------------------------------------------
#----#----#----#----#----#----#----#----#----#----#----#----#----#----#----#----#----#----#----#----
---##---##---##---##---##---##---##---##---##---##---##---##---##---##---##---##---##---##---##---##
#--###--###--###--###--###--###--###--###--###--###--###--###--###--###--###--###--###--###--###--##
--#----#----#----#----#----#----#----#----#----#----#----#----#----#----#----#----#----#----#----#--
----------------------------------------------------------------------------------------------------
#----#----#----#----#----#----#----#----#----#----#----#----#----#----#----#----#----#----#----#----
---##---##---##---##---##---##---##---##---##---##---##---##---##---##---##---##---##---##---##---##
#--###--###--###--###--###--###--###--###--###--###--###--###--###--###--###--###--###--###--###--##
--#----#----#----#----#----#----#----#----#----#----#----#----#----#----#----#----#----#----#----#--
----------------------------------------------------------------------------------------------------
#----#----#----#----#----#----#----#----#----#----#----#----#----#----#----#----#----#----#----#----
---##---##---##---##---##---##---##---##---##---##---##---##---##---##---##---##---##---##---##---##
#--###--###--###--###--###--###--###--###--###--###--###--###--###--###--###--###--###--###--###--##
--#----#----#----#----#----#----#----#----#----#----#----#----#----#----#----#----#----#----#----#--
----------------------------------------------------------------------------------------------------
#----#----#----#----#----#----#----#----#----#----#----#----#----#----#----#----#----#----#----#----
---##---##---##---##---##---##---##---##---##---##---##---##---##---##---##---##---##---##---##---##
#--###--###--###--###--###--###--###--###--###--###--###--###--###--###--###--###--###--###--###--##
--#----#----#----#----#----#----#----#----#----#----#----#----#----#----#----#----#----#----#----#--
----------------------------------------------------------------------------------------------------
#----#----#----#----#----#----#----#----#----#----#----#----#----#----#----#----#----#----#----#----
---##---##---##---##---##---##---##---##---##---##---##---##---##---##---##---##---##---##---##---##
#--###--###--###--###--###--###--###--###--###--###--###--###--###--###--###--###--###--###--###--##
--#----#----#----#----#----#----#----#----#----#----#----#----#----#----#----#----#----#----#----#--
----------------------------------------------------------------------------------------------------
#----#----#----#----#----#----#-S--#----#----#----#----#----#----#----#----#----#----#----#----#----
---##---##---##---##---##---##---##---##---##---##---##---##---##---##---##---##---##---##---##---##
#--###--###--###--###--###--###--###--###--###--###--###--###--###--###--###--###--###--###--###--##
--#----#----#----#----#----#----#----#----#----#----#----#----#----#----#----#----#----#----#----#--
----------------------------------------------------------------------------------------------------
#----#----#----#----#----#----#----#----#----#----#----#----#----#----#----#----#----#----#----#----
---##---##---##---##---##---##---##---##---##---##---##---##---##---##---##---##---##---##---##---##
#--###--###--###--###--###--###--###--###--###--###--###--###--###--###--###--###--###--###--###--##
--#----#----#----#----#----#----#----#----#----#----#----#----#----#----#----#----#----#----#----#--
----------------------------------------------------------------------------------------------------
#----#----#----#----#----#----#----#----#----#----#----#----#----#----#----#----#----#----#----#----
---##---##---##---##---##---##---##---##---##---##---##---##---##---##---##---##---##---##---##---##
#--###--###--###--###--###--###--###--###--###--###--###--###--###--###--###--###--###--###--###--##
--#----#----#----#----#----#----#----#----#----#----#----#----#----#----#----#----#----#----#----#--
----------------------------------------------------------------------------------------------------
#----#----#----#----#----#----#----#----#----#----#----#----#----#----#----#----#----#----#----#----
---##---##---##---##---##---##---##---##---##---##---##---##---##---##---##---##---##---##---##---##
#--###--###--###--###--###--###--###--###--###--###--###--###--###--###--###--###--###--###--###--##
--#----#----#----#----#----#----#----#----#----#----#----#----#----#----#----#----#----#----#----#--
----------------------------------------------------------------------------------------------------
#----#----#----#----#----#----#----#----#----#----#----#----#----#----#----#----#----#----#----#----
---##---##---##---##---##---##---##---##---##---##---##---##---##---##---##---##---##---##---##---##
#--###--###--###--###--###--###--###--###--###--###--###--###--###--###--###--###--###--###--###--##
--#----#----#----#----#----#----#----#----#----#----#----#----#----#----#----#----#----#----#----#--
----------------------------------------------------------------------------------------------------
#----#----#----#----#----#----#----#----#----#----#----#----#----#----#----#----#----#----#----#----
---##---##---##---##---##---##---##---##---##---##---##---##---##---##---##---##---##---##---##---##
#--###--###--###--###--###--###--###--###--###--###--###--###--###--###--###--###--###--###--###--##
--#----#----#----#----#----#----#----#----#----#----#----#----#----#----#----#----#----#----#----#--
----------------------------------------------------------------------------------------------------
#----#----#----#----#----#----#----#----#----#----#----#----#----#----#----#----#----#----#----#----
---##---##---##---##---##---##---##---##---##---##---##---##---##---##---##---##---##---##---##---##
#--###--###--###--###--###--###--###--###--###--###--###--###--###--###--###--###--###--###--###--##
--#----#----#----#----#----#----#----#----#----#----#----#----#----#----#----#----#----#----#----#--
----------------------------------------------------------------------------------------------------
#----#----#----#----#----#----#----#----#----#----#----#----#----#----#----#----#----#----#----#----
---##---##---##---##---##---##---##---##---##---##---##---##---##---##---##---##---##---##---##---##
#--###--###--###--###--###--###--###--###--###--###--###--###--###--###--###--###--###--###--###--##
--#----#----#----#----#----#----#----#----#----#----#----#----#----#----#----#----#----#----#----#--
----------------------------------------------------------------------------------------------------
#----#----#----#----#----#----#----#----#----#----#----#----#----#----#----#----#----#----#----#----
---##---##---##---##---##---##---##---##---##---##---##---##---##---##---##---##---##---##---##---##
#--###--###--###--###--###--###--###--###--###--###--###--###--###--###--###--###--###--###--###--##
--#----#----#----#----#----#----#----#----#----#----#----#----#----#----#----#----#----#----#----#--
----------------------------------------------------------------------------------------------------
#----#----#----#----#----#----#----#----#----#----#----#----#----#----#----#----#----#----#----#----
---##---##---##---##---##---##---##---##---##---##---##---##---##---##---##---##---##---##---##---##
#--###--###--###--###--###--###--###--###--###--###--###--###--###--###--###--###--###--###--###--##
--#----#----#----#----#----#----#----#----#----#----#----#----#----#----#----#----#----#----#----#--
----------------------------------------------------------------------------------------------------
#----#----#----#----#----#----#----#----#----#----#----#----#----#----#----#----#----#----#----#----