-#----#----#----#----#----#----#----#----#----#----#----#----#----#----#----#----#----#----#----#---
--#----#----#----#----#----#----#----#----#----#----#----#----#----#----#----#----#----#----#----#--
----------------------------------------------------------------------------------------------------
--##---##---##---##---##---##---##---##---##---##---##---##---##---##---##---##---##---##---##---##-
-#----#----#----#----#----#----#----#----#----#----#----#----#----#----#----#----#----#----#----#---
-#----#----#----#----#----#----#----#----#----#----#----#----#----#----#----#----#----#----#----#---
--#----#----#----#----#----#----#----#----#----#----#----#----#----#----#----#----#----#----#----#--
----------------------------------------------------------------------------------------------------
--##---##---##---##---##---##---##---##---##---##---##---##---##---##---##---##---##---##---##---##-
-#----#----#----#----#----#----#----#----#----#----#----#----#----#----#----#----#----#----#----#---
-#----#----#----#----#----#----#----#----#----#----#----#----#----#----#----#----#----#----#----#---
--#-E--#----#----#----#----#----#----#----#----#----#----#----#----#----#----#----#----#----#----#--
----------------------------------------------------------------------------------------------------
--##---##---##---##---##---##---##---##---##---##---##---##---##---##---##---##---##---##---##---##-
-#----#----#----#----#----#----#----#----#----#----#----#----#----#----#----#----#----#----#----#---
-#----#----#----#----#----#----#----#----#----#----#----#----#----#----#----#----#----#----#----#---
--#----#----#----#----#----#----#----#----#----#----#----#----#----#----#----#----#----#----#----#--
----------------------------------------------------------------------------------------------------
--##---##---##---##---##---##---##---##---##---##---##---##---##---##---##---##---##---##---##---##-
-#----#----#----#----#----#----#----#----#----#----#----#----#----#----#----#----#----#----#----#---
-#----#----#----#----#----#----#----#----#----#----#----#----#----#----#----#----#----#----#----#---
--#----#----#----#----#----#----#----#----#----#----#----#----#----#----#----#----#----#----#----#--
----------------------------------------------------------------------------------------------------
--##---##---##---##---##---##---##---##---##---##---##---##---##---##---##---##---##---##---##---##-
-#----#----#----#----#----#----#----#----#----#----#----#----#----#----#----#----#----#----#----#---
-#----#----#----#----#----#----#----#----#----#----#----#----#----#----#----#----#----#----#----#---
--#----#----#----#----#----#----#----#----#----#----#----#----#----#----#----#----#----#----#----#--
----------------------------------------------------------------------------------------------------
--##---##---##---##---##---##---##---##---##---##---##---##---##---##---##---##---##---##---##---##-
-#----#----#----#----#----#----#----#----#----#----#----#----#----#----#----#----#----#----#----#---
-#----#----#----#----#----#----#----#----#----#----#----#----#----#----#----#----#----#----#----#---
--#----#----#----#----#----#----#----#----#----#----#----#----#----#----#----#----#----#----#----#--
----------------------------------------------------------------------------------------------------
--##---##---##---##---##---##---##---##---##---##---##---##---##---##---##---##---##---##---##---##-
-#----#----#----#----#----#----#----#----#----#----#----#----#----#----#----#----#----#----#----#---
-#----#----#----#----#----#----#----#----#----#----#----#----#----#----#----#----#----#----#----#---
--#----#----#----#----#----#----#----#----#----#----#----#----#----#----#----#----#----#----#----#--
----------------------------------------------------------------------------------------------------
--##---##---##---##---##---##---##---##---##---##---##---##---##---##---##---##---##---##---##---##-
-#----#----#----#----#----#----#----#----#----#----#----#----#----#----#----#----#----#----#----#---
-#----#----#----#----#----#----#----#----#----#----#----#----#----#----#----#----#----#----#----#---
--#----#----#----#----#----#----#----#----#----#----#----#----#----#----#----#----#----#----#----#--
----------------------------------------------------------------------------------------------------
--##---##---##---##---##---##---##---##---##---##---##---##---##---##---##---##---##---##---##---##-
-#----#----#----#----#----#----#----#----#----#----#----#----#----#----#----#----#----#----#----#---
-#----#----#----#----#----#----#----#----#----#----#----#----#----#----#----#----#----#----#----#---
--#----#----#----#----#----#----#----#----#----#----#----#----#----#----#----#----#----#----#----#--
----------------------------------------------------------------------------------------------------
--##---##---##---##---##---##---##---##---##---##---##---##---##---##---##---##---##---##---##---##-
-#----#----#----#----#----#----#----#----#----#----#----#----#----#----#----#----#----#----#----#---
-#----#----#----#----#----#----#----#----#----#----#----#----#----#----#----#----#----#----#----#---
--#----#----#----#----#----#----#----#----#----#----#----#----#----#----#----#----#----#----#----#--
----------------------------------------------------------------------------------------------------
--##---##---##---##---##---##---##---##---##---##---##---##---##---##---##---##---##---##---##---##-
-#----#----#----#----#----#----#----#----#----#----#----#----#----#----#----#----#----#----#----#---
-#----#----#----#----#----#----#----#----#----#----#----#----#----#----#----#----#----#----#----#---
--#----#----#----#----#----#----#----#----#----#----#----#----#----#----#----#----#----#----#----#--
----------------------------------------------------------------------------------------------------
--##---##---##---##---##---##---##---##---##---##---##---##---##---##---##---##---##---##---##---##-
-#----#----#----#----#----#----#----#----#----#----#----#----#----#----#----#----#----#----#----#---
-#----#----#----#----#----#----#----#----#----#----#----#----#----#----#----#----#----#----#----#---
--#----#----#----#----#----#----#----#----#----#----#----#----#----#----#----#----#----#----#----#--
----------------------------------------------------------------------------------------------------
--##---##---##---##---##---##---##---##---##---##---##---##---##---##---##---##---##---##---##---##-
-#----#----#----#----#----#----#----#----#----#----#----#----#----#----#----#----#----#----#----#---
-#----#----#----#----#----#----#----#----#----#----#----#----#----#----#----#----#----#----#----#---
--#----#----#----#----#----#----#----#----#----#----#----#----#----#----#----#----#----#----#----#--
----------------------------------------------------------------------------------------------------
--##---##---##---##---##---##---##---##---##---##---##---##---##---##---##---##---##---##---##---##-
-#----#----#----#----#----#----#----#----#----#----#----#----#----#----#----#----#----#----#----#---
-#----#----#----#----#----#----#----#----#----#----#----#----#----#----#----#----#----#----#----#---
--#----#----#----#----#----#----#----#----#----#----#----#----#----#----#----#----#----#----#----#--
----------------------------------------------------------------------------------------------------
--##---##---##---##---##---##---##---##---##---##---##---##---##---##---##---##---##---##---##---##-
-#----#----#----#----#----#----#----#----#----#----#----#----#----#----#----#----#----#----#----#---
-#----#----#----#----#----#----#----#----#----#----#----#----#----#----#----#----#----#----#----#---
--#----#----#----#----#----#----#----#----#----#----#----#----#----#----#----#----#----#----#----#--
----------------------------------------------------------------------------------------------------
--##---##---##---##---##---##---##---##---##---##---##---##---##---##---##---##---##---##---##---##-
-#----#----#----#----#----#----#----#----#----#----#----#----#----#----#----#----#----#----#----#---
-#----#----#----#----#----#----#----#----#----#----#----#----#----#----#----#----#----#----#----#---
--#----#----#----#----#----#----#----#----#----#----#----#----#----#----#----#----#----#----#----#--
----------------------------------------------------------------------------------------------------
--##---##---##---##---##---##---##---##---##---##---##---##---##---##---##---##---##---##---##---##-
-#----#----#----#----#----#----#----#----#----#----#----#----#----#----#----#----#----#----#----#---
-#----#----#----#----#----#----#----#----#----#----#----#----#----#----#----#----#----#----#----#---
--#----#----#----#----#----#----#----#----#----#----#----#----#----#----#----#----#----#----#----#--
----------------------------------------------------------------------------------------------------
--##---##---##---##---##---##---##---##---##---##---##---##---##---##---##---##---##---##---##---##-
-#----#----#----#----#----#----#----#----#----#----#----#----#----#----#----#----#----#----#----#---
-#----#----#----#----#----#----#----#----#----#----#----#----#----#----#----#----#----#----#----#---
--#----#----#----#S---#----#----#----#----#----#----#----#----#----#----#----#----#----#----#----#--
----------------------------------------------------------------------------------------------------
--##---##---##---##---##---##---##---##---##---##---##---##---##---##---##---##---##---##---##---##-
-#----#----#----#----#----#----#----#----#----#----#----#----#----#----#----#----#----#----#----#---
-#----#----#----#----#----#----#----#----#----#----#----#----#----#----#----#----#----#----#----#---
--#----#----#----#----#----#----#----#----#----#----#----#----#----#----#----#----#----#----#----#--
----------------------------------------------------------------------------------------------------
--##---##---##---##---##---##---##---##---##---##---##---##---##---##---##---##---##---##---##---##-
-#----#----#----#----#----#----#----#----#----#----#----#----#----#----#----#----#----#----#----#---