-#----#----#----#----#----#----#----#----#----#----#----#----#----#----#----#----#----#----#----#---
--###--###--###--###--###--###--###--###--###--###--###--###--###--###--###--###--###--###--###--###
----------------------------------------------------------------------------------------------------
-##---##---##---##---##---##---##---##---##---##---##---##---##---##---##---##---##---##---##---##--
---#----#----#----#----#----#----#----#----#----#----#----#----#----#----#----#----#----#----#----#-
-#----#----#----#----#----#----#----#----#----#----#----#----#----#----#----#----#----#----#----#---
--###--###--###--###--###--###--###--###--###--###--###--###--###--###--###--###--###--###--###--###
----------------------------------------------------------------------------------------------------
-##---##---##---##---##---##---##---##---##---##---##---##---##---##---##---##---##---##---##---##--
---#----#----#----#----#----#----#----#----#----#----#----#----#----#----#----#----#----#----#----#-
-#----#----#----#----#----#----#----#----#----#----#----#----#----#----#----#----#----#----#----#---
--###--###--###--###--###--###--###--###--###--###--###--###--###--###--###--###--###--###--###--###
----------------------------------------------------------------------------------------------------
-##---##---##---##---##---##---##---##---##---##---##---##---##---##---##---##---##---##-S-##---##--
---#----#----#----#----#----#----#----#----#----#----#----#----#----#----#----#----#----#----#----#-
-#----#----#----#----#----#----#----#----#----#----#----#----#----#----#----#----#----#----#----#---
--###--###--###--###--###--###--###--###--###--###--###--###--###--###--###--###--###--###--###--###
----------------------------------------------------------------------------------------------------
-##---##---##---##---##---##---##---##---##---##---##---##---##---##---##---##---##---##---##---##--
---#----#----#----#----#----#----#----#----#----#----#----#----#----#----#----#----#----#----#----#-
-#----#----#----#----#----#----#----#----#----#----#----#----#----#----#----#----#----#----#----#---
--###--###--###--###--###--###--###--###--###--###--###--###--###--###--###--###--###--###--###--###
----------------------------------------------------------------------------------------------------
-##---##---##---##---##---##---##---##---##---##---##---##---##---##---##---##---##---##---##---##--
---#----#----#----#----#----#----#----#----#----#----#----#----#----#----#----#----#----#----#----#-
-#----#----#----#----#----#----#----#----#----#----#----#----#----#----#----#----#----#----#----#---
--###--###--###--###--###--###--###--###--###--###--###--###--###--###--###--###--###--###--###--###
------------------E---------------------------------------------------------------------------------
-##---##---##---##---##---##---##---##---##---##---##---##---##---##---##---##---##---##---##---##--
---#----#----#----#----#----#----#----#----#----#----#----#----#----#----#----#----#----#----#----#-
-#----#----#----#----#----#----#----#----#----#----#----#----#----#----#----#----#----#----#----#---
--###--###--###--###--###--###--###--###--###--###--###--###--###--###--###--###--###--###--###--###
----------------------------------------------------------------------------------------------------
-##---##---##---##---##---##---##---##---##---##---##---##---##---##---##---##---##---##---##---##--
---#----#----#----#----#----#----#----#----#----#----#----#----#----#----#----#----#----#----#----#-
-#----#----#----#----#----#----#----#----#----#----#----#----#----#----#----#----#----#----#----#---
--###--###--###--###--###--###--###--###--###--###--###--###--###--###--###--###--###--###--###--###
----------------------------------------------------------------------------------------------------
-##---##---##---##---##---##---##---##---##---##---##---##---##---##---##---##---##---##---##---##--
---#----#----#----#----#----#----#----#----#----#----#----#----#----#----#----#----#----#----#----#-
-#----#----#----#----#----#----#----#----#----#----#----#----#----#----#----#----#----#----#----#---
--###--###--###--###--###--###--###--###--###--###--###--###--###--###--###--###--###--###--###--###
----------------------------------------------------------------------------------------------------
-##---##---##---##---##---##---##---##---##---##---##---##---##---##---##---##---##---##---##---##--
---#----#----#----#----#----#----#----#----#----#----#----#----#----#----#----#----#----#----#----#-
-#----#----#----#----#----#----#----#----#----#----#----#----#----#----#----#----#----#----#----#---
--###--###--###--###--###--###--###--###--###--###--###--###--###--###--###--###--###--###--###--###
----------------------------------------------------------------------------------------------------
-##---##---##---##---##---##---##---##---##---##---##---##---##---##---##---##---##---##---##---##--
---#----#----#----#----#----#----#----#----#----#----#----#----#----#----#----#----#----#----#----#-
-#----#----#----#----#----#----#----#----#----#----#----#----#----#----#----#----#----#----#----#---
--###--###--###--###--###--###--###--###--###--###--###--###--###--###--###--###--###--###--###--###
----------------------------------------------------------------------------------------------------
-##---##---##---##---##---##---##---##---##---##---##---##---##---##---##---##---##---##---##---##--
---#----#----#----#----#----#----#----#----#----#----#----#----#----#----#----#----#----#----#----#-
-#----#----#----#----#----#----#----#----#----#----#----#----#----#----#----#----#----#----#----#---
--###--###--###--###--###--###--###--###--###--###--###--###--###--###--###--###--###--###--###--###
----------------------------------------------------------------------------------------------------
-##---##---##---##---##---##---##---##---##---##---##---##---##---##---##---##---##---##---##---##--
---#----#----#----#----#----#----#----#----#----#----#----#----#----#----#----#----#----#----#----#-
-#----#----#----#----#----#----#----#----#----#----#----#----#----#----#----#----#----#----#----#---
--###--###--###--###--###--###--###--###--###--###--###--###--###--###--###--###--###--###--###--###
----------------------------------------------------------------------------------------------------
-##---##---##---##---##---##---##---##---##---##---##---##---##---##---##---##---##---##---##---##--
---#----#----#----#----#----#----#----#----#----#----#----#----#----#----#----#----#----#----#----#-
-#----#----#----#----#----#----#----#----#----#----#----#----#----#----#----#----#----#----#----#---
--###--###--###--###--###--###--###--###--###--###--###--###--###--###--###--###--###--###--###--###
----------------------------------------------------------------------------------------------------
-##---##---##---##---##---##---##---##---##---##---##---##---##---##---##---##---##---##---##---##--
---#----#----#----#----#----#----#----#----#----#----#----#----#----#----#----#----#----#----#----#-
-#----#----#----#----#----#----#----#----#----#----#----#----#----#----#----#----#----#----#----#---
--###--###--###--###--###--###--###--###--###--###--###--###--###--###--###--###--###--###--###--###
----------------------------------------------------------------------------------------------------
-##---##---##---##---##---##---##---##---##---##---##---##---##---##---##---##---##---##---##---##--
---#----#----#----#----#----#----#----#----#----#----#----#----#----#----#----#----#----#----#----#-
-#----#----#----#----#----#----#----#----#----#----#----#----#----#----#----#----#----#----#----#---
--###--###--###--###--###--###--###--###--###--###--###--###--###--###--###--###--###--###--###--###
----------------------------------------------------------------------------------------------------
-##---##---##---##---##---##---##---##---##---##---##---##---##---##---##---##---##---##---##---##--
---#----#----#----#----#----#----#----#----#----#----#----#----#----#----#----#----#----#----#----#-
-#----#----#----#----#----#----#----#----#----#----#----#----#----#----#----#----#----#----#----#---
--###--###--###--###--###--###--###--###--###--###--###--###--###--###--###--###--###--###--###--###
----------------------------------------------------------------------------------------------------
-##---##---##---##---##---##---##---##---##---##---##---##---##---##---##---##---##---##---##---##--
---#----#----#----#----#----#----#----#----#----#----#----#----#----#----#----#----#----#----#----#-
-#----#----#----#----#----#----#----#----#----#----#----#----#----#----#----#----#----#----#----#---
--###--###--###--###--###--###--###--###--###--###--###--###--###--###--###--###--###--###--###--###
----------------------------------------------------------------------------------------------------
-##---##---##---##---##---##---##---##---##---##---##---##---##---##---##---##---##---##---##---##--
---#----#----#----#----#----#----#----#----#----#----#----#----#----#----#----#----#----#----#----#-
-#----#----#----#----#----#----#----#----#----#----#----#----#----#----#----#----#----#----#----#---
--###--###--###--###--###--###--###--###--###--###--###--###--###--###--###--###--###--###--###--###
----------------------------------------------------------------------------------------------------
-##---##---##---##---##---##---##---##---##---##---##---##---##---##---##---##---##---##---##---##--
---#----#----#----#----#----#----#----#----#----#----#----#----#----#----#----#----#----#----#----#-
-#----#----#----#----#----#----#----#----#----#----#----#----#----#----#----#----#----#----#----#---
--###--###--###--###--###--###--###--###--###--###--###--###--###--###--###--###--###--###--###--###
----------------------------------------------------------------------------------------------------
-##---##---##---##---##---##---##---##---##---##---##---##---##---##---##---##---##---##---##---##--
---#----#----#----#----#----#----#----#----#----#----#----#----#----#----#----#----#----#----#----#-