#----#----#----#----#----#----#----#----#----#----#----#----#----#----#----#----#----#----#----#----
---#----#----#----#----#----#----#----#----#----#----#----#----#----#----#----#----#----#----#----#-
##--###--###--###--###--###--###--###--###--###--###--###--###--###--###--###--###--###--###--###--#
--#----#----#----#----#----#----#----#----#----#----#----#----#----#----#----#----#----#----#----#--
-##---##---##---##---##---##---##---##---##---##---##---##---##---##---##---##---##---##---##---##--
#----#----#----#----#----#----#----#----#----#----#----#----#----#----#----#----#----#----#----#----
---#----#----#----#----#----#----#----#----#----#----#----#----#----#----#----#----#----#----#----#-
##--###--###--###--###--###--###--###--###--###--###--###--###--###--###--###--###--###--###--###--#
--#----#----#----#----#----#----#----#----#----#----#----#----#----#----#----#----#----#----#----#--
-##---##---##---##---##---##---##---##---##---##---##---##---##---##---##---##---##---##---##---##--
#----#----#----#----#----#----#----#----#----#----#----#----#----#----#----#----#----#----#----#----
---#----#----#----#----#----#----#----#----#----#----#----#----#----#----#----#----#----#----#----#-
##--###--###--###--###--###--###--###--###--###--###--###--###--###--###--###--###--###--###--###--#
--#----#----#----#----#----#----#----#----#----#----#----#----#----#----#----#----#----#----#----#--
-##---##---##---##---##---##---##---##---##---##---##---##---##---##---##---##---##---##---##---##--
#----#----#----#----#----#----#----#----#----#----#----#----#----#----#----#----#----#----#----#----
---#----#----#----#----#----#----#----#----#----#----#----#----#----#----#----#----#----#----#----#-
##--###--###--###--###--###--###--###--###--###--###--###--###--###--###--###--###--###--###--###--#
--#----#----#----#----#----#----#----#----#----#----#----#----#----#----#----#----#----#----#----#--
-##---##---##---##---##---##---##---##---##---##---##---##---##---##---##---##---##---##---##---##--
#----#----#----#----#----#----#----#----#----#----#----#----#----#----#----#----#----#----#----#----
---#----#----#----#----#----#----#----#----#----#----#----#----#----#----#----#----#----#----#----#-
##--###--###--###--###--###--###--###--###--###--###--###--###--###--###--###--###--###--###--###--#
--#----#----#----#----#----#----#----#----#----#----#----#----#----#----#----#----#----#----#----#--
-##---##---##---##---##---##---##---##---##---##---##---##---##---##---##---##---##---##---##---##--
#----#----#----#----#----#----#----#----#----#----#----#----#----#----#----#----#----#----#----#----
---#----#----#----#----#----#----#----#----#----#----#----#----#----#----#----#----#----#----#----#-
##--###--###--###--###--###--###--###--###--###--###--###--###--###--###--###--###--###--###--###--#
--#----#----#----#----#----#----#----#----#----#----#----#----#----#----#----#----#----#----#----#--
-##---##---##---##---##---##---##---##---##---##---##---##---##---##---##---##---##---##---##---##--
#----#----#----#----#----#----#----#----#----#----#----#----#----#----#----#----#----#----#----#----
---#----#----#----#----#----#----#----#----#----#----#----#----#----#----#----#----#----#----#----#-
##--###--###--###--###--###--###--###--###--###--###--###--###--###--###--###--###--###--###--###--#
--#----#----#----#----#----#----#----#----#----#----#----#----#----#----#----#----#----#----#----#--
-##---##---##---##---##---##---##---##---##---##---##---##---##---##---##---##---##---##---##---##--
#----#----#----#----#----#----#----#----#----#----#----#----#----#----#----#----#----#----#----#----
---#----#----#----#----#----#----#----#----#----#----#----#----#----#----#----#----#----#----#----#-
##--###--###--###--###--###--###--###--###--###--###--###--###--###--###--###--###--###--###--###--#
--#----#----#----#----#----#----#----#----#----#----#----#----#----#----#----#----#----#----#----#--
-##---##---##---##---##---##---##---##---##---##---##---##---##---##---##---##---##---##---##---##--
#----#----#----#----#----#----#----#----#----#----#----#----#----#----#----#----#----#----#----#----
---#----#----#----#----#----#----#----#----#----#----#----#----#----#----#----#----#----#----#----#-
##--###--###--###--###--###--###--###--###--###--###--###--###--###--###--###--###--###--###--###--#
--#----#----#----#----#----#----#----#----#----#----#----#----#----#----#----#----#----#----#----#--
-##---##---##---##---##---##-E-##---##---##---##---##---##---##---##---##---##---##---##---##---##--
#----#----#----#----#----#----#----#----#----#----#----#----#----#----#----#----#----#----#----#----
---#----#----#----#----#----#----#----#----#----#----#----#----#----#----#----#----#----#----#----#-
##--###--###--###--###--###--###--###--###--###--###--###--###--###--###--###--###--###--###--###--#
--#----#----#----#----#----#----#----#----#----#----#----#----#----#----#----#----#----#----#----#--
-##---##---##---##---##---##---##---##---##---##---##---##---##---##---##---##---##---##---##---##--
#----#----#----#----#----#----#----#----#----#----#----#----#----#----#----#----#----#----#----#----
---#----#----#----#----#----#----#----#----#----#----#----#----#----#----#----#----#----#----#----#-
##--###--###--###--###--###--###--###--###--###--###--###--###--###--###--###--###--###--###--###--#
--#----#----#----#----#----#----#----#----#----#----#----#----#----#----#----#----#----#----#----#--
-##---##---##---##---##---##---##---##---##---##---##---##---##---##---##---##---##---##---##---##--
#----#----#----#----#----#----#----#----#----#----#----#----#----#----#----#----#----#----#----#----
---#----#----#----#----#----#----#----#----#----#----#----#----#----#----#----#----#----#----#----#-
##--###--###--###--###--###--###--###--###--###--###--###--###--###--###--###--###--###--###--###--#
--#----#----#----#----#----#----#----#----#----#----#----#----#----#----#----#----#----#----#----#--
-##---##---##---##---##---##---##---##---##---##---##---##---##---##---##---##---##---##---##---##--
#----#----#----#----#----#----#----#----#----#----#----#----#----#----#----#----#----#----#----#----
---#----#----#----#----#----#----#----#----#----#----#----#----#----#----#----#----#----#----#----#-
##--###--###--###--###--###--###--###--###--###--###--###--###--###--###--###--###--###--###--###--#
--#----#----#----#----#----#----#----#----#----#----#----#----#----#----#----#----#----#----#----#--
-##---##---##---##---##---##---##---##---##---##---##---##---##---##---##---##---##---##---##---##--
#----#----#----#----#----#----#----#----#----#----#----#----#----#----#----#----#----#----#----#----
---#----#----#----#----#----#----#----#----#----#----#----#----#----#----#----#----#----#----#----#-
##--###--###--###--###--###--###--###--###--###--###--###--###--###--###--###--###--###--###--###--#
--#----#----#----#----#----#----#----#----#----#----#----#----#----#----#----#----#----#----#----#--
-##---##---##---##---##---##---##---##---##---##---##---##---##---##---##---##---##---##---##---##--
#----#----#----#----#----#----#----#----#----#----#----#----#----#----#----#----#----#----#----#----
---#----#----#----#----#----#----#----#----#----#----#----#----#----#----#----#----#----#----#----#-
##--###--###--###--###--###--###--###--###--###--###--###--###--###--###--###--###--###--###--###--#
--#----#----#----#----#----#----#----#----#----#----#----#----#----#----#----#----#----#----#----#--
-##---##---##---##---##---##---##---##---##---##---##---##---##---##---##---##---##---##---##---##--
#----#----#----#----#----#----#----#----#----#----#----#----#----#----#----#----#----#----#----#----
---#----#----#----#----#----#----#----#----#----#----#----#----#----#----#----#----#----#----#----#-
##--###--###--###--###--###--###--###--###--###--###--###--###--###--###--###--###--###--###--###--#
--#----#----#----#----#----#----#----#----#----#----#----#----#----#----#----#----#----#----#----#--
-##---##---##---##---##---##---##---##---##---##---##---##---##---##---##---##---##---##---##---##--
#----#----#----#----#----#----#----#----#----#----#----#----#----#----#----#----#----#----#----#----
---#----#----#----#----#----#----#----#----#----#----#----#----#----#----#----#----#----#----#----#-
##--###--###--###--###--###--###--###--###--###--###--###--###--###--###--###--###--###--###--###--#
--#----#----#----#----#----#----#----#----#----#----#----#----#----#----#----#----#----#----#----#--
-##---##---##---##---##---##---##---##---##---##---##---##---##---##---##---##---##---##---##---##--
#----#----#----#----#----#----#----#----#----#----#----#----#----#----#----#----#----#----#----#----
---#----#----#----#----#----#----#----#----#----#----#----#----#----#----#----#----#----#----#----#-
##--###--###--###--###--###--###--###--###--###--###--###--###--###--###--###--###--###--###--###--#
--#----#----#----#----#----#----#----#----#----#----#----#----#----#----#----#----#----#----#----#--
-##---##---##---##---##---##---##---##---##---##---##---##---##---##---##---##---##---##---##---##--
#----#----#----#----#----#----#----#----#----#----#----#----#----#----#----#----#----#---S#----#----
---#----#----#----#----#----#----#----#----#----#----#----#----#----#----#----#----#----#----#----#-
##--###--###--###--###--###--###--###--###--###--###--###--###--###--###--###--###--###--###--###--#
--#----#----#----#----#----#----#----#----#----#----#----#----#----#----#----#----#----#----#----#--
-##---##---##---##---##---##---##---##---##---##---##---##---##---##---##---##---##---##---##---##--
#----#----#----#----#----#----#----#----#----#----#----#----#----#----#----#----#----#----#----#----
---#----#----#----#----#----#----#----#----#----#----#----#----#----#----#----#----#----#----#----#-
##--###--###--###--###--###--###--###--###--###--###--###--###--###--###--###--###--###--###--###--#
--#----#----#----#----#----#----#----#----#----#----#----#----#----#----#----#----#----#----#----#--
-##---##---##---##---##---##---##---##---##---##---##---##---##---##---##---##---##---##---##---##--