----------------------------------------------------------------------------------------------------
--#-#--#-#--#-#--#-#--#-#--#-#--#-#--#-#--#-#--#-#--#-#--#-#--#-#--#-#--#-#--#-#--#-#--#-#--#-#--#-#
--#-#--#-#--#-#--#-#--#-#--#-#--#-#--#-#--#-#--#-#--#-#--#-#--#-#--#-#--#-#--#-#--#-#--#-#--#-#--#-#
----------------------------------------------------------------------------------------------------
#--#-#--#-#--#-#--#-#--#-#--#-#--#-#--#-#--#-#--#-#--#-#--#-#--#-#--#-#--#-#--#-#--#-#--#-#--#-#--#-
----------------------------------------------------------------------------------------------------
--#-#--#-#--#-#--#-#--#-#--#-#--#-#--#-#--#-#--#-#--#-#--#-#--#-#--#-#--#-#--#-#--#-#--#-#--#-#--#-#
--#-#--#-#--#-#--#-#--#-#--#-#--#-#--#-#--#-#--#-#--#-#--#-#--#-#--#-#--#-#--#-#--#-#--#-#--#-#--#-#
----------------------------------------------------------------------------------------------------
#--#-#--#-#--#-#--#-#--#-#--#-#--#-#--#-#--#-#--#-#--#-#--#-#--#-#--#-#--#-#--#-#--#-#--#-#--#-#--#-
----------------------------------------------------------------------------------------------------
--#-#--#-#--#-#--#-#--#-#--#-#--#-#--#-#--#-#--#-#--#-#--#-#--#-#--#-#--#-#--#-#--#-#--#-#--#-#--#-#
--#-#--#-#--#-#--#-#--#-#--#-#--#-#--#-#--#-#--#-#--#-#--#-#--#-#--#-#--#-#--#-#--#-#--#-#--#-#--#-#
----------------------------------------------------------------------------------------------------
#--#-#--#-#--#-#--#-#--#-#--#-#--#-#--#-#--#-#--#-#--#-#--#-#--#-#--#-#--#-#--#-#--#-#--#-#--#-#--#-
----------------------------------------------------------------------------------------------------
--#-#--#-#--#-#--#-#--#-#--#-#--#-#--#-#--#-#--#-#--#-#--#-#--#-#--#-#--#-#--#-#--#-#--#-#--#-#--#-#
--#-#--#-#--#-#--#-#--#-#--#-#--#-#--#-#--#-#--#-#--#-#--#-#--#-#--#-#--#-#--#-#--#-#--#-#--#-#--#-#
----------------------------------------------------------------------------------------------------
#--#-#--#-#--#-#--#-#--#-#--#-#--#-#--#-#--#-#--#-#--#-#--#-#--#-#--#-#--#-#--#-#--#-#--#-#--#-#--#-
----------------------------------------------------------------------------------------------------
--#-#--#-#--#-#--#-#--#-#--#-#--#-#--#-#--#-#--#-#--#-#--#-#--#-#--#-#--#-#--#-#--#-#--#-#--#-#--#-#
--#-#--#-#--#-#--#-#--#-#--#-#--#-#--#-#--#-#--#-#--#-#--#-#--#-#--#-#--#-#--#-#--#-#--#-#--#-#--#-#
----------------------------------------------------------------------------------------------------
#--#-#--#-#--#-#--#-#--#-#--#-#--#-#--#-#--#-#--#-#--#-#--#-#--#-#--#-#--#-#--#-#--#-#--#-#--#-#--#-
----------------------------------------------------------------------------------------------------
--#-#--#-#--#-#--#-#--#-#--#-#--#-#--#-#--#-#--#-#--#-#--#-#--#-#--#-#--#-#--#-#--#-#--#-#--#-#--#-#
--#-#--#-#--#-#--#-#--#-#--#-#--#-#--#-#--#-#--#-#--#-#--#-#--#-#--#-#--#-#--#-#--#-#--#-#--#-#--#-#
----------------------------------------------------------------------------------------------------
#--#-#--#-#--#-#--#-#--#-#--#-#--#-#--#-#--#-#--#-#--#-#--#-#--#-#--#-#--#-#--#-#--#-#--#-#--#-#--#-
----------------------------------------------------------------------------------------------------
--#-#--#-#--#-#--#-#--#-#--#-#--#-#--#-#--#-#--#-#--#-#--#-#--#-#--#-#--#-#--#-#--#-#--#-#--#-#--#-#
--#-#--#-#--#-#--#-#--#-#--#-#--#-#--#-#--#-#--#-#--#-#--#-#--#-#--#-#--#-#--#-#--#-#--#-#--#-#--#-#
----------------------------------------------------------------------------------------------------
#--#-#--#-#--#-#--#-#--#-#--#-#--#-#--#-#--#-#--#-#--#-#--#-#--#-#--#-#--#-#--#-#--#-#--#-#--#-#--#-
----------------------------------------------------------------------------------------------------
--#-#--#-#--#-#--#-#--#-#--#-#--#-#--#-#--#-#--#-#--#-#--#-#--#-#--#-#--#-#--#-#--#-#--#-#--#-#--#-#
--#-#--#-#E-#-#--#-#--#-#--#-#--#-#--#-#--#-#--#-#--#-#--#-#--#-#--#-#--#-#--#-#--#-#--#-#--#-#--#-#
----------------------------------------------------------------------------------------------------
#--#-#--#-#--#-#--#-#--#-#--#-#--#-#--#-#--#-#--#-#--#-#--#-#--#-#--#-#--#-#--#-#--#-#--#-#--#-#--#-
----------------------------------------------------------------------------------------------------
--#-#--#-#--#-#--#-#--#-#--#-#--#-#--#-#--#-#--#-#--#-#--#-#--#-#--#-#--#-#--#-#--#-#--#-#--#-#--#-#
--#-#--#-#--#-#--#-#--#-#--#-#--#-#--#-#--#-#--#-#--#-#--#-#--#-#--#-#--#-#--#-#--#-#--#-#--#-#--#-#
----------------------------------------------------------------------------------------------------
#--#-#--#-#--#-#--#-#--#-#--#-#--#-#--#-#--#-#--#-#--#-#--#-#--#-#--#-#--#-#--#-#--#-#--#-#--#-#--#-
----------------------------------------------------------------------------------------------------
--#-#--#-#--#-#--#-#--#-#--#-#--#-#--#-#--#-#--#-#--#-#--#-#--#-#--#-#--#-#--#-#--#-#--#-#--#-#--#-#
--#-#--#-#--#-#--#-#--#-#--#-#--#-#--#-#--#-#--#-#--#-#--#-#--#-#--#-#--#-#--#-#--#-#--#-#--#-#--#-#
----------------------------------------------------------------------------------------------------
#--#-#--#-#--#-#--#-#--#-#--#-#--#-#--#-#--#-#--#-#--#-#--#-#--#-#--#-#--#-#--#-#--#-#--#-#--#-#--#-
----------------------------------------------------------------------------------------------------
--#-#--#-#--#-#--#-#--#-#--#-#--#-#--#-#--#-#--#-#--#-#--#-#--#-#--#-#--#-#--#-#--#-#--#-#--#-#--#-#
--#-#--#-#--#-#--#-#--#-#--#-#--#-#--#-#--#-#--#-#--#-#--#-#--#-#--#-#--#-#--#-#--#-#--#-#--#-#--#-#
----------------------------------------------------------------------------------------------------
#--#-#--#-#--#-#--#-#--#-#--#-#--#-#--#-#--#-#--#-#--#-#--#-#--#-#--#-#--#-#--#-#--#-#--#-#--#-#--#-
----------------------------------------------------------------------------------------------------
--#-#--#-#--#-#--#-#--#-#--#-#--#-#--#-#--#-#--#-#--#-#--#-#--#-#--#-#--#-#--#-#--#-#--#-#--#-#--#-#
--#-#--#-#--#-#--#-#--#-#--#-#--#-#--#-#--#-#--#-#--#-#--#-#--#-#--#-#--#-#--#-#--#-#--#-#--#-#--#-#
----------------------------------------------------------------------------------------------------
#--#-#--#-#--#-#--#-#--#-#--#-#--#-#--#-#--#-#--#-#--#-#--#-#--#-#--#-#--#-#--#-#--#-#--#-#--#-#--#-
----------------------------------------------------------------------------------------------------
--#-#--#-#--#-#--#-#--#-#--#-#--#-#--#-#--#-#--#-#--#-#--#-#--#-#--#-#--#-#--#-#--#-#--#-#--#-#--#-#
--#-#--#-#--#-#--#-#--#-#--#-#--#-#--#-#--#-#--#-#--#-#--#-#--#-#--#-#--#-#--#-#--#-#--#-#--#-#--#-#
----------------------------------------------------------------------------------------------------
#--#-#--#-#--#-#--#-#--#-#--#-#--#-#--#-#--#-#--#-#--#-#--#-#--#-#--#-#--#-#--#-#--#-#--#-#--#-#--#-
----------------------------------------------------------------------------------------------------
--#-#--#-#--#-#--#-#--#-#--#-#--#-#--#-#--#-#--#-#--#-#--#-#--#-#--#-#--#-#--#-#--#-#--#-#--#-#--#-#
--#-#--#-#--#-#--#-#--#-#--#-#--#-#--#-#--#-#--#-#--#-#--#-#--#-#--#-#--#-#--#-#--#-#--#-#--#-#--#-#
----------------------------------------------------------------------------------------------------
#--#-#--#-#--#-#--#-#--#-#--#-#--#-#--#-#--#-#--#-#--#-#--#-#--#-#--#-#--#-#--#-#--#-#--#-#--#-#--#-
----------------------------------------------------------------------------------------------------
--#-#--#-#--#-#--#-#--#-#--#-#--#-#--#-#--#-#--#-#--#-#--#-#--#-#--#-#--#-#--#-#--#-#--#-#--#-#--#-#
--#-#--#-#--#-#--#-#--#-#--#-#--#-#--#-#--#-#--#-#--#-#--#-#--#-#--#-#--#-#--#-#--#-#--#-#--#-#--#-#
----------------------------------------------------------------------------------------------------
#--#-#--#-#--#-#--#-#--#-#--#-#--#-#--#-#--#-#--#-#--#-#--#-#--#-#--#-#--#-#--#-#--#-#--#-#--#-#--#-
----------------------------------------------------------------------------------------------------
--#-#--#-#--#-#--#-#--#-#--#-#--#-#--#-#--#-#--#-#--#-#--#-#--#-#--#-#--#-#--#-#--#-#--#-#--#-#--#-#
--#-#--#-#--#-#--#-#--#-#--#-#--#-#--#-#--#-#--#-#--#-#--#-#--#-#--#-#--#-#--#-#--#-#--#-#--#-#--#-#
----------------------------------------------------------------------------------------------------
#--#-#--#-#--#-#--#-#--#-#--#-#--#-#--#-#--#-#--#-#--#-#--#-#--#-#--#-#--#-#--#-#--#-#--#-#--#-#--#-
----------------------------------------------------------------------------------------------------
--#-#--#-#--#-#--#-#--#-#--#-#--#-#--#-#--#-#--#-#--#-#--#-#--#-#--#-#--#-#--#-#--#-#--#-#--#-#--#-#
--#-#--#-#--#-#--#-#--#-#--#-#--#-#--#-#--#-#--#-#--#-#--#-#--#-#--#-#--#-#--#-#--#-#--#-#--#-#--#-#
----------------------------------------------------------------------------------------------------
#--#-#--#-#--#-#--#-#--#-#--#-#--#-#--#-#--#-#--#-#--#-#--#-#--#-#--#-#--#-#--#-#--#-#--#-#--#-#--#-
----------------------------------------------------------------------------------------------------
--#-#--#-#--#-#--#-#--#-#--#-#--#-#--#-#--#-#--#-#--#-#--#-#--#-#--#-#--#-#--#-#--#-#--#-#--#-#--#-#
--#-#--#-#--#-#--#-#--#-#--#-#--#-#--#-#--#-#--#-#--#-#--#-#--#-#--#-#--#-#--#-#--#-#--#-#--#-#--#-#
----------------------------------------------------------------------------------------------------
#--#-#--#-#--#-#--#-#--#-#--#-#--#-#--#-#--#-#--#-#--#-#--#-#--#-#--#-#--#-#--#-#--#-#--#-#--#-#--#-
----------------------------------------------------------------------------------------------------
--#-#--#-#--#-#--#-#-S#-#--#-#--#-#--#-#--#-#--#-#--#-#--#-#--#-#--#-#--#-#--#-#--#-#--#-#--#-#--#-#
--#-#--#-#--#-#--#-#--#-#--#-#--#-#--#-#--#-#--#-#--#-#--#-#--#-#--#-#--#-#--#-#--#-#--#-#--#-#--#-#
----------------------------------------------------------------------------------------------------
#--#-#--#-#--#-#--#-#--#-#--#-#--#-#--#-#--#-#--#-#--#-#--#-#--#-#--#-#--#-#--#-#--#-#--#-#--#-#--#-
----------------------------------------------------------------------------------------------------
--#-#--#-#--#-#--#-#--#-#--#-#--#-#--#-#--#-#--#-#--#-#--#-#--#-#--#-#--#-#--#-#--#-#--#-#--#-#--#-#
--#-#--#-#--#-#--#-#--#-#--#-#--#-#--#-#--#-#--#-#--#-#--#-#--#-#--#-#--#-#--#-#--#-#--#-#--#-#--#-#
----------------------------------------------------------------------------------------------------
#--#-#--#-#--#-#--#-#--#-#--#-#--#-#--#-#--#-#--#-#--#-#--#-#--#-#--#-#--#-#--#-#--#-#--#-#--#-#--#-