------##-###-#-##-#---###-#-#---#-##----#---###-####-##-#--#----#-#----##----#-#---------#-----##--#
##-##---###-####-#-----------##----##--##---#-##--#-#-----##-----##-##------#---------##-##----#-#--
----#-----------###--------------#-----#-#-#---#-#---##--#-#-----#---#---####-----#--###--------#---
-#----#--#-#-#----------##----####---#----#-----#--#------#------###-------##-#-#--#-##----#--#-#-#-
###--#-#--#---------#---##-#---#-#-------#-------#---##-----#-###--#-#-------##--#----#----#-#--###-
#-#---##----#-----------#-#--------##---#---###--#-#---#--------#---#-----#------###-----##---###--#
-#----------#-#--#-##---#----------#-#-#--#---#--##--##-###-##-----#--#-##-----------#-#----#--#-#--
--------#-----#-#-##--#-----#---------##--#-------------##-#---#---#---#-#---#--#---##-------#--#---
----------#--#-----##-##---##-#-----#---####-----#------#-#---------#-#------#---#-#----#--#----##-#
---#----##-----#-#----##--#----------#---#-#---#--------#--##----------------#-#--###-#--##---#-#---
--##---###----#--#-#-#-#---#----#--#-##--#-#--#-##----#------#-#-----#-----#-#-#--#-#---#--##---#---
-----#-##----------##-----#--#-----#-#--#---#---#---#-##--#-#--#-----#--------------#-----##-##-#---
#--##-----#--##-#-#------#--#-----#------#--------#-###-#----#------#---#--#------#--##----#--#-#---
-----##-#----#----##-#---------#---#---#-#---#---#-----#-#---###----#---#---#-#-----#-#---#-----###-
--#--##--#--#####-###-----#-#-#----#-#---------#----#---#--#--#----#---#--######----##--#-----#---##
---#---####-#---#--S---###-#-#-#-----#-##--#--------##-##--------------#---#-###-#--#--#-#-#---##---
#---#-#-----##-#--------#---##----##--#------#----#--#--#--#-##--#--#-##------#--#-#---#-#---------#
---##----#-#-##-#---#--#-#--#----------#----------------###--##---#----##---##--###-#--#----------#-
-#---##-##---#-#---##----##------###-----#-###-##-----##--###----#-#---#--#---##--##-#--#---#-------
##----###-#--------------#-##------------#--##-#--#----#--------##---##----#------#------#--------#-
##----#--###----#-#--#--#-----###-##---#---#-#-#---##-------####-#---###--------#----###-#-##-------
--#-#--------#-#-##-###----#-#-----##---#-##-----#---###-#-E#-----#----#--------#--#-#----------###-
###-#-#--#----#--#-#-----#-----#-#----#-#---#--##---------#-####--#-#--#-----###---##-------#####---
-#--#--#-------#-##----#-------##--#----##--#------#-----#-------#--#--##--#---#------###-----#-----
--------#--#-#----##-#---#-----#-#--#------------#-----##---#---###--###-#----#---#-------#---------
------------------#---##----#--#-----#----##-###----#-#---#-##-----##--------##---##-#--#-#-#--#----
---#----#---#-#--#----#---#-#--#--#-#----#--------###-#---#----##-##-#-#-----#-------#-##-----#-#---
--#------##-#--------#-##----##--#--#---#---#--####-#---#-#--#--#--##--##-#--####-#--#-----#-----##-
----##-#------#-##--#---#---#--#---####---#----#---###-#-------##--###-#-----#--#---#-----#----#---#
---#--##---#---#-#---#------#-#-##-----#-##--#--#------#-#--#-#--##-#-------------#----#---##--#---#
---#-----#--#-##-------#--#--#--#----#-#--#-#-##---#---#--------##----#--#------#-#-#---#--###--#--#
---##---#---###-------------#--#---------#---#-----------#---#-#--#--##---##-#-----#------#-#----##-
----##--------#-###---------------#---#-#---#--#-----##------###---#--#-##-##---#--#--###-##-------#
------#------####--#--#-###-##--#-#------#--#-##---##--#---#---#-----##---##--#----##-#-------#---#-
-----#--#-----#--------##-#-#--##--##-----##---#----#---------#--#--##----#-#-#--#--#-----##--#-----
##-##--###----#-#---#---#-#-#--#-------#-------##---------#----#--#---###----#-#-#----#---#------###
---##-#--##-#-------##-#---##-------#------#--#-#--#---##-#---#-#-#-#--#--#--#--##-----#-#-----#-##-
#--#---#--#--#--##-#---------#--##-##----#-##------##-#-#----#-##-#---------#--#---#-----#--#---#-#-
----#-#------#---#-----#--#-#-##----#-------#-#------#----##---#--#--#----####-------##--#-##-------
#-----------##---#--#--#-#---#---------#--##-#-#-#--#----#-----#--#-----##---##-##-#----------------
-#------#-#---#---------#--#--#---###-#--------#-##---#--##---#-##--#-##--##-------######---#-------
-----#---#---###--#---------#-#--##---#-#--##------#-#-#----##-#----#---#---------#-#-#--#----#-#-##
-##--#--#---###---#-----###-##-#--#------#-##----#-#--------#-#-----#---------#---------#----#--##--
-----#------#--------#-#----#---#---#------#-##----#--------##---#----#-#-------#--##--##-#---#-#---
-###------------###---------###-------####---#--------#-##---#---#-#-------------###----#-------#---
--##-#---#-----#----##-#-#---#-------##-----#-#--#------##-##-##------------#------------#--#---#-##
#----##----#-###---#--#--###-----##---------#-#----------#-----#--#-#--#----#-##--#-#-----#--#-#----
-#---------#-#-----##---#-#-#-----##--##--#-#-#-#-##-##-#-#---#-----###----#---##--##-------##------
-#-#-----#--#-#----#------#------##---#-------#-#-##--#-##--------#--##---#-##-----#-##-#-#---#-#---
-----------#-##--##--####---#--------###-#---####--#---#---#--#--#--#------##--##---##--#---#-#--###
-#---##-######--#--##--#-#--###---##------#-#------#----#-##-----##------#------#--##--##---#--#----
#--------------##-##-#-##--------#--#---#--#---#-----#----------#-#####---#-----##---#---##--#-#--#-
-----#-#-------#----------#-#-###----#-#-#--#-#--#--##-----##-#--------#----------#---#--###-----#--
-#-#-#------#---#---#----##-#-##-#---#---##---##--##-------#-#---------##-----#--#-#-#----------#---
-#-#--#---#--#-#-#------#--###----#----###-#-#---#-###-#-------#--##--#--##-##---#-####-###---------
-#-------#--#----#--#-----#-----#----------#-----#--#-----#---#-----------#-#-------#-----#----#--#-
--#-------------------#-##-----#--------#--##-----##-------#--##-#-----#--#----#-#-#-----##--------#
--##-----###-#----##----#-####---------#------###----##----##----###----#---#-------#--#--#--#------
----#----##-----#---#-------#---#--#-#--#-------#-#------#---##----#--#------------------#-#-##-#--#
--#-#---#----#-###--##-#--#-------#-#-#-##-#------#---#----#--#---#--#----------#---#--#--#-#--#---#
#------#---###--#----#---#--#---##-##---##--------#----#--#--#----#----##-#--------#-#-------#-----#
------###------#-------#---#--#-####-##-#------#-----##---###--------#-#-#-##-----#---#----#-###---#
-##-#------##-#----####-------#----#---##-#-------------#--#-###----------#-###-------###------#-#--
-##----#----#-------###---#-------#----##--#--#------------#-----#----##----#--#----#---------#--#-#
#----#-#-##--##------#-##------#-#-----#-----#------#--#---#---###---#-#-#-##--#-#-----#----####----
#------------#--------##---#-#----#--------###--#--#-##--###---##--##----#-#--#----------#-#--#-#---
#----#-###--#---##--#--#-#-##--##--##---#-##--#--###--------#-------#-#---------#-###-----#----#----
###-#-#------##---##-#----####--#-#-###-###---###------#---#---#-#---------####-##-#-#---#-###---#--
-#-------#-----##--#-#----####-------###--###--#----##-#---------#-----#--#-------###---#-----------
-######----#---#--##--#--##--##--#---##---###--#--###--#-##----#---#------#-##---#--###-###------#--
##---#-###-##---##--------#--###---##--#-####--------------##-##----#--#--#---------------------##--
#-#------#--#--#-#-----#----------###---#-----#--#-#----##--#-----##-----#---#---#--#------###------
--#---##---#-#--#--#----------#---##-----#-#-###-##----------------#-#--#----------#--#####-#---#-#-
#-#--#--##--#-#--#--####---#-------#---##---##-##---------------###-#----##-#--#-####-#--##-#-----#-
---##---##-#------#-----#----###-####---###---##-##--#-------#------#--------#-#-#--#-#-----#-###---
#--####-###---#---#---#-#-##-#--#---##--#---##-#-#--#-----------##-#----#-----#-----------#-----##--
#-#-###--#----##----------#---#-------#-#-####-------#--##--#-#--##-#---#---#----#---#---###---#-#--
##---##--#----##--##--##-##-#--------#-----##--#----###----------#-#-----------#####--##-----#-#---#
----#-#----#---#-----#---##-#--#-#---#-#--#-#--#-------------#--#-#--##-----#---#--------------#----
----##--###-#-#-#--#--#------#--#-#---#---#----###----##-----##-------#---#-----------#--------#-#--
--##--#---------------#---#-##-#---##----##-#--##------#--------------#-#-#--#-#---------#-#----#---
-#--------#---#-##------##---#---#-##-----#-----#-----#-#-#--------#------#-#----#-##-----#-------#-
---#-#-#----#--###-#-----###------------##--#-----#-----#----#-#-#--#---####-#--#------#-##--#-#---#
-#-##---###--------#--#-----##--#--##---###----#-#---#-------#----#----##-----#---##-------###---#-#
-#--#---#-----#-----##---#-#----#-#-#---###--#--##---##----#--##-----------#---------------##-#--#-#
-#---------#-#------##-#--###---#-#--#-#---#----#-##--#-------#---#-#--##-###--#--##--#--#-----#-#--
#-##-#--#-#--###--#--#--#---#--#----------------##-----------#--##-----------#-#---#-------#----#---
--#--##--#--##-#--##----#----#---#-#---#--------#-----#-##----#-----###-----#------#-----####---#---
-----#--#-#--#-#--#-###--#-#-#-##-----#-######--##--------#----#--##-#--##-#--#-#--#-----###-#-#-##-
#---##--------##----####--###--#----##-#---#------#-#---#-##--#------#-#-#--------#---##--#-#--#----
----------#--------#------#-------#-----#-#-#-#--#---#---#---#--#---#----#-#-#-----##----#-----#-###
-##-#---#--##-#-----#---##--#-#-#------#---#---#------#-#------#----#----##-----#--###-#----#-##-#--
--#--#-##--#-##-##-#-----#---#-###-----#--#-----#--#--#--###-#--#---#######---#----#---#--#----#-#--
###-#----#-#------#-#-#--#-#-#--#---#-------##-#--###---------#-##--#-#-#----##--#--#-#--#-#-#---###
#---#--#------#-##-----#-#---###-#---#---#----#--##---####-##--#-#-#-##--#-###------#----#--#----#--
-#---#-###-------##----####-#---#--------#-#-----##-#--###------###----##--####---##--------##----##
-----------#--#-#--##-#---------#-#---#-----#--------#-##-----#-#--##--#-#-----#---#-#-----#--#-##--
---#--#--###----#-###--#-#--####-#----#--##--#-------------#---#-######-#--##--#-#-------#-#-#--#---
----#-#---##-#-#--##---#----##---#-#--#------#-##--#---------##-----#--##-----------#---#-#-#-#---#-
-----#-#--#-#--##--------##--#-#-#--##---##----------#----#--##---------##--#-#----####-----###--##-