#-#-#------#-------#--#-------##-###--#--##------##-##---#--#--##-#-#-#-##---#--#-#-##--------#-----
-##--------#--##--#-----#------#---------##-###--------##------#---#--------##-----#----##-#--#--###
---#----##--#-#----###---#--##-####----#--#-#--------#-----#-#---#---#-#--##-------#-----#-#--#---#-
#---#-##---#-----#-#-#-##--#--#--#---#---#--#-#----------#------##-------##-------###------------##-
--#-##--#-----#--##---#-#----#---##-#-#-------##-##--##---------##-----##-#--#-#----------#---##-#--
##-#---#---#--#---#---#--##-#-----###---##--##---##--#-#-##-#-#-#-#---#-------##--#--#-#-#-----##---
----#----#-#--#----#-----#----##-##-##-##------------#--#----#--#--##--#-------#####-------##-------
-----#-##---###----##--#------###--#--##-----#----#---#--#-###---#-------##-------------#-------##--
-------------#---#-##--------#--#----##---#--#--------#----##---#-----#--#--#---####----#-----#-----
--##-----#------#---------#-#-#------#----#----#------#---#-#--#-------#------#-##--#---###---#-#-##
---#-###---#--------#--#--####--###----#-##----#---#---#---#-#----#-#-#-#--------######------#-##---
-----#-#--####----#-#---#------##--#--##-#-#------#--##---#-##----##---#--#-###-#-#-----#--#--------
#-----------##------------####-###---#-#--#-#--##------#-###-------#---#---##-###--------------#----
---------#-----###---##--#----#--#------#-----#-#--#-#--#-####--####-----##--#--##--------#----#---#
#-#-##---##--#-##--#--#---##--#--#-#--#--#--#-##-#-#-####--------##--#--#-----#-#---------#-#----#--
-#----#-#-----##------#-##-#-#---###--#-#-#--###-#---------##---##----##--#---#--#-#---#-##---##----
#---------#-##--##-#--#-#-##-----#----#--#--#--#----#----#-----##-#----#-------#-#---------#------#-
----------###-------#-#--------#---##----##-#--###--#---#-------------##-------#------#-#---#-------
###--#-##-------#-##-##--##-#-------#----#-------------#--#-###--#----#--#-----#-----#-##----#-#--#-
--#-----##--##----#---#---##-#-----------#---#-#---#-#-----#--##---#---#---------##--#----##-----#-#
----#---##--#---##-----#----#---##---------##-#--#--#--#----#--#--------------#--#------#----#------
------#-#-###-----##--####----#-#--#--------##--#--#-##---#-##--#-------##-##-#--##-----#-###-------
---###----#-#-##-##--------------###-#--#-##--------#----#-#------#------#-#-------##----#-------#--
------#-----##-----#----#--#--##-#-#---#----#--#---##-###-#----#-------##--###--#----####-#----#---#
#-##-----#---#----#-####-#--#---#-#-----#-#---#-----#-----#--------#-----####---#---#--#--------#-#-
----####-#-----------------#---#-#----##----#--#####--#-#--###--###-##---#--##--------#------#-####-
###-----#-#---##------##---------#-------##-#-#----#------------##-#---#--#---###-----##-#-##-#-#-#-
--#--#-#-##---#--#--#---##-#--##-----##---#--------------#-#--##-#---#-#---##----#-##-##---#--#----#
---#------#----#----#------#---#--#---------##----##---#---#--#-----#---#-###----#--####-----#-##-#-
#---------#----#--#----#--------#--#----#-----#-#----####-##-#--#-------------#--#------#-----##--#-
-#---------------#--#-------#--#-#-#--###---#---#---#-#----#-#----#----##-#-##-#---#----#----#---#--
-##-----#-#---##------##-----#-#--#####--###---#-##----#------#-#---###----#---------#-#--##---#----
#----#-#---##-#--#--#---###--------#----#-#-----#------##-#-----#-##-#-----#-#--#------#-#-#--##----
--#-------#--###---##-#-----------------------#-#------##-------#--#---#--#--###----##-#--##-------#
------#--#---##--#---------###-------#--#------#-###-##----#--#--#----#-#------------#-##----------#
--##--#--#-#-------##-#----------#--#--#--#---##---#---##---#---------#-#--##-#-#--#-##--#----#----#
---------#-#-##--#----#-#---#--#---#----##---##--#---#-######--#---##-#---#-#----#--##--#--#-----#--
--#---#-----#---###-#-#---##---#-#----#---------##--#--##-----#--##----#--##--#--#-#-##------------#
#-------###----#-#-#-#-#-#-----------------##--------#---#--#--------#--#-#--#----#--#-##---###--##-
--##---------#-#------##--#----#--#-----#-------###-#--##--#---##-#----#----#--#---#--###----#-#---#
--#------#---#-##-#----##-#-#--------#-----#--#-#----#-###--#-#-----##-#---#----#-#-----#-##-----#-#
---#-----#--##---------#----#----#--#---#---#----#-------#-#--------#--###---#--###-----#-#----#--#-
---#----##---#-------##--#---##--#--##---###------#---------#------##-------#-#-#--#--#-------#-----
-------------#----#----#----------#-##-#------#-#-#-#-#---#---#-##-----#--##--##------##----#-##----
#-#-#----#-------#-#----##----####-#---#---###----#-#---#-##-#--##-----#---#--####-----#-#--##-#---#
--#------#-#---#-#-#---#----###-----#-###-#-#---##---#S#------#----#-----##----#-###----#---#-##--#-
--#--#--#-----##-------#---#-------------------#---#--#---##-------##-##--##--#-----###-#-----------
-##-#-##---#-#--#--###-#-#---------#--#---#--#-#--#-#--###-----#---#-##---###----###------#--##--#-#
#-##------#--------#--##-#-#-###---###--#------#----#----#----------#--#-#-----#-----####----#--#--#
----##-#-----#---#---#----#-#--------#---------#--------#-#-#-----##---##---#----#-#--#-----------#-
-###------#-#----#--#--#-----###-#--------##-#--#----#---#-##---#-#---#--#---#----#-#-#---#-#--#-#-#
-----#----------##----#--#--##---##---##----------##--##--#-##-----##---##-#---#--#---#-------------
-#-----###--##--####-#-##---#-----#-#-----------##---------##-------#---#--#---------#--##-#----#--#
---##---###---------#----------##-----#-##-------#---#--#-----#------#--#-----#-------#---------##--
------#-#---#-#-#-------##-----#--#--#--##--###-#-#-#--####------#-##-#---#-------##-#####----#-----
-#-##--#----#------#------#-##---##-##-##------------#---------#---##-----#------#-#--#-#--##-----##
-#--#-------#--#--#----------#-#----#-#-#--##--#-----#----#--#---#----#--#----------###--####-#-#---
----#--#-----#--#-------------#-------#-#---##-----#-##---#--##--#---#---------#--#--#-#--#--##-##--
-#------#-#---#---#---#--#----###------#------#-#-------#-#-##-##---#-#---#---------------#-##--##-#
-----#---##------####--#--#-#----#--#---#---#-#--###-#--#-####-##----#----#-#-#------##---#--##-#---
-#-#-#---#----#-----#---#----###--#----##----------##-------#-#--#-#-#-#--#-------#--#---####----##-
------##---#-#-#----##---#-#--####------##-#-#--#--#-#---#---#-####--###--#-#----#---##-----#-#-----
---#-#----------#-#-#--#---##-----#-#--#-------##------##-#-------#----#-------#--#--###-#-------#--
#-----------#####--##---#-#-##-----------#--#--#-#--------#------#-#-#-------#--#-#-#-##----###---##
--#--#-#------##-##--#--##--#---------#---##---#--##---#----###--#---##---------#----##----#-#--##--
-###--#---#-#--##-#------------#---#--#-#-##-#----#---#------------#--#---#----##---#-##--#-#----###
-#-----#-#------#--#-##----#-#-#---#------#--------###-----##-#-#--------####---##--###-----#---#-#-
-#-#-#-----##--######-##-###--####---##---------#----####--#-------#--------#----#-#-#-###---#-#----
---#----#---#--#---##-####-#---###-----#--###-#-------#-##---##--#--##-------------#--#---#-----###-
#-#--#-#-##---##---##-#----#------#-#-#-#---#--#--#--##-#-#--#--##-#----#-#--###-#-#----##-----#--#-
#-#------###------------#-#---------#-----#---#-##-----##--#-#----##---#----##-----#--#-------#-####
--#--##---###--#--#------#---##-#--#---#--#-##----#-#----###--#-#---#-#-#--#--------------------#-#-
#-#--#-#-------#----#-E#----#-###--#------##-##----#-------##----------##---#--#-###---#--#-----#---
-#-#--#---------#-#---#-----#-#----#-----###-#-------#----##--------#-------#--#--###-##-----###----
#----#---#-###----##--#--------#-#--#-##----#--##----#----#-#-##----#-##------#####---#----##---#--#
##------#-#-##-#--##--------#-----#---##---##--#-#-#-#---#-#-###----#-----#####-#-#--##--###-#--#-#-
----------#--#-------###-#-----#----#------#----------#--#-----#-#--#---------------------#-#-----#-
-#-###----#------#------------##--#-----#--#-##-#------#-------#--##---##---#----------#-##-#---#---
-------##---###---#---##-#--###----#----#-##--#-#-------##--#-#---#-##-#------##-###-#-#---#--##--#-
-----#---#------#---##---#-#----#----#---#-------#-#-#-#----#--#--#----#-#####----------##-###-#---#
----#----#------------##----#-#-----#---##-###---##----------###-----#-----#--#---#----#-------#---#
----#------###-##-###----#-#-##-##---#--###----#--#------#------##--#---#-----#####--#-##--#------#-
-#--##---#-#--#--------#-----#-----#-----#-----####--#-#-----###------#---##---#---##----#-#-#------
-#--#----------#--------##--##--#-##-#-----#-----##--###-##----#----#---#---#-------##-#---##---#---
#-#-#--##--##--#---#---------###---#-#----#-----#------#--------#--------------#-----#--#-#-----#-#-
#-##------##-##---#-#----------#-#-##-------##-----#--#---#--#---#-#--#----#------#----#-#-#--##----
-#-----------#---####---##-##--#---##--#-#-#------#---##--#------#---#-#----#---#-----#-#---#-#-#---
-----------#-----#-#-------##---#------#-------#-#--#---#---------#-----#-#-----##-#-------#--------
------#-#---#-#--#----#-#-#-----#---#--#-----#-###--#--------##-#---#-#-#-##------##-#--------##----
----------##--###---#-----##------#-#----#--##-##-##--#--###-#----#---#---#----#--#---#-#------#----
#-##-----#-------#-------##-#-----##--#---#---#----#---####--#-#-#-##---#-#------#-#-----#------#-##
#--###--#-#----##-----#-#--#-#---------#-#------#---#-#-----##-#-#----------#--#-------##--#-#-#-#--
-----#-###--#-#--###----#-#-###-#------#-#-#---------#--#------#--#-##--#-#-###---#-##---#-#-#--#-##
-#-----#----#---#--####--#----#----#-#-##------#----#---#-----##--#####----------#-#---#-----#-----#
-##------#------#--#------##----#---#--##----##-#--#------##-#--#----###--###-###-#-----------#-#---
--#------------#--#-#---------#--#-####--#-#----#----##---#----##-#--#---#####--#--#----####-#---##-
----#-#---##---####-##--#-------#--##-##----#--##---------#--##--#-----#-##---##-##----##-##-----#--
###----#----#--#-#-----#-#--###-##-#-#----#---##------#-#---##-#-#----##-#-#-----###-#--#-#----#--##
-----#---#---#-###-#--#---#------#---#--##---###-###-----#--------#-###-----##-#----######-----#----
#-#-##---#---##-#---###----#-##----#----#-##-#-#---#---##---#--####---##-#---##------#-#-#-#---#----