##---#-###---------##-------#----------###--##------##--#--#----#-#-------#-----#--------##--#---#--
#-#-------#-----------#-----#---##-#--#---#----------#---#---###-#----##--#------#--#---#--#---#--##
#--#--#-----#-##-----#--##----#-#--##--#---###---#-#-#-------####-#------------#-#--#---#-#---#-##--
##--#--------##-#----#-#------#----#----##--###----#--#-----#---#--#-##-###----#-#----##--#-------#-
------##------##-##-#--#---#-##-###---#----#-#--#-#-#-#--#-------------###-#-#-#--#-----###---------
-#--#--#-#-#-----#---##------#----###---##--##-#-#-----#-###--------#--##-----#----#---#-#---##----#
--------#-#----------##---------##--#----#-##--###---#-----#-#-##-----------##--#--------#--##----##
#-#-----#-#-#---####-----#-------#---#-#-#--#-----##----------#------------#--###-#-######---#--#---
---##------###-#-#####--#---#--#------##--#####-#---###--##-#--------------#---#-----------##-------
--#-----#------###----#-------------###----#-#-----#--------#--#---###---#-#-#---------#---------#--
----#--------#---#-#----##-##----#-##--###----#-#-##----##----#----####-##-#---#--#-#------##--#-#--
---#------###-------------##---------------#-----------#---#----##---####----#-##-#--#-###---------#
-----##-#-##---#--#####-----#------##--##-##--#-#------#-#-----#--#---------------------#--##---#-##
##----#---#-------#---###-----#-#--###----#------##--#-#---------###-------#---##--#-#----------#-#-
----#---#------###--###------#-#------#-##----#--#--###---#-#---------#----##-##-#-#----#-##------#-
----#####--#---#-##--####---#---##-###--##--###---#####---##--#-----#-#--#-#####-#--#--#----##-###--
-###----#----#-##---------#-#-----#-------#-----------##----##-----##----#-#----#-##----#-----------
-----#--###--#-----#--#------##------###----##--#--##-----##-##-#-#---###-#-##--#-#------#-----#----
---#---##--------###-##-###----#--#-#----#-----###---#-#---------#------#-#----##---#-#-#-------###-
-##--##---##---#-#-----#--#-#-##-#--###-----#--#--##-###-----#--##----#---#-##---------#----#-------
##------##----##-----------###--------#---#--#----#----##-##-#--##-#-------#---#---#-----#----------
--------#-##--#--#--#------------#--------#------#--#-#-----##-#----#---#--#------##-###---##-#-#-#-
#--###----#-----#---------#---#------#-----#--###---#-----#--#-#-------#---##-#--#------##-#-#--#---
---##---#----#---###--#-#-#-----#-##-----#---#------------#-#-----#-#----#-#----##--#----#-#-#-##---
---#--#----####---------#---###---##-#-------#--#------#------##--#---#----#----#----#-#--#---#--#--
-#--#-----#---##-##-##--#-#--#-####-#--#-##------##-#-#-###-----#------####-#-#--#--##---#---#-#----
#----###-#--#-#----##-------##-##---------#------#------#---###-#----#-###-#------#-###-#-#----#----
-----------#-#------#------#--#-----#--#----------##--------------##--#-#--#--#--#-#-##---###-#-#---
--##--##-##---#--#---#---#---#----#-----------#--#----#-#--#---#--#--###-----###----#------#----#--#
--#----##---###-#-#---------#-###----------##-##------#--##-----#--#----##--#--#-##---#--#-##-##----
-----#---#----##-----#---#-#-##----#---#-#----##------------#--###-#--#--##--#------#-##-#-----#----
#---#--#----------#---#--#--###----##-#----##-#------##---##--------###-#-#---#--#--#---#----###--#-
-#--#---#-----#-##-----#-------#-#---#-#-#-#--#--#-#---#----------#---#-#-#---#--#------#-----####--
-#-#---##--##-#----#-#------------##-##-#----#-###--#-#-----#--#--#--#--##------##-#--#-------------
##--#---#--#---##-----#-#-#------#-----------#-----##-------#---#-------------##---#-#-#-#-----#-#-#
---#-------#--#----------###--#----##---#---#----#----###------#-##-##-#---#--------##----#--------#
----#-------#--#-#---#-#-S-#-#----#-----##---###------#--#-#-----------#-#-#--#-------##-----------#
#-#-----#----#--#-###---##-##-#--##--#-#-###-----#----##-#-#-#-#--#------#-#--------#-#-----#####-#-
-#---#--#------##-#-#--#---#-#---------##-#--#---#------#-#----#------#----------#----##--##------#-
#-#--###--##-#-###---#-----###---#--#-------#---------##---#-#----#---#-###------------#------#-###-
#------#-#-#---#-------#---#-#---------------------##----##---#-----#-#-------##---#------####-#--#-
-##-##---##---##-------##---------#-####--#-###-#-#####-#---#-------#-####--#-#-----#-#-###-##-#---#
##----##-#---#---#-#---#-----#-----#-#---##--#-------##----#-##-#-##-----#-##-#--------####---##-#-#
--#-##--#-------##---#---###--##--#-#---#--------#----#---#-#----#-###----#---##----#---#------#----
-----------####------#-#----##-###----#--------###-#--#-#--#---#-#---#-##---#--#-----#----#----#-#--
#--##-#-##--###------#-#-##----##-###--#--#-###-----#--#--#-#--##-##-#--#-#--------####--##-----#--#
###--------#--#------##--###-------#-----##---#----##--------#------#-#----#--#---#-##--#-----#-----
--#----#------#----#-##----#---------##----##---#-#---#------###---#---##-##--##-----#-#---#----#---
-##---#---#---#------------#-#-#-##-#--##-#-##-------#--#-------#--#-----##------#--##---##-----##--
-#--#--#---##-#--#-#----##---#-#-###----------#---#----#-#--------##---#---#####----#-#---------#--#
------#-###-#-----------#--####------#---#---------#--#-------------------#---#--###---#----####--#-
#-----------###----------##--#-#-#-----#-#-#---#------#-#--#---#-##---##--#-#--#----#-----------#--#
#-#-#--#--#---##-#--#----##--###-------#------#----#--------#---###-----#-----#----#---#----#-#-----
-#--#---#-#--#-------#----------###-------##-#-#-###---#-######-------####-----##--#------#--#-----#
-##--#----##----##---##--##-----#--#----#--#--###--#----#---#---##--#####-##------#-##-#-###-##--#--
----------###-----###------##--###-#--###---#-##-#----------#--#-###-----#---#-#-----##-##---#--##--
###--#--#---------#-------#-###------#--##------#-#---#------#-----#-##-##---##--#-###-------#-##-#-
-#------#----#-#--#-#----#--------#-#-#-----#-------####-#-#----#-#----#--------##-#---##-#-#--##-##
------#--##----------#------#--#----#--#-#---#-#---------------#----#--###-----#---##-#-------#----#
#-#-###--##--#-----------###--------#-#-#-#--##--#---##-#------------#--#-----##-#--#----##----##-#-
---##----#-#----#--#------#----#-#--#--------#--##---#-----------##--#-#-----#------#---#--##-------
----##----##--------##----------#---#--#----#-----##-----##---##-#--#-####-#-#--------#--#-##--#-#--
-###---#-------#------#-#-#-----#-----#----##-#-#-----##------#-#-#--#-#-------#-#-##-#--#-----#----
#-----#----#--#------#-#-#--#------#--#---##---#-#------#---#--##-#--##---##--#--#----------#-##----
#--#--#----##-#--####-----#------####------#--------#--###-----##---###-##--#-##----#-#---#----##---
#---#------##--#---#--#--------##--#----#-#----#------##------------#-####-------------#-#--##--####
#--#------#--####-##--#---#-----#-#-##--#-#-#-##-##-#--------##-#------#-#-----##---------#--#--#-##
####--#-#--#-----------#--##--##--#--##----#---###--##-#--#----#--#-----#--#----#-#----#--#--#---#--
------#--##--####-#--------##--#------#---#-#---#----#-#-------#--##-----#---#####-#----###------#--
-##--#--#--#----#-----#----------#-------#--#-----##-#-#-#---##-###--#--###-##--#----#---###----#---
-----###--##--#-##---##----##-----#--#---#--#---#----------#-##----#-#---##--#---------#--##----##-#
-#-###-##-----#-#--------#------#----------#--#-###----##-#-##------#-#--#---#####-##-----#--#-##-#-
---##--#--#--#--#---------#-##-----#---##----#-#-##-##----#-----#---#--#---#------------------#--#-#
#---#--------#---#-----#-#-----#-----#------#--#-##-#-##-#####----#---#---#------------#-#--#-#-#---
#------#-----------#--#####-#---#----##-----#-#--#-###-#-#-##---#-###--##-#-##-----##-###-#-----#---
--#-#-#--##--##-#----##------#-#--#------#----##--#--#-----#####------####--#-------#----------#----
-###--#----#-#--#----##--##-#-#-##-###-----#------#--------#-----#-----#-#--##-----#----##--#-------
#---#----###-----#--##-#-##-----#-#-#-#-------###-----#--#---#--------#--##-##-#-#-##-#--##----#---#
-#----#-E----#-----##-#------------#----#--#-----------#--------#--###--##---#------#---------#-#---
#----#--#-------#-------#--##--#---#--#-----#-#---##-##---#-----#-----#---#-------##-##---#-##-#-#-#
#-#---#---------------#---#-#-------#----#-#-#--#----#---------#--#----##----##----##-#-#----##---##
-#-#####--#---------#----#-#---#----#----#--#------##-##-#-##---#------###--------#-##-##--#-#------
-###-#-#-#----#-##--###--##--##--##---#-----##------------#----#-#--------#-##-#---#-#-#-----#------
---------##-------------##----#--#------------#-#--#--#-##---##---#------##-#------#----#-#---#---#-
----##------##-##-##-#-##--------------##-##---#-----#-##-#------#-#--#-----#-------##---#-#---#----
#-#--#--#------#---#-##-----------#------#-##--#-##------#-----##--------##----###-##---------#-#--#
---#--#---##---#----#-##--#------##---------##--##--#-#--#--##-#----##-#-------#---##-----#----#-###
-#-----#-#--##--##-#-#---##-----#-#-#-#---#-#--##-#-#--#----#--#-#-----#--#--#--#-----##---------#--
-#-#----#----#------------#---##-#-#-##--##--#---#-----#-#-##---#-#----#---##-----#----#--#----#----
----#-#-----#--#####---##--------##-----------#-#--------------##-#---#---#----##-#-------------##--
-#---#-#-##---#---##-----#-#--#-#--------------#-#-----------##--#-#--###------#------##--#-----#---
#---#--#--#---------##--#--####--#-#-#--####-----###----#------#---#----#--#-------#---------------#
-----##-#-#--##------##----#-----#--#----##-#-----------##--##--#####---#---##-##---#--------#-#-##-
#--##---#-------#----#--#-#-##-#---#-##-#--##-----##--#--#-##----#---###--##-#------#---#--#---#--#-
-#---#-#---#--#--------#-------##-----#---------#-#----#-#-------##--#-#-----#----------#-#--##-----
##-####--#----#----##--#-####--###-#--#---#---#-##------#-##----#-#-#----------#-----#--#--#--#-##--
---#-#-##-#---#-----#-##---#--##------#---------#-----##-#----###-##-----------##------#----##--#---
--#--#-#--#----##------#-##------------#--#-##---#--#--#---#---##--#-----###----#--#-#-##---#---#--#
----#---#----##--#-#----#--####--#---#----##----#--#-#--#-#----#-#---#----##-##---#-##----##-----#--
--------------#--#----###-----#-#--------###--#-#--###--#-----#----##----##----#-----#--##----#--#--