--##---##---##---##---##---##---##---##---##---##---##---##---##---##---##---##---##---##---##---##-
---##---##---##---##---##---##---##---##---##---##---##---##---##---##---##---##---##---##---##---##
---#----#----#----#----#----#----#-E--#----#----#----#----#----#----#----#----#----#----#----#----#-
#----#----#----#----#----#----#----#----#----#----#----#----#----#----#----#----#----#----#----#----
--#----#----#----#----#----#----#----#----#----#----#----#----#----#----#----#----#----#----#----#--
--##---##---##---##---##---##---##---##---##---##---##---##---##---##---##---##---##---##---##---##-
---##---##---##---##---##---##---##---##---##---##---##---##---##---##---##---##---##---##---##---##
---#----#----#----#----#----#----#----#----#----#----#----#----#----#----#----#----#----#----#----#-
#----#----#----#----#----#----#----#----#----#----#----#----#----#----#----#----#----#----#----#----
--#----#----#----#----#----#----#----#----#----#----#----#----#----#----#----#----#----#----#----#--
--##---##---##---##---##---##---##---##---##---##---##---##---##---##---##---##---##---##---##---##-
---##---##---##---##---##---##---##---##---##---##---##---##---##---##---##---##---##---##---##---##
---#----#----#----#----#----#----#----#----#----#----#----#----#----#----#----#----#----#----#----#-
#----#----#----#----#----#----#----#----#----#----#----#----#----#----#----#----#----#----#----#----
--#----#----#----#----#----#----#----#----#----#----#----#----#----#----#----#----#----#----#----#--
--##---##---##---##---##---##---##---##---##---##---##---##---##---##---##---##---##---##---##---##-
---##---##---##---##---##---##---##---##---##---##---##---##---##---##---##---##---##---##---##---##
---#----#----#----#----#----#----#----#----#----#----#----#----#----#----#----#----#----#----#----#-
#----#----#----#----#----#----#----#----#----#----#----#----#----#----#----#----#----#----#----#----
--#----#----#----#----#----#----#----#----#----#----#----#----#----#----#----#----#----#----#----#--
--##---##---##---##---##---##---##---##---##---##---##---##---##---##---##---##---##---##---##---##-
---##---##---##---##---##---##---##---##---##---##---##---##---##---##---##---##---##---##---##---##
---#----#----#----#----#----#----#----#----#----#----#----#----#----#----#----#----#----#----#----#-
#----#----#----#----#----#----#----#----#----#----#----#----#----#----#----#----#----#----#----#----
--#----#----#----#----#----#----#----#----#----#----#----#----#----#----#----#----#----#----#----#--
--##---##---##---##---##---##---##---##---##---##---##---##---##---##---##---##---##---##---##---##-
---##---##---##---##---##---##---##---##---##---##---##---##---##---##---##---##---##---##---##---##
---#----#----#----#----#----#----#----#----#----#----#----#----#----#----#----#----#----#----#----#-
#----#----#----#----#----#----#----#----#----#----#----#----#----#----#----#----#----#----#----#----
--#----#----#----#----#----#----#----#----#----#----#----#----#----#----#----#----#----#----#----#--
--##---##---##---##---##---##---##---##---##---##---##---##---##---##---##---##---##---##---##---##-
---##---##---##---##---##---##---##---##---##---##---##---##---##---##---##---##---##---##---##---##
---#----#----#----#----#----#----#----#----#----#----#----#----#----#----#----#----#----#----#----#-
#----#----#----#----#----#----#----#----#----#----#----#----#----#----#----#----#----#----#----#----
--#----#----#----#----#----#----#----#----#----#----#----#----#----#----#----#----#----#----#----#--
--##---##---##---##---##---##---##---##---##---##---##---##---##---##---##---##---##---##---##---##-
---##---##---##---##---##---##---##---##---##---##---##---##---##---##---##---##---##---##---##---##
---#----#----#----#----#----#----#----#----#----#----#----#----#----#----#----#----#----#----#----#-
#----#----#----#----#----#----#----#----#----#----#----#----#----#----#----#----#----#----#----#----
--#----#----#----#----#----#----#----#----#----#----#----#----#----#----#----#----#----#----#----#--
--##---##---##---##---##---##---##---##---##---##---##---##---##---##---##---##---##---##---##---##-
---##---##---##---##---##---##---##---##---##---##---##---##---##---##---##---##---##---##---##---##
---#----#----#----#----#----#----#----#----#----#----#----#----#----#----#----#----#----#----#----#-
#----#----#----#----#----#----#----#----#----#----#----#----#----#----#----#----#----#----#----#----
--#----#----#----#----#----#----#----#----#----#----#----#----#----#----#----#----#----#----#----#--
--##---##---##---##---##---##---##---##---##---##---##---##---##---##---##---##---##---##---##---##-
---##---##---##---##---##---##---##---##---##---##---##---##---##---##---##---##---##---##---##---##
---#----#----#----#----#----#----#----#----#----#----#----#----#----#----#----#----#----#----#----#-
#----#----#----#----#----#----#----#----#----#----#----#----#----#----#----#----#----#----#----#----
--#----#----#----#----#----#----#----#----#----#----#----#----#----#----#----#----#----#----#----#--
--##---##---##---##---##---##---##---##---##---##---##---##---##---##---##---##---##---##---##---##-
---##---##---##---##---##---##---##---##---##---##---##---##---##---##---##---##---##---##---##---##
---#----#----#----#----#----#----#----#----#----#----#----#----#----#----#----#----#----#----#----#-
#----#----#----#----#----#----#----#----#----#----#----#----#----#----#----#----#----#----#----#----
--#----#----#----#----#----#----#----#----#----#----#----#----#----#----#----#----#----#----#----#--
--##---##---##---##---##---##---##---##---##---##---##---##---##---##---##---##---##---##---##---##-
---##---##---##---##---##---##---##---##---##---##---##---##---##---##---##---##---##---##---##---##
---#----#----#----#----#----#----#----#----#----#----#----#----#----#----#----#----#----#----#----#-
#----#----#----#----#----#----#----#----#----#----#----#----#----#----#----#----#----#----#----#----
--#----#----#----#----#----#----#----#----#----#----#----#----#----#----#----#----#----#----#----#--
--##---##---##---##---##---##---##---##---##---##---##---##---##---##---##---##---##---##---##---##-
---##---##---##---##---##---##---##---##---##---##---##---##---##---##---##---##---##---##---##---##
---#----#---S#----#----#----#----#----#----#----#----#----#----#----#----#----#----#----#----#----#-
#----#----#----#----#----#----#----#----#----#----#----#----#----#----#----#----#----#----#----#----
--#----#----#----#----#----#----#----#----#----#----#----#----#----#----#----#----#----#----#----#--
--##---##---##---##---##---##---##---##---##---##---##---##---##---##---##---##---##---##---##---##-
---##---##---##---##---##---##---##---##---##---##---##---##---##---##---##---##---##---##---##---##
---#----#----#----#----#----#----#----#----#----#----#----#----#----#----#----#----#----#----#----#-
#----#----#----#----#----#----#----#----#----#----#----#----#----#----#----#----#----#----#----#----
--#----#----#----#----#----#----#----#----#----#----#----#----#----#----#----#----#----#----#----#--
--##---##---##---##---##---##---##---##---##---##---##---##---##---##---##---##---##---##---##---##-
---##---##---##---##---##---##---##---##---##---##---##---##---##---##---##---##---##---##---##---##
---#----#----#----#----#----#----#----#----#----#----#----#----#----#----#----#----#----#----#----#-
#----#----#----#----#----#----#----#----#----#----#----#----#----#----#----#----#----#----#----#----
--#----#----#----#----#----#----#----#----#----#----#----#----#----#----#----#----#----#----#----#--
--##---##---##---##---##---##---##---##---##---##---##---##---##---##---##---##---##---##---##---##-
---##---##---##---##---##---##---##---##---##---##---##---##---##---##---##---##---##---##---##---##
---#----#----#----#----#----#----#----#----#----#----#----#----#----#----#----#----#----#----#----#-
#----#----#----#----#----#----#----#----#----#----#----#----#----#----#----#----#----#----#----#----
--#----#----#----#----#----#----#----#----#----#----#----#----#----#----#----#----#----#----#----#--
--##---##---##---##---##---##---##---##---##---##---##---##---##---##---##---##---##---##---##---##-
---##---##---##---##---##---##---##---##---##---##---##---##---##---##---##---##---##---##---##---##
---#----#----#----#----#----#----#----#----#----#----#----#----#----#----#----#----#----#----#----#-
#----#----#----#----#----#----#----#----#----#----#----#----#----#----#----#----#----#----#----#----
--#----#----#----#----#----#----#----#----#----#----#----#----#----#----#----#----#----#----#----#--
--##---##---##---##---##---##---##---##---##---##---##---##---##---##---##---##---##---##---##---##-
---##---##---##---##---##---##---##---##---##---##---##---##---##---##---##---##---##---##---##---##
---#----#----#----#----#----#----#----#----#----#----#----#----#----#----#----#----#----#----#----#-
#----#----#----#----#----#----#----#----#----#----#----#----#----#----#----#----#----#----#----#----
--#----#----#----#----#----#----#----#----#----#----#----#----#----#----#----#----#----#----#----#--
--##---##---##---##---##---##---##---##---##---##---##---##---##---##---##---##---##---##---##---##-
---##---##---##---##---##---##---##---##---##---##---##---##---##---##---##---##---##---##---##---##
---#----#----#----#----#----#----#----#----#----#----#----#----#----#----#----#----#----#----#----#-
#----#----#----#----#----#----#----#----#----#----#----#----#----#----#----#----#----#----#----#----
--#----#----#----#----#----#----#----#----#----#----#----#----#----#----#----#----#----#----#----#--
--##---##---##---##---##---##---##---##---##---##---##---##---##---##---##---##---##---##---##---##-
---##---##---##---##---##---##---##---##---##---##---##---##---##---##---##---##---##---##---##---##
---#----#----#----#----#----#----#----#----#----#----#----#----#----#----#----#----#----#----#----#-
#----#----#----#----#----#----#----#----#----#----#----#----#----#----#----#----#----#----#----#----
--#----#----#----#----#----#----#----#----#----#----#----#----#----#----#----#----#----#----#----#--