----#----#----#----#----#----#----#----#----#----#----#----#----#----#----#----#----#----#----#----#
-#--#-#--#-#--#-#--#-#--#-#--#-#--#-#--#-#--#-#--#-#--#-#--#-#--#-#--#-#--#-#--#-#--#-#--#-#--#-#--#
----#----#----#----#----#----#----#----#----#----#----#----#----#----#----#----#----#----#----#----#
--#----#----#----#----#----#----#----#----#----#----#----#----#----#----#----#----#----#----#----#--
-#-##-#-##-#-##-#-##-#-##-#-##-#-##-#-##-#-##-#-##-#-##-#-##-#-##-#-##-#-##-#-##-#-##-#-##-#-##-#-##
----#----#----#----#----#----#----#----#----#----#----#----#----#----#----#----#----#----#----#----#
-#--#-#--#-#--#-#--#-#--#-#--#-#--#-#--#-#--#-#--#-#--#-#--#-#--#-#--#-#--#-#--#-#--#-#--#-#--#-#--#
----#----#----#----#----#----#----#----#----#----#----#----#----#----#----#----#----#----#----#----#
--#----#----#----#----#----#----#----#----#----#----#----#----#----#----#----#----#----#----#----#--
-#-##-#-##-#-##-#-##-#-##-#-##-#-##-#-##-#-##-#-##-#-##-#-##-#-##-#-##-#-##-#-##-#-##-#-##-#-##-#-##
----#----#----#----#----#----#----#----#----#----#----#----#----#----#----#----#----#----#----#----#
-#--#-#--#-#--#-#--#-#--#-#--#-#--#-#--#-#--#-#--#-#--#-#--#-#--#-#--#-#--#-#--#-#--#-#--#-#--#-#--#
----#----#----#----#----#----#----#----#----#----#----#----#----#----#----#----#----#----#----#----#
--#----#----#----#----#----#----#----#----#----#----#----#----#----#----#----#----#----#----#----#--
-#-##-#-##-#-##-#-##-#-##-#-##-#-##-#-##-#-##-#-##-#-##-#-##-#-##-#-##-#-##-#-##-#-##-#-##-#-##-#-##
----#----#----#----#----#----#----#----#----#----#----#----#----#----#----#----#----#----#----#----#
-#--#-#--#-#--#-#--#-#--#-#--#-#--#-#--#-#--#-#--#-#--#-#--#-#--#-#--#-#--#-#--#-#--#-#--#-#--#-#--#
----#----#----#----#----#----#----#----#----#----#----#----#----#----#----#----#----#----#----#----#
--#----#----#----#----#----#----#----#----#----#----#----#----#----#----#----#----#----#----#----#--
-#-##-#-##-#-##-#-##-#-##-#-##-#-##-#-##-#-##-#-##-#-##-#-##-#-##-#-##-#-##-#-##-#-##-#-##-#-##-#-##
----#----#----#----#----#----#----#----#----#----#----#----#----#----#----#----#----#----#----#----#
-#--#-#--#-#--#-#--#-#--#-#--#-#--#-#--#-#--#-#--#-#--#-#--#-#--#-#--#-#--#-#--#-#--#-#--#-#--#-#--#
----#----#----#----#----#----#----#----#----#----#----#----#----#----#----#----#----#----#----#----#
--#----#----#----#----#----#----#----#----#----#----#----#----#----#----#----#----#----#----#----#--
-#-##-#-##-#-##-#-##-#-##-#-##-#-##-#-##-#-##-#-##-#-##-#-##-#-##-#-##-#-##-#-##-#-##-#-##-#-##-#-##
----#----#----#----#----#----#----#----#----#----#----#----#----#----#----#----#----#----#---E#----#
-#--#-#--#-#--#-#--#-#--#-#--#-#--#-#--#-#--#-#--#-#--#-#--#-#--#-#--#-#--#-#--#-#--#-#--#-#--#-#--#
----#----#----#----#----#----#----#----#----#----#----#----#----#----#----#----#----#----#----#----#
--#----#----#----#----#----#----#----#----#----#----#----#----#----#----#----#----#----#----#----#--
-#-##-#-##-#-##-#-##-#-##-#-##-#-##-#-##-#-##-#-##-#-##-#-##-#-##-#-##-#-##-#-##-#-##-#-##-#-##-#-##
----#----#----#----#----#----#----#----#----#----#----#----#----#----#----#----#----#----#----#----#
-#--#-#--#-#--#-#--#-#--#-#--#-#--#-#--#-#--#-#--#-#--#-#--#-#--#-#--#-#--#-#--#-#--#-#--#-#--#-#--#
----#----#----#----#----#----#----#----#----#----#----#----#----#----#----#----#----#----#----#----#
--#----#----#----#----#----#----#----#----#----#----#----#----#----#----#----#----#----#----#----#--
-#-##-#-##-#-##-#-##-#-##-#-##-#-##-#-##-#-##-#-##-#-##-#-##-#-##-#-##-#-##-#-##-#-##-#-##-#-##-#-##
----#----#----#----#----#----#----#----#----#----#----#----#----#----#----#----#----#----#----#----#
-#--#-#--#-#--#-#--#-#--#-#--#-#--#-#--#-#--#-#--#-#--#-#--#-#--#-#--#-#--#-#--#-#--#-#--#-#--#-#--#
----#----#----#----#----#----#----#----#----#----#----#----#----#----#----#----#----#----#----#----#
--#----#----#----#----#----#----#----#----#----#----#----#----#----#----#----#----#----#----#----#--
-#-##-#-##-#-##-#-##-#-##-#-##-#-##-#-##-#-##-#-##-#-##-#-##-#-##-#-##-#-##-#-##-#-##-#-##-#-##-#-##
----#----#----#----#----#----#----#----#----#----#----#----#----#----#----#----#----#----#----#----#
-#--#-#--#-#--#-#--#-#--#-#--#-#--#-#--#-#--#-#--#-#--#-#--#-#--#-#--#-#--#-#--#-#--#-#--#-#--#-#--#
----#----#----#----#----#----#----#----#----#----#----#----#----#----#----#----#----#----#----#----#
--#----#----#----#----#----#----#----#----#----#----#----#----#----#----#----#----#----#----#----#--
-#-##-#-##-#-##-#-##-#-##-#-##-#-##-#-##-#-##-#-##-#-##-#-##-#-##-#-##-#-##-#-##-#-##-#-##-#-##-#-##
----#----#----#----#----#----#----#----#----#----#----#----#----#----#----#----#----#----#----#----#
-#--#-#--#-#--#-#--#-#--#-#--#-#--#-#--#-#--#-#--#-#--#-#--#-#--#-#--#-#--#-#--#-#--#-#--#-#--#-#--#
----#----#----#----#----#----#----#----#----#----#----#----#----#----#----#----#----#----#----#----#
--#----#----#----#----#----#----#----#----#----#----#----#----#----#----#----#----#----#----#----#--
-#-##-#-##-#-##-#-##-#-##-#-##-#-##-#-##-#-##-#-##-#-##-#-##-#-##-#-##-#-##-#-##-#-##-#-##-#-##-#-##
----#----#----#----#----#----#----#----#----#----#----#----#----#----#----#----#----#----#----#----#
-#--#-#--#-#--#-#--#-#--#-#--#-#--#-#--#-#--#-#--#-#--#-#--#-#--#-#--#-#--#-#--#-#--#-#--#-#--#-#--#
----#----#----#----#----#----#----#----#----#----#----#----#----#----#----#----#----#----#----#----#
--#----#----#----#----#----#----#----#----#----#----#----#----#----#----#----#----#----#----#----#--
-#-##-#-##-#-##-#-##-#-##-#-##-#-##-#-##-#-##-#-##-#-##-#-##-#-##-#-##-#-##-#-##-#-##-#-##-#-##-#-##
----#----#----#----#----#----#----#----#----#----#----#----#----#----#----#----#----#----#----#----#
-#--#-#--#-#--#-#--#-#--#-#--#-#--#-#--#-#--#-#--#-#--#-#--#-#--#-#--#-#--#-#--#-#--#-#--#-#--#-#--#
----#----#----#----#----#----#----#----#----#----#----#----#----#----#----#----#----#----#----#----#
--#----#----#----#----#----#----#----#----#----#----#----#----#----#----#----#----#----#----#----#--
-#-##-#-##-#-##-#-##-#-##-#-##-#-##-#-##-#-##-#-##-#-##-#-##-#-##-#-##-#-##-#-##-#-##-#-##-#-##-#-##
----#----#----#----#----#----#----#----#----#----#----#----#----#----#----#----#----#----#----#----#
-#--#-#--#-#--#-#--#-#--#-#--#-#--#-#--#-#--#-#--#-#--#-#--#-#--#-#--#-#--#-#--#-#--#-#--#-#--#-#--#
----#----#----#----#----#----#----#----#----#----#----#----#----#----#----#----#----#----#----#----#
--#----#----#----#----#----#----#----#----#----#----#----#----#----#----#----#----#----#----#----#--
-#-##-#-##-#-##-#-##-#-##-#-##-#-##-#-##-#-##-#-##-#-##-#-##-#-##-#-##-#-##-#-##-#-##-#-##-#-##-#-##
----#----#----#----#----#----#----#----#----#----#----#----#----#----#----#----#----#----#----#----#
-#--#-#--#-#--#-#--#-#--#-#--#-#--#-#--#-#--#-#--#-#--#-#--#-#--#-#--#-#--#-#--#-#--#-#--#-#--#-#--#
----#----#----#----#----#----#----#----#----#----#----#----#----#----#----#----#----#----#----#----#
--#----#----#----#----#----#----#----#----#----#----#----#----#----#----#----#----#----#----#----#--
-#-##-#-##-#-##-#-##-#-##-#-##-#-##-#-##-#-##-#-##-#-##-#-##-#-##-#-##-#-##-#-##-#-##-#-##-#-##-#-##
----#----#----#----#----#----#----#----#----#----#----#----#----#----#----#----#----#----#----#----#
-#--#-#--#-#--#-#--#-#--#-#--#-#--#-#--#-#--#-#--#-#--#-#--#-#--#-#--#-#--#-#--#-#--#-#--#-#--#-#--#
----#----#----#----#----#----#----#----#----#----#----#----#----#----#----#----#----#----#----#----#
--#----#----#----#----#----#----#----#----#----#----#----#----#----#----#----#----#----#----#----#--
-#-##-#-##-#-##-#-##-#-##-#-##-#-##-#-##-#-##-#-##-#-##-#-##-#-##-#-##-#-##-#-##-#-##-#-##-#-##-#-##
----#----#----#----#----#----#----#----#----#----#----#----#----#----#----#----#----#----#----#----#
-#--#-#--#-#--#-#--#-#--#-#--#-#--#-#--#-#--#-#--#-#--#-#--#-#--#-#--#-#--#-#--#-#--#-#--#-#--#-#--#
----#----#----#----#----#----#----#----#----#----#----#----#----#----#----#----#----#----#----#----#
--#----#----#----#----#----#----#----#----#----#----#----#----#----#----#----#----#----#----#----#--
-#-##-#-##-#-##-#-##-#-##-#-##S#-##-#-##-#-##-#-##-#-##-#-##-#-##-#-##-#-##-#-##-#-##-#-##-#-##-#-##
----#----#----#----#----#----#----#----#----#----#----#----#----#----#----#----#----#----#----#----#
-#--#-#--#-#--#-#--#-#--#-#--#-#--#-#--#-#--#-#--#-#--#-#--#-#--#-#--#-#--#-#--#-#--#-#--#-#--#-#--#
----#----#----#----#----#----#----#----#----#----#----#----#----#----#----#----#----#----#----#----#
--#----#----#----#----#----#----#----#----#----#----#----#----#----#----#----#----#----#----#----#--
-#-##-#-##-#-##-#-##-#-##-#-##-#-##-#-##-#-##-#-##-#-##-#-##-#-##-#-##-#-##-#-##-#-##-#-##-#-##-#-##
----#----#----#----#----#----#----#----#----#----#----#----#----#----#----#----#----#----#----#----#
-#--#-#--#-#--#-#--#-#--#-#--#-#--#-#--#-#--#-#--#-#--#-#--#-#--#-#--#-#--#-#--#-#--#-#--#-#--#-#--#
----#----#----#----#----#----#----#----#----#----#----#----#----#----#----#----#----#----#----#----#
--#----#----#----#----#----#----#----#----#----#----#----#----#----#----#----#----#----#----#----#--
-#-##-#-##-#-##-#-##-#-##-#-##-#-##-#-##-#-##-#-##-#-##-#-##-#-##-#-##-#-##-#-##-#-##-#-##-#-##-#-##
----#----#----#----#----#----#----#----#----#----#----#----#----#----#----#----#----#----#----#----#
-#--#-#--#-#--#-#--#-#--#-#--#-#--#-#--#-#--#-#--#-#--#-#--#-#--#-#--#-#--#-#--#-#--#-#--#-#--#-#--#
----#----#----#----#----#----#----#----#----#----#----#----#----#----#----#----#----#----#----#----#
--#----#----#----#----#----#----#----#----#----#----#----#----#----#----#----#----#----#----#----#--
-#-##-#-##-#-##-#-##-#-##-#-##-#-##-#-##-#-##-#-##-#-##-#-##-#-##-#-##-#-##-#-##-#-##-#-##-#-##-#-##
----#----#----#----#----#----#----#----#----#----#----#----#----#----#----#----#----#----#----#----#
-#--#-#--#-#--#-#--#-#--#-#--#-#--#-#--#-#--#-#--#-#--#-#--#-#--#-#--#-#--#-#--#-#--#-#--#-#--#-#--#
----#----#----#----#----#----#----#----#----#----#----#----#----#----#----#----#----#----#----#----#
--#----#----#----#----#----#----#----#----#----#----#----#----#----#----#----#----#----#----#----#--
-#-##-#-##-#-##-#-##-#-##-#-##-#-##-#-##-#-##-#-##-#-##-#-##-#-##-#-##-#-##-#-##-#-##-#-##-#-##-#-##