#---##---##---##---##---##--E##---##---##---##---##---##---##---##---##---##---##---##---##---##---#
-#-#--#-#--#-#--#-#--#-#--#-#--#-#--#-#--#-#--#-#--#-#--#-#--#-#--#-#--#-#--#-#--#-#--#-#--#-#--#-#-
----------------------------------------------------------------------------------------------------
--#----#----#----#----#----#----#----#----#----#----#----#----#----#----#----#----#----#----#----#--
--#-#--#-#--#-#--#-#--#-#--#-#--#-#--#-#--#-#--#-#--#-#--#-#--#-#--#-#--#-#--#-#--#-#--#-#--#-#--#-#
#---##---##---##---##---##---##---##---##---##---##---##---##---##---##---##---##---##---##---##---#
-#-#--#-#--#-#--#-#--#-#--#-#--#-#--#-#--#-#--#-#--#-#--#-#--#-#--#-#--#-#--#-#--#-#--#-#--#-#--#-#-
----------------------------------------------------------------------------------------------------
--#----#----#----#----#----#----#----#----#----#----#----#----#----#----#----#----#----#----#----#--
--#-#--#-#--#-#--#-#--#-#--#-#--#-#--#-#--#-#--#-#--#-#--#-#--#-#--#-#--#-#--#-#--#-#--#-#--#-#--#-#
#---##---##---##---##---##---##---##S--##---##---##---##---##---##---##---##---##---##---##---##---#
-#-#--#-#--#-#--#-#--#-#--#-#--#-#--#-#--#-#--#-#--#-#--#-#--#-#--#-#--#-#--#-#--#-#--#-#--#-#--#-#-
----------------------------------------------------------------------------------------------------
--#----#----#----#----#----#----#----#----#----#----#----#----#----#----#----#----#----#----#----#--
--#-#--#-#--#-#--#-#--#-#--#-#--#-#--#-#--#-#--#-#--#-#--#-#--#-#--#-#--#-#--#-#--#-#--#-#--#-#--#-#
#---##---##---##---##---##---##---##---##---##---##---##---##---##---##---##---##---##---##---##---#
-#-#--#-#--#-#--#-#--#-#--#-#--#-#--#-#--#-#--#-#--#-#--#-#--#-#--#-#--#-#--#-#--#-#--#-#--#-#--#-#-
----------------------------------------------------------------------------------------------------
--#----#----#----#----#----#----#----#----#----#----#----#----#----#----#----#----#----#----#----#--
--#-#--#-#--#-#--#-#--#-#--#-#--#-#--#-#--#-#--#-#--#-#--#-#--#-#--#-#--#-#--#-#--#-#--#-#--#-#--#-#
#---##---##---##---##---##---##---##---##---##---##---##---##---##---##---##---##---##---##---##---#
-#-#--#-#--#-#--#-#--#-#--#-#--#-#--#-#--#-#--#-#--#-#--#-#--#-#--#-#--#-#--#-#--#-#--#-#--#-#--#-#-
----------------------------------------------------------------------------------------------------
--#----#----#----#----#----#----#----#----#----#----#----#----#----#----#----#----#----#----#----#--
--#-#--#-#--#-#--#-#--#-#--#-#--#-#--#-#--#-#--#-#--#-#--#-#--#-#--#-#--#-#--#-#--#-#--#-#--#-#--#-#
#---##---##---##---##---##---##---##---##---##---##---##---##---##---##---##---##---##---##---##---#
-#-#--#-#--#-#--#-#--#-#--#-#--#-#--#-#--#-#--#-#--#-#--#-#--#-#--#-#--#-#--#-#--#-#--#-#--#-#--#-#-
----------------------------------------------------------------------------------------------------
--#----#----#----#----#----#----#----#----#----#----#----#----#----#----#----#----#----#----#----#--
--#-#--#-#--#-#--#-#--#-#--#-#--#-#--#-#--#-#--#-#--#-#--#-#--#-#--#-#--#-#--#-#--#-#--#-#--#-#--#-#
#---##---##---##---##---##---##---##---##---##---##---##---##---##---##---##---##---##---##---##---#
-#-#--#-#--#-#--#-#--#-#--#-#--#-#--#-#--#-#--#-#--#-#--#-#--#-#--#-#--#-#--#-#--#-#--#-#--#-#--#-#-
----------------------------------------------------------------------------------------------------
--#----#----#----#----#----#----#----#----#----#----#----#----#----#----#----#----#----#----#----#--
--#-#--#-#--#-#--#-#--#-#--#-#--#-#--#-#--#-#--#-#--#-#--#-#--#-#--#-#--#-#--#-#--#-#--#-#--#-#--#-#
#---##---##---##---##---##---##---##---##---##---##---##---##---##---##---##---##---##---##---##---#
-#-#--#-#--#-#--#-#--#-#--#-#--#-#--#-#--#-#--#-#--#-#--#-#--#-#--#-#--#-#--#-#--#-#--#-#--#-#--#-#-
----------------------------------------------------------------------------------------------------
--#----#----#----#----#----#----#----#----#----#----#----#----#----#----#----#----#----#----#----#--
--#-#--#-#--#-#--#-#--#-#--#-#--#-#--#-#--#-#--#-#--#-#--#-#--#-#--#-#--#-#--#-#--#-#--#-#--#-#--#-#
#---##---##---##---##---##---##---##---##---##---##---##---##---##---##---##---##---##---##---##---#
-#-#--#-#--#-#--#-#--#-#--#-#--#-#--#-#--#-#--#-#--#-#--#-#--#-#--#-#--#-#--#-#--#-#--#-#--#-#--#-#-
----------------------------------------------------------------------------------------------------
--#----#----#----#----#----#----#----#----#----#----#----#----#----#----#----#----#----#----#----#--
--#-#--#-#--#-#--#-#--#-#--#-#--#-#--#-#--#-#--#-#--#-#--#-#--#-#--#-#--#-#--#-#--#-#--#-#--#-#--#-#
#---##---##---##---##---##---##---##---##---##---##---##---##---##---##---##---##---##---##---##---#
-#-#--#-#--#-#--#-#--#-#--#-#--#-#--#-#--#-#--#-#--#-#--#-#--#-#--#-#--#-#--#-#--#-#--#-#--#-#--#-#-
----------------------------------------------------------------------------------------------------
--#----#----#----#----#----#----#----#----#----#----#----#----#----#----#----#----#----#----#----#--
--#-#--#-#--#-#--#-#--#-#--#-#--#-#--#-#--#-#--#-#--#-#--#-#--#-#--#-#--#-#--#-#--#-#--#-#--#-#--#-#
#---##---##---##---##---##---##---##---##---##---##---##---##---##---##---##---##---##---##---##---#
-#-#--#-#--#-#--#-#--#-#--#-#--#-#--#-#--#-#--#-#--#-#--#-#--#-#--#-#--#-#--#-#--#-#--#-#--#-#--#-#-
----------------------------------------------------------------------------------------------------
--#----#----#----#----#----#----#----#----#----#----#----#----#----#----#----#----#----#----#----#--
--#-#--#-#--#-#--#-#--#-#--#-#--#-#--#-#--#-#--#-#--#-#--#-#--#-#--#-#--#-#--#-#--#-#--#-#--#-#--#-#
#---##---##---##---##---##---##---##---##---##---##---##---##---##---##---##---##---##---##---##---#
-#-#--#-#--#-#--#-#--#-#--#-#--#-#--#-#--#-#--#-#--#-#--#-#--#-#--#-#--#-#--#-#--#-#--#-#--#-#--#-#-
----------------------------------------------------------------------------------------------------
--#----#----#----#----#----#----#----#----#----#----#----#----#----#----#----#----#----#----#----#--
--#-#--#-#--#-#--#-#--#-#--#-#--#-#--#-#--#-#--#-#--#-#--#-#--#-#--#-#--#-#--#-#--#-#--#-#--#-#--#-#
#---##---##---##---##---##---##---##---##---##---##---##---##---##---##---##---##---##---##---##---#
-#-#--#-#--#-#--#-#--#-#--#-#--#-#--#-#--#-#--#-#--#-#--#-#--#-#--#-#--#-#--#-#--#-#--#-#--#-#--#-#-
----------------------------------------------------------------------------------------------------
--#----#----#----#----#----#----#----#----#----#----#----#----#----#----#----#----#----#----#----#--
--#-#--#-#--#-#--#-#--#-#--#-#--#-#--#-#--#-#--#-#--#-#--#-#--#-#--#-#--#-#--#-#--#-#--#-#--#-#--#-#
#---##---##---##---##---##---##---##---##---##---##---##---##---##---##---##---##---##---##---##---#
-#-#--#-#--#-#--#-#--#-#--#-#--#-#--#-#--#-#--#-#--#-#--#-#--#-#--#-#--#-#--#-#--#-#--#-#--#-#--#-#-
----------------------------------------------------------------------------------------------------
--#----#----#----#----#----#----#----#----#----#----#----#----#----#----#----#----#----#----#----#--
--#-#--#-#--#-#--#-#--#-#--#-#--#-#--#-#--#-#--#-#--#-#--#-#--#-#--#-#--#-#--#-#--#-#--#-#--#-#--#-#
#---##---##---##---##---##---##---##---##---##---##---##---##---##---##---##---##---##---##---##---#
-#-#--#-#--#-#--#-#--#-#--#-#--#-#--#-#--#-#--#-#--#-#--#-#--#-#--#-#--#-#--#-#--#-#--#-#--#-#--#-#-
----------------------------------------------------------------------------------------------------
--#----#----#----#----#----#----#----#----#----#----#----#----#----#----#----#----#----#----#----#--
--#-#--#-#--#-#--#-#--#-#--#-#--#-#--#-#--#-#--#-#--#-#--#-#--#-#--#-#--#-#--#-#--#-#--#-#--#-#--#-#
#---##---##---##---##---##---##---##---##---##---##---##---##---##---##---##---##---##---##---##---#
-#-#--#-#--#-#--#-#--#-#--#-#--#-#--#-#--#-#--#-#--#-#--#-#--#-#--#-#--#-#--#-#--#-#--#-#--#-#--#-#-
----------------------------------------------------------------------------------------------------
--#----#----#----#----#----#----#----#----#----#----#----#----#----#----#----#----#----#----#----#--
--#-#--#-#--#-#--#-#--#-#--#-#--#-#--#-#--#-#--#-#--#-#--#-#--#-#--#-#--#-#--#-#--#-#--#-#--#-#--#-#
#---##---##---##---##---##---##---##---##---##---##---##---##---##---##---##---##---##---##---##---#
-#-#--#-#--#-#--#-#--#-#--#-#--#-#--#-#--#-#--#-#--#-#--#-#--#-#--#-#--#-#--#-#--#-#--#-#--#-#--#-#-
----------------------------------------------------------------------------------------------------
--#----#----#----#----#----#----#----#----#----#----#----#----#----#----#----#----#----#----#----#--
--#-#--#-#--#-#--#-#--#-#--#-#--#-#--#-#--#-#--#-#--#-#--#-#--#-#--#-#--#-#--#-#--#-#--#-#--#-#--#-#
#---##---##---##---##---##---##---##---##---##---##---##---##---##---##---##---##---##---##---##---#
-#-#--#-#--#-#--#-#--#-#--#-#--#-#--#-#--#-#--#-#--#-#--#-#--#-#--#-#--#-#--#-#--#-#--#-#--#-#--#-#-
----------------------------------------------------------------------------------------------------
--#----#----#----#----#----#----#----#----#----#----#----#----#----#----#----#----#----#----#----#--
--#-#--#-#--#-#--#-#--#-#--#-#--#-#--#-#--#-#--#-#--#-#--#-#--#-#--#-#--#-#--#-#--#-#--#-#--#-#--#-#
#---##---##---##---##---##---##---##---##---##---##---##---##---##---##---##---##---##---##---##---#
-#-#--#-#--#-#--#-#--#-#--#-#--#-#--#-#--#-#--#-#--#-#--#-#--#-#--#-#--#-#--#-#--#-#--#-#--#-#--#-#-
----------------------------------------------------------------------------------------------------
--#----#----#----#----#----#----#----#----#----#----#----#----#----#----#----#----#----#----#----#--
--#-#--#-#--#-#--#-#--#-#--#-#--#-#--#-#--#-#--#-#--#-#--#-#--#-#--#-#--#-#--#-#--#-#--#-#--#-#--#-#
#---##---##---##---##---##---##---##---##---##---##---##---##---##---##---##---##---##---##---##---#
-#-#--#-#--#-#--#-#--#-#--#-#--#-#--#-#--#-#--#-#--#-#--#-#--#-#--#-#--#-#--#-#--#-#--#-#--#-#--#-#-
----------------------------------------------------------------------------------------------------
--#----#----#----#----#----#----#----#----#----#----#----#----#----#----#----#----#----#----#----#--
--#-#--#-#--#-#--#-#--#-#--#-#--#-#--#-#--#-#--#-#--#-#--#-#--#-#--#-#--#-#--#-#--#-#--#-#--#-#--#-#