--#-####--#----#--##-----#-----#--#---#--#--------#------#--#--------##-#-#-#-#----#---#--#--#----#-
-#-#---#---------#--##---##----#---##--------#-#--#-#-#####--#------###------#-#--##---#---##-#----#
-----#---#--------#--#----#---#--#---##-#-----#------------#--------##----###---####-#---------##--#
-##-----#-----###-#--###-----##--#-------------#-#--#-###-----#--##-#-##----------####-#---#--#-----
--##-#-----#-#-#----###-----#--#--###--##----#-#---#--#-----#---------##-###--##------#-----#-#-----
---------#-#-----#-----#-#-#--#--#-------------#------##--------##-------#--#-#-#---##----#--------#
#----###------#-----#-----#---#-#---#----#------#-#---------#------#-----#---#-##--#---#-#--#--#----
--##-#---#-##-#####-#-##-----###-----#-###-----#-#----#------#-#------##-#--------------#--#--#--##-
-----#--#----#---#-##--#-#-#---#--#-#---#-#--#----#--------#---##-#--##----##---#-#--#------#-#-----
----##--#---#-#-#-----------#-#----------#-#--#---#-----------##--#---#-#--#-#----#----------#---#-#
#--#--#--###--###-------#-------#-##---##--#---#-----#-#-------####------#--#-#--#---------#----#--#
-#-##--###-#-##-#-----#-------#-####--#--------#---------#--------#--#-#--#-####-------#-#--#-------
-#-#---------#--##-##---#-#--#--#----#-####--#---#-----#------###----#------#--------#-###-###-#----
##---#----#---##--#-##-----------#---##-----#-#---###----##---##--#---------#------------####-#-----
---#---####--#-#-#--#--#---#-------#-#---##-----#-#-----#------##-#------------------#--#--#----##--
-----#-#--#------#----#--##------##-#-----#------##-------------#-#-#-####---##-----##------###---#-
-##---#-----##-#-----#-#-##-#-#----#---##--#--##-------#-----##-#-------###--#-----#--#--###--#-#---
----##---------#-#---#--#-##----#--#-####-----###-#-######-##-#--#-----#-#-----#-----#-###-#-#-#----
-#-#------#--#-#------------#---#------#----#----#--####-----####---##--#####-------#-#---##--##--##
--#--#------#-----#--##-#-----#-##-##-#---#-#-#---##-##--#------#-#-##-#-#---#-#--#----------##-----
-##-##--##-----##-##--#--#-----#--#--####----#------##----#----###-#-#-----#---------#--#-#-#-------
------##--##-----------#------------##-#----####-####----------#-----------##--##---#----##---------
-##-##-----#-#----#-##-------#--#--##-#-#-----------###----##---##---#---#--####-###--##-#---#-----#
---#--#-#------##-#-----------##----#----------#---##-#------#-------#-#------------#--#-###-#--#-#-
-##---------#----#--#--###---#-#------###---#---#---##------##--#-##------------##--#-----##---#--#-
-#----##--#-#--#----###-#-#---#####----##-#-#--##-##-----------#-##---#---#----#--#---#-####------#-
--------##---##-##---#-#-----#-#-#------#-----#-###----------#-#---#--#--#---###--##-----#----##-#--
#---#--------#---##-----#-##--#--#---#-----##---#--##-#--#--##--##---------##-#--##--##------##-#---
--#---#----#--#--#---##----#-####---#---#-----##-----#-#--#----##----#---###--#-##-------#---##-#---
----#----#-#--#-------#----#---##-----#-#------#-#---#----------------------#-##----#---#--#--------
##---#--#--#--#-------###-#--#--#-#####----#####---##---##--#-#---------#----####--#---#---#--##-#--
-#--##-#----#---#------#---#-#--##-------#------######------S---##--#--#---#-#---------#---------#--
--#----------------#----##-#-#----#-#----#-#--#---#---#--#--#---#-#---#-#---#-#--#----#----#--------
-#--#---#------###---###--#--#-#-#-----##---#-#--#--#--#------#------#--#-#----#-----#---#--###-#---
---#--#-------#------#---#---#-#-----#-#-#--#----##------#-----#-#-#-#---#---#----------#--#--------
-------#-#-----------##------#------#-####------#------#---------------#-#----#----#---##----------#
#----##--#---------#-#--#-----#-##---#----------#-####---#--##-#---##---#--#--------------###--#-#--
----#-##--------#--###-##-#-------#-#--#--#-#-#-#-#----#--#----###--------#---#-##-###-----###------
##---#-#----#--#-------------#----#-#-----#-##-------#--------#------#-----###--#---#-#--#-#--#--#-#
--------------#---#---#-#-------#--#------#---###--#----#--------#-#-------------###-#--#--#---#-#--
-#--#---#-#-#----##--#--#-#-------#--#-#------##-##-##------#---###--#---##--#-#--##--#-#---#--#---#
-----##---##--#-#----#-----------#------#---#---------#-##---#----##------#-#----##-###-##--##---#-#
-------#---#-#-----#-#----##--####------#-----#-----#--#-#----#---#--#--#--#-#---#--##-##--------#-#
-#-##-##-#-###----#----#--#-#---------#--#--#---##----#--#-##---#---#--------###---------#-#-#-#-##-
-###-----#----##----#---#---#-##--####-#-####---##---------#--#---##-#----###----------#---#--##-#-#
----#-##----#-##-#-##----------#-----###----#-#-#----#--#-#--------#----##--##----#----##-##------#-
-#-#--------#--###--------##--##---#----#----#-#----#-------------#-##---------##----#-----##-##----
#-----#--##-#-#-#-#-#---#----#-#####-----#--#-##--#-------#------##-----####-#-#-#-##--###----------
--#---#-#---#-------#--##----#--#--#-------#------#----#-#--##--#--##--##-#-##-#-##-#-----------##--
#--#-#-#-----#--#-#----------###-##-###-#-#--#----#---#--#-------#--------------#-#--#-#-##--##-##--
#-#---#-##-#-#-##-#--#-###-#--#----#--##-----##-#--##-##---#--##-#-#-#-##---#-#----##-###----#--###-
----####-#-----#---###-----#----------#--#-----#--#-##---------#--#--#-#---##---##---##-##---------#
#-#--##-#-----#----#--#--#-------#--------#--#-----#----##--####------#-#---###-##--##---##-##-----#
---#####--#--#-----##-#-----#--------#-----#--##---------##-#-#-------#----#---#--#-##--#-----------
---#---#----#-#-----##---#-#--#-#----##---#--#---#----#-##--##----##---#--#-----------#--#--###---##
----#---#-#-------#--#--#--##-#-#----------##----##--#-#-#####--#----##--##---------#---#--##-----##
##--##--#--##-##------#-------#---##------#-#---###-----###--######-#----#-------#---#----#-#-----#-
--------#---#---#--------##--#--------#-#--#-#----#-------#--#----#---#------###--##--##-----#---#-#
---#----#-----#------#-#--##---#---##-#-----##--#-###--#----##---##-##-----#---#---------##--#-#--##
###--#----#-------#-#-#-#-##--#----#-#-#---#-#--##--#--#---##---#-#---##-#-#---#----#-#-#----#-#--#-
-------#--##--#-#-#--#-#--#-----#---------#---##--#-#---------#-------#------###--#-#---#-###-------
-#--------#-#-#--#---------#--#--###--#-##---#--#---#-#--####--#----##-##-#-##--#-##----#-#--##---##
-#-#------#------##---###--####--#---#----#---#--##------#---#--#------#---#-----#------#-#------#--
--#---##--#-#-#---##-##-#---#-####---#-----###-####-----#-----##-#--------##-------###-----#------#-
---##-#-##------------##---------#-##------#-#--#---#------------###----#-----#--#-----#-#------##-#
-#-----#---#----------#-#-----#----##--#---##--#-#-----------#-#-#-#-#----#----#---------#-###-##-#-
--##-#----#-###-------#-----#-------#------#------##-------#-------#----#--#---##----------------#--
-----##---##-#-#---#----##-#----#------#-#-###-#-----#-##-#-#--###-#-##---###-#-##----#----------#--
-#---#--#--##---###----#----#-#----#-----#--#-#-#--#---##---##--#--#-#-##-#-------#---#-------#-----
#--#--#-#----##---#-------##--#-#---#--#-##------#-#-#--#--#-#--#-##------#----##-----#----------#--
--#-#-#-#-#---#------##--#-###--##--#----####-------####---#---#---#------#-----#-#-------#----#---#
--#-------#--##---#-#--#--#---#--#---------#-#--##--#---#-#--#-##--###---#------#-##-#----#-#-------
-#-----#-#----##--#-#----###-----------#-----------#----#---##---#--###------#----##-----#----#---##
##--#----------##----##-##----------#-#-#---#----#--------##------#----#-#-----##--#-#--#---#-------
---------##-##-#--###---##--##-#--#--###-#---------#-----##---###-##--#-##----------#---#----#------
---#--##-#----#--#---##----#--##-#------##---##-------##-----#-##---#--#-#-#-------######------##-##
------##-#----#-----#-#---#---#--##-#-#------####---#-#---#----#----#--#--#-###--#----------#----###
#--------------##-----##--#----#-##-#--#--##------------#-#-##------###-#------#-#-#-----------#---#
#---#------#-#---##-##------##----#-####-----#-----#----#--##-#------#--------------#-----#---#--#-#
#--#-#--------------#----#--##------#---#----------#-###-#----##--####----#---------##-##-#--------#
---#--#--###--#-------#--#--#------#-#-###--#-##-----#---#--------#-#--#####---#-----#--#----#--#---
---#----------#-#---####---------#-#-#------#---#---##-----#-#-##-##---###----------#-#---#-##-----#
#-------####-###--##-##-----##-#--##-#----#------#-------#-#-#-------------#-----#####---#--#--#-#-#
##--###--###---#------#---####------##---#--#--#-#----#--###--------##-#----###-##-----#---###--#---
#-#------------#--#-#-----#--##---#---#---#-##-#-##--###-#-#--------#--#------#--#--#---#--#--####-#
-#----#####-#--#----------#--#----------#-##---##-##-----##-#-####---#-###-#--#--------#-------#-#-#
--#----##--#-#-#--#------#-#-----#---#---#-#--#--#-#-#-#-----#--#-##---#----#-#----#------#-#---#-#-
--------##--#-#--#-------#-#---#--##--###----#-##-#--#####--#------###-##----##--#-----#-----------#
--#---#-##-----------##--------#-###-##-----#--#-----#------#---#-###------#---##---###-###---##--##
#-----######---#-#---#--------##-####--##-----#--#---###------#----#-#-##-####---#--##-----#-#------
#-#-##-#--##----###----#-----------#----#---#--#--#####-----#--#-#-#-#----#-#--------#-#--#------#--
#-----#--#----#----#-##--##--#-------#-----###-#--#--#---#-----##-------###---#---#----------###--##
----------#---###--#----######--#-#------#--##-#--##-----------###------#-------------#----#--#-----
#-#---#---#-#--#---##-#----------###--#---##-----------------#---#---#---#---#-------##--#---#--##--
#-------#-----------##--#-#-#----#-##-##--###-----------#--##-#-#-----#--#----------###--#--#-#-----
#----##-#--------------#----#----------##--##-##-#----#--##--#-----##--#-----##--#----####---#-#-#--
----#---#--#--#------------##-#-##----#---#----#-#-#-#-#---#----#--#--#--------#----##-#-#-E#-######
--#----##-#-------#-#--#--#----#----#-#---#-##--#--------#--#-------#----#----#-#-#--#--#---#--#----
------------#---#------#--#-#-#----##----#-------###-##-#-#--##-----#---#--#--#-----#-##---#--###---
###----#--##-##------#--##---#-#----#--##---#--##-----#--------#-#-##----#--###------###---------##-