#--#-#---#--##-#-#-#-----###--##------#-##----------#--#--#-#--##-##-#-##----##--#----#--------#--#-
###--------#---#---#-----#--##-#------#-##---##--##------#-#-#----#-#-----#---#-#----##-#--#--------
#-----#-------###-##-----#------##-#-##----------------#####---###------#---##-#--##------#--#-#####
-#---------#--#--------------##-#--#----###-#--#--###--#-#--#-#------------#--##----#--#-----#----#-
-#----##----#---##--#------#---#-#--#---#--#-----#-#--##--###--#-#----#------#-##-----#####-####----
---##----#---#-#------##---#---#----#-#--#------#--#-----------#-#-------##------#-#-#---#---##-----
-----###-#--####--------#-#-##-------#-------#-#--##-###---#--##--##------#-----##-----------#--#--#
---##---##-##-#-##---##-#---#--#----##---#--------##----------------------###--#-#--#-------##------
#--#-###-------#----#-##-#--#---#--#--#-##---------#----#---##-------------##---###-#-#--#-##----###
---#-##---#-#-#-----#--####----#--###---#-#---#---------####--##---------#-----#---------#-------##-
--#--------#---##-#---#--#-##---#---#---------#-#------#-----#---####-#-##------###-----##---#--#--#
##--#-###---#---###-##-#-##-##-#----#---#----#--#-###----#--##---#-#-#-#------#--#----####-##-#-##--
-----#-#------#----#--#-##-#-------#-----------##--#-##---#-----#--#---##----#----#--##-#-##------#-
-#-------#--------##-#-###-#----###---##---#--#-#--###------#---##---##---------##-###-##---##------
-#----#--#-#-------#--------###--###--#----------------#----#-###---------------------#---####------
-##-------##----#----##----#-#-#----#---##---####-#-#-#----###--#-----#---#----#--##-#-------#----#-
---------#---#-#------------##---------#--#---#-----#-#--#-#---##---#------#-------###------#--#----
-#-#---------#--###--#--#--#---#-----#---##-----------#-----#------###---#-#----#--------------#--#-
#-##-----------#-#---------#------#---#----#----#---------#--#--#-----#--#-##----------#-##-#-#-----
-#---#-----#----#-###--#---###--#-#-#-##-#-#-##-##-#-#------------#----#---#----#--##---#----#--#-##
-----##--#--#-----##-#--#---#------###---###------##-----------#--##--#----#--#----------#---#-##---
#--#----#---#-##---#####----#-----#---#-#--#------##--#--####--#-#-----------#--###--#--###-#-#--##-
#------#---#--##-#---##-#------#--#--####-#-##-#--------##---##---#------##-#----#-----#---#-#-#----
---##----#--#------#-----###--#-------####-----#---------#---#-#---#-#--#----#---#---#-----#-----#--
-#-##-----#-###----#--#--##--#-#--#-###-----#------#-#--#------------##-#-----#-#--#------##-##---##
-#-#---#-#-----#-###--#####-#-----#-##------#----#-------##-#-----#-----#-#----##---##--#-----------
------#-###---##---#--#--------##----#-#---#----##---##---------##----#--------------------------#-#
----#-#-----####-#--------#---#-#-#---#-###----##---#------------#------#-#-#-----#-----#--#-------#
-#----#----#--#-----###-#-#--#-##-----##--##------#-##-#-#-##-----###---##--##--##----###-#--###---#
##-#-#-----------#--#-##-----#----##-----------#---#------#---##-####----###----###-----#-#-##-#--##
-#-#-##-##--###-#-#----#--###---#--#---##-#-#-#-------#---#--#-----#--#-#-#---#---#-------###-###-#-
-###----##--------##--------###-----------##--#-----#---#---------#-----##----#----###----##--------
-#-#-##--#--#-#####----#-##---#---#---#------#--##-#--#---#--##---#-####-#--------###--#-###-----###
##-----#-#---#------#--#----#----#-------#-#-#-##---#---##-#--#-----#---#----###--#-#-#--##-#----###
---#---##----#--###--#------#---#---#--#-#---##---##-#--###-##-#-#---------#---#-#----#----##----#--
##--#--#-#------------#-------#---#-#----------#----###----#---##--#-#--###--##-#-##---##-##-----##-
----#-----#---###-##-##--##---##-----#-#--#-###-#-##--#------#-#---#------#--#--#---##------#---#---
#-#----#---#-#-###-#--#####---#--#-#-----#----#--##--##--#--#-----------#-#--#--#-#-#---###-#-#--##-
-#---###--#-----##------##--#-----------#---#--#------#--##---#-----------#---------##------#------#
-#------------#--#-##-#--#-#---#---------##----#-#------#-#------#--#-----##--#-##--#--#-#----#-##--
-#---##-----#------###-#--###--##------###--#-##-#-----#--#----#--#-----#######-----#-#--##--------#
----#----#--#-------#--##-#--#--##---#--#-----##-##----------#--#---#-#-#-#-#--##---##-#-----#----##
---####-------------#-##---#------------------#--#-#------#------#-----#------##--###------##---#-##
-#---#------------#----#--#----#--#--------#----##----------##----#--#-------##------#--####--#-#--#
-#----##--#---#---------------#-#-------###---#-#--##--#---####-----#------#----#----------##------#
-#-##---##--------###---#--#----------#---#----#------#---#---------#--#-----------#-#----#-#-----##
-#-----------#----#--###--#--------#---#--#-##-#-------###---##-#--#---#--------#----#---#-##-------
----#-----------------#---#-#-#-##--#-#---#------------#-#----------#-#----##----#-#-#---#------#---
---#-#------###-------#---#------------------#--------#--#-------------#--#-##-----#-#######-----#--
##-#--#-#----#####------------#---#-----##-#--##-#--###-----#-#--##-#--####---#-#---##-----##-####--
-#--#-#--###----#---------##-----####-####-##------#--------#--#--#-----#--------#-##------#-#------
###---##-####----------#-------#-#-----#------##----###----------##--###----##----#---#--#-----#----
---------#-----#-#-##--#-#---#----#----##--#--#----#------#-#----##---#------##-####---------#----#-
---#-###--#-#--#------##----#------##-----###---#-#-----###-#--#-#-##-#-#-#-#--#-######-#-----##-##-
--#---##-###------#--#---#---#-#--##-#--------#--------##----#--#--#---------#-##--#---#-#----------
--#---#-##--###---#--###--#--###--#----#---#-#---##--------------#--#---#-----#-###--##-#-----##---#
-###----##----##-##-----##---##----####--###------#--####----#--#----#---#-#-------##----#---##---##
--##-#----#------#----#-----#--#-#--#-------#---#--#----##--##--##--##-#-----#-----#-#-###------#---
-----#--#--------#---#-#----#-----#-#--##-#---##------#---#--#--#---#-#--#-----#--------------------
------#-#-##-##------#--#--##---##---#--------------------#------#--#-##----#-#-##--------#---#--###
-##-------#--###---#-#-#---#---##----#-###---#-----#-#----#-#---##-------#---##----#-----#---#-#---#
---#----######-#----#--#----###----#-#----##-##-#-----------###-#--#----#------##--#---##-----##----
##-------##---------#-----#-----##--#--##--#-###-##-------#-##--#--##-#----#---#-####---------#----#
###---------#-#-#-----#------#-----#-##-#-#--------#--#--------#-#-###-#-##-------------#----#------
#--------#----####----------#------##--#----#---#-##-#---##-###----##---------------#----#--#--#----
---#--#-#-#-#----#---#-----####-----#-----#--#--------##-###------####---##------#####---##--#------
--#-#--#-----#-#-###-##-----#-#--#-----------#-------#---#-###----##----##---#---#-###----#-#--#----
#---------###--#-#---##---####---#-#---#----#----#--##---##------##----#--#-##----#--#-----##-##----
--##---#---#----##-------#----#---#-------#------#--#------#--#-------------#-------##--------------
---##----#--#-#-#-#---###--##-----##--#----###-##--###-#-#--------##-#-#--#-#-#------#---#---##-#---
#--###------#----#---#-#----#-##--##---#----#---#-#-##----#--#----#-#-----#------#---####----##-#---
--#--#-#--#--------#------#---#---#--#--#------#---#-#-#-----#-##--#-#----#----##---###----###-#----
--#-------#--------#--#-----##--###----------------####-------#--#---#-#----###---#-----#-#---#-----
---#-###--##-#-#-----##-------####-###---#-----##-#--###----###---#--#-#---#-#--#---------#-----#---
--##---------#--#---------#-###------###--#--##--#-#######-#----#-------#------#--###----#--##--####
---#-##-#-----#-#-------##-##-#--#---#-##------#---#--#--##-#--##---------##-#--##-#-------#-#-##---
#-#--#------#-#--##-#--#-##---#-#------#-----###----#----#--#--##---####----####--------###---#-##--
##-##-##--#--------#---####----##---##---#--#---#-----------#--------##-------#--###-------------#-#
----#-#--#--###----------#---------#----##-#--#----#-#-##---#--#-----##-##-----##-#--##----#--#-----
--###-##--#----####--#-##--##-#--#------#--#--###---#-------#-#----##-----##---#--#--#------#----##-
--###--##----#----#-##---#---------#--------##--------#-------##-------##-------#-#-#--#---------#-#
##------#-#-##-#--------######-#-##-##---#---#---#----#---#---S--##--#------###--##---#-----------#-
---#--#----#-----#--#----##--#-##---#-###-#-----#---###--#-------#--#----#--#-------##-#-##---##-###
#---#-#-------##-#--#-###--##------##--#-----#-------##--#---#-----##--#----##---#----#----###-----#
---#-###--#---#--#----##--#--##-#-------------#---###---#---#---#-----#-#-------#---#-#---#-##------
-----###-------#--#--#----#--#--#--#---#-####------###--#-----##------#---------#----------#-##-----
-##----##----#--#-----##----##------##-----------#-----##-----#----##-------#--#-#------#----#-#####
---#----#--#------#-----------#--#-----#------------###---#----#-#---##-#---##------#-#-#--###--#---
-#----##-#---#--###--------##-###----#-#-#--##---##--##---#-#--#--#-##--#-----#----#-#-##-##-#----#-
--#-#------#-#---------#---#--#----#-----#---#--#---##-------------##------###----#-##-#-###--#-##--
-------#--#------#---#-#-#-#----####--##----------####-------#--#--#-----#-#-##-#----#-#----###--E--
---##--#----#--#-##-#----#-----#---#------#--#---####--#--#---#---#-##--#----###---###----#------###
-#-#-#---#--------#------#-#-##-#--#---------#-##---#---#---###------------#---#-##-#---#-#-###--#--
--#--#---#--#--#-----#-#---------#--#---#-------#--#------##---##-------#-------#-#------###-#--#-#-
--##--##---##------##---#--##----#--#--##----#-------#--##--####-#------#--##--#----#--###-##---#---
--##-#--#--#-----------##-#-#---##-#----#----##---##------#-#-----#---##-------#--#--#-----------#-#
-#-##-----#--#----######--####-------##-#-------#------##-----#-----#----#-#-----#------##-------#--
--#-##-###-----#---##-#-#--#---#-----##-##-##---#-#------#-------#-#--------#-#--------------#---#-#
-##----##-----##-#-#--#--#--#--#-----###--#---------#----#--#-#-##--#-#-#------------#---##-#-#-----
---#--#-#---#---##---#---#--#-#---#-##------------#-##------#-##--#-#---#-#-----#-#--#--#-#-----###-