----------------------------------------------------------------------------------------------------
----------------------------------------------------------------------------------------------------
##-#-##-#-##-#-##-#-##-#-##-#-##-#-##-#-##-#-##-#-##-#-##-#-##-#-##-#-##-#-##-#-##-#-##-#-##-#-##-#-
#----#----#----#----#----#----#----#----#----#----#----#----#----#----#----#----#----#----#----#----
##--###--###--###--###--###--###--###--###--###--###--###--###--###--###--###--###--###--###--###--#
----------------------------------------------------------------------------------------------------
----------------------------------------------------------------------------------------------------
##-#-##-#-##-#-##-#-##-#-##-#-##-#-##-#-##-#-##-#-##-#-##-#-##-#-##-#-##-#-##-#-##-#-##-#-##-#-##-#-
#----#----#----#----#----#----#----#----#----#----#----#----#----#----#----#----#----#----#----#----
##--###--###--###--###--###--###--###--###--###--###--###--###--###--###--###--###--###--###--###--#
----------------------------------------------------------------------------------------------------
----------------------------------------------------------------------------------------------------
##-#-##-#-##-#-##-#-##-#-##-#-##-#-##-#-##-#-##-#-##-#-##-#-##-#-##-#-##-#-##-#-##-#-##-#-##-#-##-#-
#----#----#----#----#----#----#----#----#----#----#----#----#----#----#----#----#----#----#----#----
##--###--###--###--###--###--###--###--###--###--###--###--###--###--###--###--###--###--###--###--#
----------------------------------------------------------------------------------------------------
----------------------------------------------------------------------------------------------------
##-#-##-#-##-#-##-#-##-#-##-#-##-#-##-#-##-#-##-#-##-#-##-#-##-#-##-#-##-#-##-#-##-#-##-#-##-#-##-#-
#----#----#----#----#----#----#----#----#----#----#----#----#----#----#----#----#----#----#----#----
##--###--###--###--###--###--###--###--###--###--###--###--###--###--###--###--###--###--###--###--#
----------------------------------------------------------------------------------------------------
----------------------------------------------------------------------------------------------------
##-#-##-#-##-#-##-#-##-#-##-#-##-#-##-#-##-#-##-#-##-#-##-#-##-#-##-#-##-#-##-#-##-#-##-#-##-#-##-#-
#----#----#----#----#----#----#----#----#----#----#----#----#----#----#----#----#----#----#----#----
##--###--###--###--###--###--###--###--###--###--###--###--###--###--###--###--###--###--###--###--#
----------------------------------------------------------------------------------------------------
----------------------------------------------------------------------------------------------------
##-#-##-#-##-#-##-#-##-#-##-#-##-#-##-#-##-#-##-#-##-#-##-#-##-#-##-#-##-#-##-#-##-#-##-#-##-#-##-#-
#----#----#----#----#----#----#----#----#----#----#----#----#----#----#----#----#----#----#----#----
##--###--###--###--###--###--###--###--###--###--###--###--###--###--###--###--###--###--###--###--#
----------------------------------------------------------------------------------------------------
-----------------------------------------------------------------------E----------------------------
##-#-##-#-##-#-##-#-##-#-##-#-##-#-##-#-##-#-##-#-##-#-##-#-##-#-##-#-##-#-##-#-##-#-##-#-##-#-##-#-
#----#----#----#----#----#----#----#----#----#----#----#----#----#----#----#----#----#----#----#----
##--###--###--###--###--###--###--###--###--###--###--###--###--###--###--###--###--###--###--###--#
----------------------------------------------------------------------------------------------------
----------------------------------------------------------------------------------------------------
##-#-##-#-##-#-##-#-##-#-##-#-##-#-##-#-##-#-##-#-##-#-##-#-##-#-##-#-##-#-##-#-##-#-##-#-##-#-##-#-
#----#----#----#----#----#----#----#----#----#----#----#----#----#----#----#----#----#----#----#----
##--###--###--###--###--###--###--###--###--###--###--###--###--###--###--###--###--###--###--###--#
----------------------------------------------------------------------------------------------------
----------------------------------------------------------------------------------------------------
##-#-##-#-##-#-##-#-##-#-##-#-##-#-##-#-##-#-##-#-##-#-##-#-##-#-##-#-##-#-##-#-##-#-##-#-##-#-##-#-
#----#----#----#----#----#----#----#----#----#----#----#----#----#----#----#----#----#----#----#----
##--###--###--###--###--###--###--###--###--###--###--###--###--###--###--###--###--###--###--###--#
----------------------------------------------------------------------------------------------------
----------------------------------------------------------------------------------------------------
##-#-##-#-##-#-##-#-##-#-##-#-##-#-##-#-##-#-##-#-##-#-##-#-##-#-##-#-##-#-##-#-##-#-##-#-##-#-##-#-
#----#----#----#----#----#----#----#----#----#----#----#----#----#----#----#----#----#----#----#----
##--###--###--###--###--###--###--###--###--###--###--###--###--###--###--###--###--###--###--###--#
----------------------------------------------------------------------------------------------------
----------------------------------------------------------------------------------------------------
##-#-##-#-##-#-##-#-##-#-##-#-##-#-##-#-##-#-##-#-##-#-##-#-##-#-##-#-##-#-##-#-##-#-##-#-##-#-##-#-
#----#----#----#----#----#----#----#----#----#----#----#----#----#----#----#----#----#----#----#----
##--###--###--###--###--###--###--###--###--###--###--###--###--###--###--###--###--###--###--###--#
----------------------------------------------------------------------------------------------------
----------------------------------------------------------------------------------------------------
##-#-##-#-##-#-##-#-##-#-##-#-##-#-##-#-##-#-##-#-##-#-##-#-##-#-##-#-##-#-##-#-##-#-##-#-##-#-##-#-
#----#----#----#----#----#----#----#----#----#----#----#----#----#----#----#----#----#----#----#----
##--###--###--###--###--###--###--###--###--###--###--###--###--###--###--###--###--###--###--###--#
----------------------------------------------------------------------------------------------------
----------------------------------------------------------------------------------------------------
##-#-##-#-##-#-##-#-##-#-##-#-##-#-##-#-##-#-##-#-##-#-##-#-##-#-##-#-##-#-##-#-##-#-##-#-##-#-##-#-
#----#----#----#----#----#----#----#----#----#----#----#----#----#----#----#----#----#----#----#----
##--###--###--###--###--###--###--###--###--###--###--###--###--###--###--###--###--###--###--###--#
----------------------------------------------------------------------------------------------------
----------------------------------------------------------------------------------------------------
##-#-##-#-##-#-##-#-##-#-##-#-##-#-##-#-##-#-##-#-##-#-##-#-##-#-##-#-##-#-##-#-##-#-##-#-##-#-##-#-
#----#----#----#----#----#----#----#----#----#----#----#----#----#----#----#----#----#----#----#----
##--###--###--###--###--###--###--###--###--###--###--###--###--###--###--###--###--###--###--###--#
----------------------------------------------------------------------------------------------------
----------------------------------------------------------------------------------------------------
##-#-##-#-##-#-##-#-##-#-##-#-##-#-##-#-##-#-##-#-##-#-##-#-##-#-##-#-##-#-##-#-##-#-##-#-##-#-##-#-
#----#----#----#----#----#----#----#----#----#----#----#----#----#S---#----#----#----#----#----#----
##--###--###--###--###--###--###--###--###--###--###--###--###--###--###--###--###--###--###--###--#
----------------------------------------------------------------------------------------------------
----------------------------------------------------------------------------------------------------
##-#-##-#-##-#-##-#-##-#-##-#-##-#-##-#-##-#-##-#-##-#-##-#-##-#-##-#-##-#-##-#-##-#-##-#-##-#-##-#-
#----#----#----#----#----#----#----#----#----#----#----#----#----#----#----#----#----#----#----#----
##--###--###--###--###--###--###--###--###--###--###--###--###--###--###--###--###--###--###--###--#
----------------------------------------------------------------------------------------------------
----------------------------------------------------------------------------------------------------
##-#-##-#-##-#-##-#-##-#-##-#-##-#-##-#-##-#-##-#-##-#-##-#-##-#-##-#-##-#-##-#-##-#-##-#-##-#-##-#-
#----#----#----#----#----#----#----#----#----#----#----#----#----#----#----#----#----#----#----#----
##--###--###--###--###--###--###--###--###--###--###--###--###--###--###--###--###--###--###--###--#
----------------------------------------------------------------------------------------------------
----------------------------------------------------------------------------------------------------
##-#-##-#-##-#-##-#-##-#-##-#-##-#-##-#-##-#-##-#-##-#-##-#-##-#-##-#-##-#-##-#-##-#-##-#-##-#-##-#-
#----#----#----#----#----#----#----#----#----#----#----#----#----#----#----#----#----#----#----#----
##--###--###--###--###--###--###--###--###--###--###--###--###--###--###--###--###--###--###--###--#
----------------------------------------------------------------------------------------------------
----------------------------------------------------------------------------------------------------
##-#-##-#-##-#-##-#-##-#-##-#-##-#-##-#-##-#-##-#-##-#-##-#-##-#-##-#-##-#-##-#-##-#-##-#-##-#-##-#-
#----#----#----#----#----#----#----#----#----#----#----#----#----#----#----#----#----#----#----#----
##--###--###--###--###--###--###--###--###--###--###--###--###--###--###--###--###--###--###--###--#
----------------------------------------------------------------------------------------------------
----------------------------------------------------------------------------------------------------
##-#-##-#-##-#-##-#-##-#-##-#-##-#-##-#-##-#-##-#-##-#-##-#-##-#-##-#-##-#-##-#-##-#-##-#-##-#-##-#-
#----#----#----#----#----#----#----#----#----#----#----#----#----#----#----#----#----#----#----#----
##--###--###--###--###--###--###--###--###--###--###--###--###--###--###--###--###--###--###--###--#