#----##--#--#-#--#-#-#---#-----#--#---#------#--#-##--#--##-#---#--###-----#---------#-#---#--#-###-
##-#-####--#--#-#-#-#---##-------##--#---#------#-#####-#----##--#------#---##-##--#-#-#--#---#-----
#--#-#-#-----------#--#--#--#----------#--#-----#---#--------------#-#-#---##----###-#----#---##-#-#
---###-------#--#--#-------#---------####--------#---##----#--#----#-------#-----#---####--#--#-----
#-#-###--#-##-##-#------------#-#----#-###----#-#--##---#-#--#--#-------#------#####-#----#--#-#--#-
-----#--#-----###--###---------#--------##--#-#--#-#--#####-#----#---#--#--####-#----#-#-##--#-#----
-##-------#----#-#--#--#----#-##------#----##-##------------#--------#--#---##-###-----------##-#---
#-----#---#-#------------#-#-#-#--#------#-#--#####-----------#-----###--##---#----##-#-##-------#--
#--#--##---##--#------##-------#--#-#------###------###--#--#----#-#---##----#-----#------#---#---#-
---#--#---#----##-#---------#--#----#-------#------#------#---##----##---##------------##-##--#--##-
#--##--###--#---#---##-#-------#------#---#--#--------#-##---#-###------#--#-----##-----------#-----
##-##-----#--------------##---#---#--------#--###-#--###-##----#--------#-#---#--#--###-----------##
-------#--##-#-#----#--#--##------####-#--------------###----------#------###-##---#--#----#-----#--
##-#--##-------#----------#----#-#-#####----#-#-##---##---#----#--###--##--#--------#-#---#---#-#---
----------#----#-##-#--##-##--####-#--------#--#-###---------------###-#---#-#----------####---#----
-#-##--###------##-#-###----##-#-----#--#---#---#--#-#-##----------###-###---#-#---###-----#-##--###
-----#--#-----#-#---##--#---#-#-##-##--#----#--#-#--#----##-#---------##--#--#---#-#-##----#---##---
---#-#--##-##------#-------#-####----#--------#-----#------#------#-#--##-##-#--##---#----##-------#
-----#-----#---------#------#------------#-----#------------#-#---------#----#----##----#-------##--
---#------##---#-----#--##-------#-#-#--#-----##-#--------#--#-------##--#-----#-#-#----------#-----
####-##--#--------#---#----#--------#---#--##----#----#--##-----#----##-##---#--#---#--------##---#-
---#-----##--##-#--##-----##------#--##----####--#-#--#---###--##--------------#-----#-#-##---------
---#---#--#-------##--##----#-#-##-#----#-#-#--------------#-#-#-#----#--#--#----#----####-----#----
---#-----------##-------#----#--#-----#------------#---##----#-------#-##--##--###-##--#-#-#-##-#---
--#-----#-----------------#--#-#----#-#-#--#-#-#--###-#---------#---#-#---####-#--#--#-------###---#
#--------###----#--#------#-#-----#--#-###---------#-----##-##-#---#-----#--##-----#-#-###-----##---
----#---##---------#-----#---#-#----##---------#-#-----#--#-##-##--------#----#---#----###------#--#
#-------#-##-##-------#--#---#----#---###--#--#----#--#-------##-###--#-----##-#-----##-#--#-#------
----#-#--#----#--#---#------###-#-#---#------#-----#--##-#------#-------##--------#---#-#-----##--##
#-#----##---------#--###-#-##-#--#-###--#----#-##------#-##----#-------#----------#-#--##-##--##--#-
##------##---#-------#-#####---##--#-#----##-#-----#---#-##---##-#-#-#---#--------#--#---###--------
-##--##-#-##-#--##-#----#-#-----#-##--#-##--#---#-#--##---------------#---------------##----#------#
-------#--#------##-###----------#-####--###--##-##-------#------#------##----#--#--#-----#-#-#--#--
-----#-##-----###-##-----#-###-#-##-#----#----#---#-----#-##-----#-##--#-####--##-##------#-##----#-
#--###--#-#-------##----#--#####--------#------##--#----#-------------#------#-#----#-#---##--#---#-
#-----#-#------#-#---------##-#---#-#-----#-----#---#---###-#-##--#-#-#--#--#-#-#--#--#-#-#---#-#-##
---#-#--##---#-------#-----#-------#------#----------##--#-----#--#--#-#--------#-#---#---#--##-----
-----##---##-##----#----#--###--##--#----#-##--#--#-----#----###--#-#---##-------#---#----#----#-#-#
--##----#-###-##--#----#----#----##-#------#-----------##------#-#----#-#---###-----##----#--#-##-##
#-#-##-----#----#--------###-------#--#-###--#-#-#-#---------------###-#--###-#-#---#-----#---#----#
####------#----#----#--#----#-##---#--#-##----------#-#--------#-#-##-#######----##-----#----#--##-#
------#--#-#-#---#-#-#-#--###-----#-#--#-----##--#-#----#----#-#-##--#-#------##-#-----#-##--#--#---
---#--#-#------#--###-----#--#---#--###-#--#-----#--#--##----##--------##---#--------------#--##-#-#
-##----#----#-#--###-----------#-##-#--#-------##---###----#---##-------##----###-----##------------
--#---------#----####--------#--##---#--##--------#---#------------------###---##--#----##----#----#
-##--------##--#-----#--#--##-#--#-#--##-------##------##-#-------#------#-#-#--#------#---#-----#-#
------#------#-##---#--------###----##------------#-----###--###-------#-#-##---#-#----####--#-----#
--#--#----##-#-##-----###---#--###-#----------------------#-#---#---###----#--#-#-#---------#-------
---#-#--#-##-------###--###-#---#-----#-##----#---#----##----##------##-----##----#--#-#------#-----
-##-#----#-----###----#-##---##--#--#-----#-----#-#-#----####--#---------#---------#-#-----#-----#-#
------#--#------#----------#---#--------###-----##-#-##-##--#-------#--------##---##-##--#----#-----
#---#-#----#----#--##---#--#--#-###-#--#---#--#---#-##--#-#--##------#--#---#-##-#--#####-#-##-----#
#----#--##-###-#----#---##--##--##----#---#-------#--#----#--##---##---#----#---##-##-----##-#--#--#
-------------##--#-#-##----#-#-##-#---#---##---###-#-#------#-#-#-##-#----##----#-#--##----#--#-----
--###---#-#--#-#----##--###-----##-#--------#-#-#---#------#--#-#-----#--###-----#----#--###-#-#--#-
-#-------#--#-#-####-###------#---#-------###----------#----#--#----#--#--#-#-#-##----#----####--#--
----#---#----#------#-#-#------#--#--#---#--------#------#---#--#----##----##-----#--#---#---#--##--
-#---#--#-##-----#--###-----####----#-----###-#-##-#--##-----------###-------##---###------#--##-#-#
----------------#--#-----#-##---------#----------##---##----#-##--####--#--#----#-#----#------#---#-
##-------##----#--#-------------###---#--------#-#-----#---##-##---##----#----#---------#-----###--#
#----##--###-#-#---#-#-----#-##--#--#---#---#---##--###---#----#-----#----------#-##-----------#---#
#--#---#-------#-------#-##-#-#-#-#--###---#------#---##-#-----#---#---#------------#--##-#-###----#
-------#-----##---------#-####-#-#-#####-#------##---##---------##--##--#---S#------#-#------#-#-#--
---#-##-#----#--#--#--------#--------##---#------#---#-#---#--#---#--------#--#-------------#-------
#---#--#-##--------#--##-#---#-####------#-----------#----------#-#-#-#--#-#--#####-##-----###-##--#
--#-#-##-#-------#--#---##------##--##-----#--#-#--#--#-----#-------#-----#--------#--------#--##-#-
---#-#---#-##-----##---#-#------####--#-#--#------#--#------#----#----------#-#----####-##-#-#--#---
-#--------##--#-#--#---------###--##--------##---#----#-##---###--#---#------------#--#-#---##---#--
----#----#---#-#---#----#-------#--#-----##-##---------#-#-#-#-##-----------#-----##---#-###----##--
##---#-#----##----##-----##--#-------#------#--#------------------#--#--#-#-#---#---#---#---##------
--------##--#-#-----#-###------#----#-###-#-#---#-##-##---#-#-####-----#-------###---###--#####-#-#-
-#-#---#--###--#-----###-####--#---#-###----#-##--#-#-#-##--------#---#--#--#--#---##-##---#--------
------###-#--#--#-#--------#--#-#--##-#-##---#-####----#--------#---------#-##---###-#-#--#-##--#---
#---------##-##----#----#---#-#--------#-----#-------#-##-#-#--#-##----#---###-#-#-##--#-###-#------
#--#----###-----##--#--##--#--###----#--#---#----#---------##---#--#----#--#-##----###-##-#-----#-#-
#----#---#---------##---#-#--#-#-###----#---#---#--#----###--##-#-----#-#--##---##---#-#---#-------#
---#-#--#-##--#--#--#-------#-----###-----------#--#---#-----#----###-#------#----#---##-##----##-#-
-------#---##-#-----#----#----#-#----#--#------#---##----#--------#--#-----#--##-----##----##-#-----
--#----##----#----#-#-#--#--#--#--#-------#-------#---####--------#----##---#-#--##-#--#-##----#--#-
-#----#----#---#--------###-#--###--#-##----##-##--#---#---##---##---------#-#-#-###-----##-#--##-#-
-----#----##---#-#-#--#----------##-###---#---#--#---##--#-#-##--#-#-#-------##----#-##-##----#----#
------#--#-###-#-#----##-#--#--###-#--##-#-------#------------------#-#--##------#----#---##--#-----
----#------#-#----#-#--#----#-##-------###-##---##-#------##-#-##-------##-#-----#-------#-#-######-
---------------#-----#####-#--------------####--##--#-#--#--##-#-##--#---#--------##----#---#--#-###
---#--#-##---####--#--------#----##--------##-##--------##--#--------#--#---#-##------#----#----#-#-
---#----#---#-#------#--#-#------#----##---##--#---###----##-#--#---------#-------#-###------##-#---
##-#------##--#-#--#-------###-###----#--#--#----###-------###---#---------##----#--#----##---##--#-
------##------##-----------------#----#--------##----#------##-----------#-#---##-#-----#-#--##-#--#
#-----#-##---#-------#----------##----#-#---#-#------#----#-#-----#--#---#---#-###-####----#-#-###-#
#--#-####----#-----##-#-----#--#--###----#-#-------##------##----#-###-#---#--------#-#-#------#----
----#---#--#-------#---#--##--#-##--#--#-#-----#-##----#--#-----#-#-----#-##-#--#---#------#--------
--#-#--##-#----#---#--#---#-------#--------##-#----##-###----------#---#--#-----##--#------#--------
##----#---#-##--------#----#-###-#-##--#--##-----#---#-#----##--#-####-------##----#-##--##----#-###
---------#-#-##-##-#-##--#-------#-#----#------#----------##-----####---#--#--#---##---------##-----
-#---##-#---#------#--#-#----------##--##---#---#---#----E---#--#-#-#-#---#----##-#---#--#----#-----
---#--#------##-#-----------#-#--#--#--##-##-#-#------#-----#-##--#---#-------#--#---#-#-#-#--#-#---
##-#---##--##---##-#-----####---#-----##---#----#---------#--------##-#---#----#-##----#--####--##--
-#-#-###-#-#--###--#----------#--##-#--#-#----#--------#---#-#-###---#-----###---##-----#-##--##--#-
-#-----#-##---#---#---#----#----#-----#--#----#----#--#--#-#---#-##-#----##--------#--#----#----#-#-
--##---#---#---------##--####-#-#--#--#------#--###---#--#-##-----#---###-#----###-----#---#--#-#---