----#----#----#----#----#----#----#----#----#----#----#----#----#----#----#----#----#----#----#----#
----------------------------------------------------------------------------------------------------
#----#----#----#----#----#----#----#----#----#----#----#----#----#----#----#----#----#----#----#----
##--###--###--###--###--###--###--###--###--###--###--###--###--###--###--###--###--###--###--###--#
---#----#----#----#----#----#----#----#----#----#----#----#----#----#----#----#----#----#----#----#-
----#----#----#----#----#----#----#----#----#----#----#----#----#----#----#----#----#----#----#----#
----------------------------------------------------------------------------------------------------
#----#----#----#----#----#----#----#----#----#----#----#----#----#----#----#----#----#----#----#----
##--###--###--###--###--###--###--###--###--###--###--###--###--###--###--###--###--###--###--###--#
---#----#----#----#----#----#----#----#----#----#----#----#----#----#----#----#----#----#----#----#-
----#----#----#----#----#----#----#----#----#----#----#----#----#----#----#----#----#----#----#----#
----------------------------------------------------------------------------------------------------
#----#----#----#----#----#----#----#----#----#----#----#----#----#----#----#----#----#----#----#----
##--###--###--###--###--###--###--###--###--###--###--###--###--###--###--###--###--###--###--###--#
---#----#----#----#----#----#----#----#----#----#----#----#----#----#----#----#----#----#----#----#-
----#----#----#----#----#----#----#----#----#----#----#----#----#----#----#----#----#----#----#----#
----------------------------------------------------------------------------------------------------
#----#----#----#----#----#----#----#----#----#----#----#----#----#----#----#----#----#----#----#----
##--###--###--###--###--###--###--###--###--###--###--###--###--###--###--###--###--###--###--###--#
---#----#----#----#----#----#----#----#----#----#----#----#----#----#----#----#----#----#----#----#-
----#----#----#----#----#----#----#----#----#----#----#----#----#----#----#----#----#----#----#----#
----------------------------------------------------------------------------------------------------
#----#----#----#----#----#----#----#----#----#----#----#----#----#----#----#----#----#----#----#----
##--###--###--###--###--###--###--###--###--###--###--###--###--###--###--###--###--###--###--###--#
---#----#----#----#----#----#----#----#----#----#----#----#----#----#----#----#----#----#----#----#-
----#----#----#----#----#----#----#----#----#----#----#----#----#----#----#----#----#----#----#----#
----------------------------------------------------------------------------------------------------
#----#----#----#----#----#----#----#----#----#----#----#----#----#----#----#----#----#----#----#----
##--###--###--###--###--###--###--###--###--###--###--###--###--###--###--###--###--###--###--###--#
---#----#----#----#----#----#----#----#----#----#----#----#----#----#----#----#----#----#----#----#-
----#----#----#----#----#----#----#----#----#----#----#----#----#----#----#----#----#----#----#----#
----------------------------------------------------------------------------------------------------
#----#----#----#----#----#----#----#----#----#----#----#----#----#----#----#----#----#----#----#----
##--###--###--###--###--###--###--###--###--###--###--###--###--###--###--###--###--###--###--###--#
---#----#----#----#----#----#----#----#----#----#----#----#----#----#----#----#----#----#----#----#-
----#----#----#----#----#----#----#----#----#----#----#----#----#----#----#----#----#----#----#----#
----------------------------------------------------------------------------------------------------
#----#----#----#----#----#----#----#----#----#----#----#----#----#----#----#----#----#----#----#----
##--###--###--###--###--###--###--###--###--###--###--###--###--###--###--###--###--###--###--###--#
---#----#----#----#----#----#----#----#----#----#----#----#----#----#----#----#----#----#----#----#-
----#----#----#----#----#----#----#----#----#----#----#----#----#----#----#----#----#----#----#----#
----------------------------------------------------------------------------------------------------
#----#----#----#----#----#----#----#----#----#----#----#----#----#----#----#----#----#----#----#----
##--###--###--###--###--###--###--###--###--###--###--###--###--###--###--###--###--###--###--###--#
---#----#----#----#----#----#----#----#----#----#----#----#----#----#----#----#----#----#----#----#-
----#----#----#----#----#----#----#----#----#----#----#----#----#----#----#----#----#----#----#----#
----------------------------------------------------------------------------------------------------
#----#----#----#----#----#----#----#----#----#----#----#----#----#----#----#----#----#----#----#----
##--###--###--###--###--###--###--###--###--###--###--###--###--###--###--###--###--###--###--###--#
---#----#----#----#----#----#----#----#----#----#----#----#----#----#----#----#----#----#----#----#-
----#----#----#----#----#----#----#----#----#----#----#----#----#----#----#----#----#----#----#----#
----------------------------------------------------------------------------------------------------
#----#----#----#----#----#----#----#----#----#----#----#----#----#----#----#----#----#----#----#----
##--###--###--###--###--###--###--###--###--###--###--###--###--###--###--###--###--###--###--###--#
---#----#----#----#----#----#----#----#----#----#----#----#----#----#----#----#----#----#----#----#-
----#----#----#----#----#----#----#----#----#----#----#----#----#----#----#----#----#----#----#----#
----------------------------------------------------------------------------------------------------
#----#----#----#----#----#----#----#----#----#----#----#----#----#----#----#----#----#----#----#----
##--###--###--###--###--###--###--###--###--###--###--###--###--###--###--###--###--###--###--###--#
---#----#----#----#----#----#----#----#----#----#----#----#----#----#----#----#----#----#----#----#-
----#----#----#----#----#----#----#----#----#----#----#----#----#----#----#----#----#----#----#----#
----------------------------------------------------------------------------------------------------
#----#----#----#----#----#----#----#----#----#----#----#----#----#----#----#----#----#----#----#----
##--###--###--###--###--###--###--###--###--###--###--###--###--###--###--###--###--###--###--###--#
---#----#----#----#----#----#----#----#----#----#----#----#----#----#----#----#----#----#----#----#-
----#----#----#----#----#----#----#----#----#----#----#----#----#----#----#----#----#----#----#----#
----------------------------------------------------------------------------------------------------
#----#----#----#----#----#----#----#----#----#----#----#----#----#----#----#----#----#----#----#----
##--###--###--###--###--###--###--###--###--###--###--###--###--###--###--###--###--###--###--###--#
---#----#----#E---#----#----#----#----#----#----#----#----#----#----#----#----#----#----#----#----#-
----#----#----#----#----#----#----#----#----#----#----#----#----#----#----#----#----#----#----#----#
----------------------------------------------------------------------------------------------------
#----#----#----#----#----#----#----#----#----#----#----#----#----#----#----#----#----#----#----#---S
##--###--###--###--###--###--###--###--###--###--###--###--###--###--###--###--###--###--###--###--#
---#----#----#----#----#----#----#----#----#----#----#----#----#----#----#----#----#----#----#----#-
----#----#----#----#----#----#----#----#----#----#----#----#----#----#----#----#----#----#----#----#
----------------------------------------------------------------------------------------------------
#----#----#----#----#----#----#----#----#----#----#----#----#----#----#----#----#----#----#----#----
##--###--###--###--###--###--###--###--###--###--###--###--###--###--###--###--###--###--###--###--#
---#----#----#----#----#----#----#----#----#----#----#----#----#----#----#----#----#----#----#----#-
----#----#----#----#----#----#----#----#----#----#----#----#----#----#----#----#----#----#----#----#
----------------------------------------------------------------------------------------------------
#----#----#----#----#----#----#----#----#----#----#----#----#----#----#----#----#----#----#----#----
##--###--###--###--###--###--###--###--###--###--###--###--###--###--###--###--###--###--###--###--#
---#----#----#----#----#----#----#----#----#----#----#----#----#----#----#----#----#----#----#----#-
----#----#----#----#----#----#----#----#----#----#----#----#----#----#----#----#----#----#----#----#
----------------------------------------------------------------------------------------------------
#----#----#----#----#----#----#----#----#----#----#----#----#----#----#----#----#----#----#----#----
##--###--###--###--###--###--###--###--###--###--###--###--###--###--###--###--###--###--###--###--#
---#----#----#----#----#----#----#----#----#----#----#----#----#----#----#----#----#----#----#----#-
----#----#----#----#----#----#----#----#----#----#----#----#----#----#----#----#----#----#----#----#
----------------------------------------------------------------------------------------------------
#----#----#----#----#----#----#----#----#----#----#----#----#----#----#----#----#----#----#----#----
##--###--###--###--###--###--###--###--###--###--###--###--###--###--###--###--###--###--###--###--#
---#----#----#----#----#----#----#----#----#----#----#----#----#----#----#----#----#----#----#----#-
----#----#----#----#----#----#----#----#----#----#----#----#----#----#----#----#----#----#----#----#
----------------------------------------------------------------------------------------------------
#----#----#----#----#----#----#----#----#----#----#----#----#----#----#----#----#----#----#----#----
##--###--###--###--###--###--###--###--###--###--###--###--###--###--###--###--###--###--###--###--#
---#----#----#----#----#----#----#----#----#----#----#----#----#----#----#----#----#----#----#----#-