-#----##-------#--------#-#------##----------#--##-#----#-##-##------------#-#-#-#------###--------#
#--------#-------#-#----#--------##-##------#-------#------#-------#--##-###------#---#--#-#---####-
##----------##-------##----#---##-----##--#-----#--#------####-###-#-#-----#--#--#-#----#-#---#-----
--###-###-#-#-##-##--#----#-#----------##-#---#---#-#-----#-#-##-#-----#----#-##----#------------##-
--#--#-#-------#-#---#--#--#-##----#--#---#-##------##---#---#----#-#---#-#-##----#--##-#---#-#---#-
#--##-#-##----#-#-#-###--#----#------------#----#-##---#------#-####---#-#-----##-#---#---#-#-##---#
--##-#---##----##--##-#---#----#----------#--#-#----#------#----##--##----##------------#-#--###--#-
###-#-----#-----#--#-----###-#---#-##-#-----#----------#--#-#-----#-##-#--###------#-#-#-##-----##-#
##---#----#---##-#--#-##---#---#------#---#---------#--#------------##-#---#--#--#---#--##------##-#
#-#--##----#--#---#-#---#-##---#---#-#---#--#--#--#----#--#-#----------##-----#-----#---#---#-#-----
--#---#-#--#-##--#---###------#---#-----#-------#######---#----#---##------#---------#--##-----#-#--
-------------#---#---------#---------#---#------#-------#--------##--###-----###----#-----#---#-----
-#-#--#--#-#---###-#-#---#-#----#-##----#------#-#-#-#-##----#-##--#----#----#---#--##-##-##-----#--
---##-##-#-#---##------------------#-------#------#----###----#-------#----##--#-#------#-##-#--#---
##--#--###-###-----#---#---#-------##----#-#--#------###---#---#----#--###--#----------#-###----##--
#-#--#------#--------------##-----##-------#--#---##-----#-----------#--#------#--#---#-#--#-#-##---
#-#--------#--#--#------#---#--------##-----#--#---#---###---#-#--#--#---###----#------#------#--#-#
-#------##----#-----##---#-##------#-----##--#---##-----##-----##----#---#-------#-###----##-##-----
---#--#-#--####--##--##--#-#------###-##--#--#-------#---#-####--#--#---------------##---#---#--#--#
##---###---#-#--------#---#-----------##-----#-#-----#----#-#---#----#------#-##--------------#----#
-#----#-##-##---#-##-##----------#-#------------#---#-----##-------###-##---###----#####----------#-
-#------#-----#-----#------#---#--#--#-#-#-#--#--##---####--#--------#------##----##--#------#-#-##-
-------------##----#---#-##--#--#-#-#-----##---#-----#-#----#-----------#-#--##-#-#---------#-##----
#----###-##--##----#----------------#--#-#----------#----##-----#-##-##----#---#---#-##-#--------#--
#--##---#------#--#--##---------#----##---##------------###----###--------#-----#------------#----##
--#------#---#--##-#-#------------#-----#---------#---##-#--------#-----##--#---#--##-#--#-#------##
-#--------#---#--#-----#---#-###---#-#-#---#-#--###-#-----#---#----#-#####-#----#---#-----##--#####-
#----###-#-----###--#----#---#--#----#----###--#----#-#-#--#-#------#-----#------#--###---#------#--
-----------#-#----####----#--##----------##----#-#-###----###-##-#-##---#-#--##-#---#-###-----##--#-
##----#----------#--######-#-------#----#----#--#----#---##---##-##--#--##-#----#-#---##-#------#---
-#---#----#--#####-----#-#-----#-----#-#-#---#---------#---#--#-----#--#-#-----##-##--####---##----#
##--#-----##---#-#-##-#----#--#--##-----#-#---#-#-----#-#----------###-#--------#--#-------#--#---#-
-----###-#--##------------###-#---#-----#-###--#-#-------------##---#------------##--##---#--#--#---
-#-----##--------#-------#--#--#-#--#-#-##-##-#----#-#---------#--#----------------#-##-#--#--#--#--
----#-------------#--##--###-------#---#-#-##--##-#--------#-#-##--###--#--##--#-#---##-#---------##
--#----#---#--------#---#-#-#------------###--#--#----#-------###------#-#-##----------#-------#---#
-#--------#--####---#-#-----#----#--#-#-----#-------#-#--#-----#-#-----#-------#-##----##------#---#
#---##-#--#-#------------#---#-##----##---##------#------#-#------#--#-#--#######---#-----#-----#---
---#---#----#-------------#--####----#----#-------#---#----------#-###-------##-#-#-##--------##----
-----#--#-#------#-#-----#--#--##---#-------##-----#-#----#----#-##---##--#--###-#--#--##--#---#----
-----#----------###-#-----###--------#-#-----#-----##--#---#-----###--#---#-#----###-#-#-#-##--#-#-#
-###----#--###########---------#-##------#-#----##-##-----------#-------------#----###--##----##----
--#--###-------#-----#----#--#--##-#----#------##--#-----#----#-------#---#----##--#-----#-#----#---
#---##-#---------##-#---#-----#----#------#----##-#--#--####--#--##------#-##---#---------#---#-----
--##--#-#-#-----##--#----#-##---#-#--#-#---###-------##-##-----#-#--#----------###--##-##-###----#-#
-----##---#--##-###-----------#-##-##-#---#---#---##---#--###--#---#------#----#-#---###----#-#---#-
###-----#--#-#---###-#-##------#----#-#-#-#---#-------##--##-----##---------#----------#---#--##----
#--##---####-----#---#----#-----#--#-#-#-###---###--#--#-###--#-#---##-----#----#--##--#----##---#--
--##----------#-##---###----#---##----##------#-#-#--#--#-#-##---#--------####--#------#--------##--
----#----#---#------####-##---###--#-#-##-#------#---#--#-----##-#---##-----#-----#----#-#----#-#---
--##-#-##-#-#-##--##----#-----------#-#-----#---#----#-##-##-------#-#---#-#-#----#-#--#---##-#---##
---##----------------#-------##-####-##-###----###-#---#-####---#-----#-#-----#------#-#-###-----#--
------#-#---#-----#--------#----#------#-----#---##---#------##-----#-----#--------#---###------#---
#-------##------##-----#-#-----#-##--#----#---------#-##-#------#---#-#--#--#--##-##----#----###----
#----#-------#--#--#---#---#####----##-####---#---#---####-##--#---#--------#-#-##--#-----------#-#-
--#----#-----#---#---#--##-----------#-----##--#-----##--##--###--#-#----#--##---#--##-#-#-------#--
-----#-----#---#--###--#---###----#--#----#-####-----#-------####---##---###--#-#--------##-#-#-#---
---##----#--#---#--#--#----------#-#-#---###--#--#-----##--------#-##-####-----###---##-----#--#----
--#####--##-##-#----#-----#-----#---#---##---#-#-##---#-#--#-###---#-#-----#--#----#-#--#--##---##--
#--#-#----#-----###--#---#-##-----#--#-#-#-#---#-#--###----####---#---#---##----#------#-###---#----
-----#---###---##-##------#-#--#-----#-#--------#-------####-#--#--#---#---#--------##--#-#--#---#--
---#-----#--#-#-#--##-#-----##-#---------#--#------#--#--#-----#--##-----####--###--------#-#--#-#--
-#-----#---#-##--##-#--#-##-----#---#-#-------##---#--#--#----##-#----#-----#-----#-#----#--#---##--
-###-----------#---##-#---------#-###------#-#------#--#---##---#-#----#--#----#--##--#-----#----###
------#-#-##-------#---#----###--#-#-#---#-#--#----------#-###-##-----#----------#------#--#----#--#
#---#-###-##-------#-#-#-------##--#--##-----#-----##--##-##-#----#-##-S#-#-###------------#-#------
-------#------#----------#-----#-#-------#####-#--#--##-#--##----#-#-----#-#-------#-#----##-----#--
--#--#---#-----##----###--#-#-##-------##--#--#-#----------#-----#----#-#---#----#-----#---#--#--#--
--------##---##--##-#----###-#---##--#---#-------#---##------##----#--#---##----#----#-#--#-----####
#--##-##--#-##-#-#--##-#-#-#-#-#----#--#--#------##-------#-#----#-#--###--#--#-----#--#---#---#----
#-#---#-#-##---------#-#---#-#--##-----#--#-#-##-#------#--###--##-#----#-------#--#-#####--#--##---
#--##-#-##---------#--#-##-#-######-#--#--------#--#--#--#-#-----#-###--#-##-----#-----#-----##--##-
---#-#-----##-#-#----##---#-#-#--##----#-----#----#-------#----#-#-#----###----#-#--##---#---#-#----
#---------------##-#----#--#-#----##-------------#--###----##-#-##-#----#---------#---##---#-----#-#
#---###-------##--##------#--##----##----#-##-#--#-###---###-------##------##---#####-#-#---#--#---#
------###-#--###--##-------#--#-#----#--------------###--#--#--#--#---##-##-#--#-#---#-------#-#-###
----#--##--##-##-####------#--#----#---------#-#---#-##-----#-#------------------##--##-####--#-----
#-#--#-#-#------###-##-##--#-#----#-#######---#-#-##-#---#----------------###-##---#-#----#----##---
-----#---#----##-#-#-#--------#-####--#-#----------#---###--###---##-----#--#------#--#-#--###--#-##
--##-------##------#-----#-----#-#-#-----#-#---#-###--#------#####-##--#-------##-----###---#-------
--###--#----#--#----#----#-#-###---#--#--#-------###---#--#-#--#-----#---#-#--#--#--#---#--#--##----
---#--##------------#-----#-----#----##----#--#-#---#--#----------#####-----#----##----#-###---###--
-----######--#------#----##-#-------------#---#-#---#--#---#---#-----------###-#####-#------#---#---
#-##----#--#--##---#-#-#-----#--#-##--#--###---------#-#-#--#-#-----E####-------#------#-#----------
-----------#---#---###---#-#----#--#-#-##-#-#----##---#---##--#--#-#--------#-#-------#------#--#--#
-------##--#-----------##-##-----##-----#----##---#---#--#------------#--####-##-#-----##-----#-#---
---#---##-#-#-#-----#-##--##-#-##--#--#-#-#----##-#---#----------##-----##-#---#----#--##--##--#----
-#--##--##--#----#----#-#---##---------##---------#----#-#-#---------#--###--------###--#--#-##--#--
---#-----##--##-------#-#-######---##----#-#--------#---#-#---#-##------#--#-#-#--##----------#--##-
-#--#----#-#-#---#--#--##-#-#-#----#---###--#----##---##-##----#--------#---##-----#----##---##-----
------#----#-###--##-####-----##--#---###----#---#----#--##-#----##--------#---------##-------#--#--
-#-##----------#--#--#--------#--#-#--#--#-------#-##---#--#-#-##-#--##------#---#-#-------##---#---
--#--#------#-----##-##-##-###----------------#--#-----#--#-#-#####-#---#----##--##---#--------#----
---#---##--------##---#-#---###-###---------#-#-#--------#----#--------###---###-#---#----------#---
--###--#---#---#------#-------#---------#--#-######----#-----#-#-#-##--#-#-------#---#--------##----
------##--#-#-------##---#--##------#-#-#----#---#---#-----#-#-#-------##--###-##-#------#---#--#--#
#--#----#----------#---------#---#---#----##--------------#---#--##-###---#---#-#------#---------###
-----#---#-##--###-###-#-#-#--####---#-#----#------#--####-----#-#-----#-#-#--#--##------#-#---#----
--#----##-------#----#-#---#-##---#---##---------##-#-----#-##--#-#---#-#-------#--------#--#-#-----
##-----##-----##---##---#--#---#--##--#---#-#--#---#-----##-####-------#-------##-----------------#-