--#------#-#--#-----------#--##---#---------#-#--##----#--#-------##----#-#--#-##-#-#-######--------
-#-##-#---#---#--------##-#-#--#-#-#--#---##-####--#---#--##----#-#-#--------------#-##--#---###-#-#
#---#----#-#---#-#--##---##----#----##--#----#----#--#---#-#----#--#--#--##--#-####--#----#----##-#-
#---##----#-###-----#--#----#-#-----#----------#---------#---------#---#----#------##--#--##-----#--
#-#------------#---------##---#-------------###-##---#----#----#---#--##--#----------#--------#-###-
-#--#--##-#-------#---#--#----#--#-#---#-----#----#--#-##-----#--##--#--#----#---#-#-###------------
#----#--##-#-#---#-----------#-#-#----#-#----#-#----------###---##----##-#--------#---######-###-#--
---#-----###--#-##----##---##---#---------#--###-----------------#--#--#--###-#-#-#-------#-##-#--#-
-#-#------------------#-#----#---#---#---#----####-#--###--#--#-#-##-#---#--##--------#-#--#-#-###-#
---##-------#-##----##----#--#-#-#--#--#-----#--------####--#-#-----#-#-##---####-#-#------#--#-----
--#-#---#--#-#--#-#------#--##-----#-------#----#----#-#---##-----#--###------#-#-#----#----##-----#
#-###--#----###---#-#--#--#--#-#--##----------#------#--#---#-------#----##------#-#-##-#---------#-
---#-----#-------#-##-#-#----###--#-###-#--##-#--#-###-----------#---###----##--#------#---##--#-##-
--------#-#--#--###-#---#-##-#--#-#----#----#----##-#--##----------#--##--#-#---#-----#-#----#--#---
-#------------#-#-##----#--##-#---###--#-----#----------#----#-----#-------#-#--#-----#--#-##--#####
-------#----#-----#---------##-----#---#-#----###--#----#------#-------#-----#--#--#-#---#----##--#-
--##--#-##-##----#-#----##---#####-###------#--###-#------###----------##-#--#------#---#--#----##--
##---#-#-#--#-##--------#-#----#-#--#---#--------#---#-----####--#---#-#------#--#-----#--#-##----##
--##-#----#--#---#-#####--------#---#-----#----#-#-#--##--#-#------##-##-#-#--------#----#----#--#-#
----------#----#------##-------#---------#-#####-#-#--###-##-#------#-----#-------------#-#---------
##-#--------####----###--#--------#--#---#-#----#-##---#--#-----#----#--#---##-----##---#--#------#-
--#----##----------#---##-##------#-----##--#-----#--###---#---##-##-#--#----#-#--###-##-#----------
--##---#-##-#--####----##-#-----#---#--##-#-----------#----###--##---####---#-----#------#-#----#--#
-#--##-#-#-#-------##-##----#-#-----##----#-###-##--#-#-#---#---#-##-##-----#---#----------#--------
-#-----#-#------#-#-----#--####---##----##------#-----#-#-----#-#-##--------##------#-###-----------
-##--#-#-#-#----------##-------#-----#-------#--######-#-#------------##--#--#-#------#-#-#------#--
##-##-------#---##-####-#------------#-#----##--#--#--#-#---------#----##-#---#-----------##-#-----#
##------#-#----------#-------#-#--##-----#--#-#--#-#-##-#--##--#-----##-#-----#--#------#-##--------
-##---------#--##--#--------#-#-#----------###---------###--####--------###--#--#-----#-------#---#-
#-#-------#--###-#-----#--#-#---#----#-###-#--#-#####---#----#----#--------##---#-#----#---###----##
###---##-----#-#-----#--------##-#-#--------##-#---#--#--#--#-###--------#--##---#-------##---#-----
---##----##------##--#-----#------#--#------###--###-##----###--##-------#-#-#-----#---------##-#--#
---------#--#-#-###------#-##--#---##-#----#-#-------###--#---#--##-------#-------###-----------####
#-#----##-------#-#----##----#-#-##--#-##-------#---###-----#---#-##---##-----##---------##--#-##--#
--#---#--#-#----#-#--------#--#--#----------#----#-----#---#-###---##----#------#-#---#-------------
-----------##----#----------##---#-----###-##--##-#--#------#----####-----##---#--------#-#---#-----
-####--##---#-----#----#------#-#--#----#--#--##----##---#-#---#---##--###---##-#--------#---#------
--#-#-###---#----##---##---#----#--#----#-##-----##--##------###-##-#-#---#------#-#---#----#------#
#----#--###-#-----#----#-#-##-##---------#-------#--------#-----#-#-#-#---#------#---#-#--------#-#-
-#--#---#----#-###-#--------#----##--#---#----#---#------#--#-----###-##-----#--####--#---##--##---#
#-------#-------#-----#----#-#----#-#----------#---#-##-#-----###-----###-------#-----------#---#--#
--#---#------###--#-----#---#----##----#----##-#-------#---#-###---------#-----#-#-#--E----#------##
--#---#--##-------------#-------##-#---#--##-#--------#####----------##-#----##-----------#---#----#
-----##-#-##-#--#------#-#-##-----#-----#--##-#-###---#--#------##----####--##--###----#-##---#-#---
-#---------#-#-##-###--#----#---#---#--##--#-##---##-#---#--------#--##--#--#-#-#--#--------##----#-
#-##---#---###-----------##--#------#-----#-#----###--#-#-#--##---------#------#--------#-##-#--#--#
#---#--###--####--#------##---#-#-#-#--##--#--#--------#----##-#------#------------##-------##----#-
#---#-#--#-------#--##-###--#--#-##------#--####----#----#----##------------#--#---#-----#---#---#--
--####-#---##---##--------#-##------#----##---#-----##-----S------#-#---##-#-#-#------##-###-#-#--#-
#-#-#---#--#--#--#-###---#----###-#------#----#----#---------#-----####--#--#---------#-#---##-#----
#----------------##-##-----#-#--#--##----##---#--##-----#-------#---#---####-###-#----##-##-#-#-----
#---###--#----#---------#----#--##-#---###----##--#-#-##------#-#-#---###-----#-#------#-----------#
-#--------#--#-#-#-#--#--#--#--###-------#-#---#-----#-##---#-----#--###------##-#---#-----####---##
-#--------##-#---##-#---##--#-----#-##---##-----#---#--#---###-###-----#---#----#-------#-##---#-#--
###---------#-------#---###--##-##----##---##---#-------#---#-#----##--#---------##--#-#-------#----
-------#---#-------####--#-#---#--##----#-#-#---##-#------###------#-#---#-----#---#--#-------##-###
-------##---###-#----#-#--#-#-##--#---#---#-----#---------#-####-##-----#-#---#--#----##-#---##----#
-#-----------#---#-##-#-#-----#--------#-#--#--#-#-##------#---#-###-------#-------#----------#--#--
------#-#--#-----##--#-#####-#-#####---#---#--#---#####-----##--#----#-##--#-##----#-#-----------#--
------#----#---#-#--#-#---#---#-------#---##------#--------#----###---#-#-##-----#---#--#----#-#----
#-###------#-#-----#---##-#-#-#--------#-------##------###--#-------#-#---##---#####--------#-#----#
###-#----#-###--#-#------##----#--#----#-------#------#-##-----#----###-#-#-#---##-----#--#--#--##-#
-##-#----#-#----##---#---------#--#---#---##------##-------##-##-------#-#-----------#-#-#---#--##--
-#------#--#---#-#-----#----##-#-#------####---#-#------#-#--#--#--#-###-###--##-----#---#---#-#----
-------------#####--#-----##-#----#--#----#----#------###--####-------#-----##---##----#-----##-----
#---##--#---#-------#-##-###-###----##-----------###-#-#------------####-#--#----##--#-##--#--#-##--
----------------#----#---##----#--###-#-##---#--##-------------#--#----#-#---#------#--##---------#-
###--------###---#-##--------#---##--##-#---------###---------##------#-##-#--#------#----#-#------#
---#-------#-###--------#-##-#----#-#--#-------#-##----#----#------##-#-------##-###--###-###-------
----------#----###---#--##-###---##----#--#--#-----#--#-#-#---###-##------##---#--#-----##---###--##
#--#-#-----###---------##-----#-----##----------#------#-----#----#---------#-#--#----##---#--#-----
-----------#######---#-----------#-#--#-#-###-#-##-------#---##-##-#----#---##--#-####-#-#---##----#
-----#-----------##---#--#-----#-----#--#--------#-------##----#-----#--##--------#-#-#--#-#-------#
-###---#-#--##---#------#---##--#---------#--#----#---#----#-##----##-#-#--#------#--#---###-#-###-#
#----#----##-----#-#----#-----#--#----#--#-#---#-----#------#-------#####-##---#-##-##--#----#-#--#-
--#------###-------#------#--#-#-#-##-#--#--#-------#------#-----##-#-#---#-#---------#---#-----####
##----#---#---####----#--#----------------------##----#---#--##---#-##-#-#-#----##--#----#--##-#---#
#-----#---#--##--##-##------#--#-###-----------#---#--#--------#-------#------#---##----#-##-----##-
--#-#-#-#---###----##----#--#---##-#--#----#----#----------#---##-##----#-#-#---#----####-#--##-----
-##-#-#---#------##--#--##-----#####------##----##-----#--#-------------#----#--------#---#-----##--
-##---#------###-------#---#-------------#------#---------#-#---##-##-#-------##---###--##-#---#----
----#-##---#-#--#-#--##--#--------#----#---------##-##---##--##-#-#----#------#--##-###-#-#-----#-#-
#-------#-------##---#---#-----#---#-#---------#--#-####-----#-###-#---#--#----##--#-----##-#-###---
--------##----#---##----#-#-#-#####------#---#--##------#-#-#------#---#---#--##--#---------##------
--#----##-----#-------#--#-----#--##------####-#-#-#----##--#-#---#---#--##-----------#--##---##---#
#--##-#-#-##---#--#-#--##----#--#---##------------#-###-#-------##--##-----#-#---###---##-#--#---#--
---#--#-#-#-##---#------##--#-###----#--#--##------#-#--##-#-#---#--#-#------##---##---###-##------#
---#--#------#---#---#-#-##--------#--#--#-----###-------###---#----#-###--##------#---#-#-------###
#-#--##-###-#--#---##-----#-#--------#---#-#----#--#-------------##-#----#--#---#--#-----#--#-##----
--#-##--##----#-----#-#--#--#----###-#---#--#--#------#---------#--#-----------#-#---#---#---#-#--##
-##----##---##--#-##--#----------#-------###-----###---#------##-----#-##---#-#-##-----#--#---------
----#-----#---##-----#--#---------###-----#----#---###-#-#-#-#---##----#--------###-------#---#-#---
#---#----#-----##-###-##---##-##-#-#-------#------------#--#-##----#-#---#----#-#-###---#-----------
-#-##----#------#--#-#-#------#--------#-###----------------##-#--###--#--##-##-#-###---#-#----#----
#-------##-###-##--##---------#-#-----#---#-#--###--#-#-------#-#-#--#-#------##--------##----#---#-
---#####----#-#-#--#---##---#--#-##-#----#-----##--#----##--------#------#-----##-#--###--##-##-#-#-
-#-#-#---#------#----#---##-#---#####----##-#------##--#--###--#-#-----#---#-----##-------#----#-#-#
#--#-###---#-----##--#--###------#--------##---#-----#--#-----#--------#--#---#-###-####--#-#----#--
---#--#-###----------#-#---#---###----#-#-------#---#---##--#--###-----#----------#-#------#-#----##
----#------#-----#--#---#--------##--------#-#-##-#-#----#--#-----#--##-#-####-##---##-----#-------#