----------------------------------------------------------------------------------------------------
#-#--#-#--#-#--#-#--#-#--#-#--#-#--#-#--#-#--#-#--#-#--#-#--#-#--#-#--#-#--#-#--#-#--#-#--#-#--#-#--
#----#----#----#----#----#----#----#----#----#----#----#----#----#----#----#----#----#----#----#----
-#----#----#----#----#----#----#----#----#----#----#----#----#----#----#----#----#----#----#----#---
-#-#--#-#--#-#--#-#--#-#--#-#--#-#--#-#--#-#--#-#--#-#--#-#--#-#--#-#--#-#--#-#--#-#--#-#--#-#--#-#-
----------------------------------------------------------------------------------------------------
#-#--#-#--#-#--#-#--#-#--#-#--#-#--#-#--#-#--#-#--#-#--#-#--#-#--#-#--#-#--#-#--#-#--#-#--#-#--#-#--
#----#----#----#----#----#----#----#----#----#----#----#----#----#----#----#----#----#----#----#----
-#----#----#----#----#----#----#----#----#----#----#----#----#----#----#----#----#----#----#----#---
-#-#--#-#--#-#--#-#--#-#--#-#--#-#--#-#--#-#--#-#--#-#--#-#--#-#--#-#--#-#--#-#--#-#--#-#--#-#--#-#-
----------------------------------------------------------------------------------------------------
#-#--#-#--#-#--#-#--#-#--#-#--#-#--#-#--#-#--#-#--#-#--#-#--#-#--#-#--#-#--#-#--#-#--#-#--#-#--#-#--
#----#----#----#----#----#----#----#----#----#----#----#----#--S-#----#----#----#----#----#----#----
-#----#----#----#----#----#----#----#----#----#----#----#----#----#----#----#----#----#----#----#---
-#-#--#-#--#-#--#-#--#-#--#-#--#-#--#-#--#-#--#-#--#-#--#-#--#-#--#-#--#-#--#-#--#-#--#-#--#-#--#-#-
----------------------------------------------------------------------------------------------------
#-#--#-#--#-#--#-#--#-#--#-#--#-#--#-#--#-#--#-#--#-#--#-#--#-#--#-#--#-#--#-#--#-#--#-#--#-#--#-#--
#----#----#----#----#----#----#----#----#----#----#----#----#----#----#----#----#----#----#----#----
-#----#----#----#----#----#----#----#----#----#----#----#----#----#----#----#----#----#----#----#---
-#-#--#-#--#-#--#-#--#-#--#-#--#-#--#-#--#-#--#-#--#-#--#-#--#-#--#-#--#-#--#-#--#-#--#-#--#-#--#-#-
----------------------------------------------------------------------------------------------------
#-#--#-#--#-#--#-#--#-#--#-#--#-#--#-#--#-#--#-#--#-#--#-#--#-#--#-#--#-#--#-#--#-#--#-#--#-#--#-#--
#----#----#----#----#----#----#----#----#----#----#----#----#----#----#----#----#----#----#----#----
-#----#----#----#----#----#----#----#----#----#----#----#----#----#----#----#----#----#----#----#---
-#-#--#-#--#-#--#-#--#-#--#-#--#-#--#-#--#-#--#-#--#-#--#-#--#-#--#-#--#-#--#-#--#-#--#-#--#-#--#-#-
----------------------------------------------------------------------------------------------------
#-#--#-#--#-#--#-#--#-#--#-#--#-#--#-#--#-#--#-#--#-#--#-#--#-#--#-#--#-#--#-#--#-#--#-#--#-#--#-#--
#----#----#----#----#----#----#----#----#----#----#----#----#----#----#----#----#----#----#----#----
-#----#----#----#----#----#----#----#----#----#----#----#----#----#----#----#----#----#----#----#---
-#-#--#-#--#-#--#-#--#-#--#-#--#-#--#-#--#-#--#-#--#-#--#-#--#-#--#-#--#-#--#-#--#-#--#-#--#-#--#-#-
----------------------------------------------------------------------------------------------------
#-#--#-#--#-#--#-#--#-#--#-#--#-#--#-#--#-#--#-#--#-#--#-#--#-#--#-#--#-#--#-#--#-#--#-#--#-#--#-#--
#----#----#----#----#----#----#----#----#----#----#----#----#----#----#----#----#----#----#----#----
-#----#----#----#----#----#----#----#----#----#----#----#----#----#----#----#----#----#----#----#---
-#-#--#-#--#-#--#-#--#-#--#-#--#-#--#-#--#-#--#-#--#-#--#-#--#-#--#-#--#-#--#-#--#-#--#-#--#-#--#-#-
E---------------------------------------------------------------------------------------------------
#-#--#-#--#-#--#-#--#-#--#-#--#-#--#-#--#-#--#-#--#-#--#-#--#-#--#-#--#-#--#-#--#-#--#-#--#-#--#-#--
#----#----#----#----#----#----#----#----#----#----#----#----#----#----#----#----#----#----#----#----
-#----#----#----#----#----#----#----#----#----#----#----#----#----#----#----#----#----#----#----#---
-#-#--#-#--#-#--#-#--#-#--#-#--#-#--#-#--#-#--#-#--#-#--#-#--#-#--#-#--#-#--#-#--#-#--#-#--#-#--#-#-
----------------------------------------------------------------------------------------------------
#-#--#-#--#-#--#-#--#-#--#-#--#-#--#-#--#-#--#-#--#-#--#-#--#-#--#-#--#-#--#-#--#-#--#-#--#-#--#-#--
#----#----#----#----#----#----#----#----#----#----#----#----#----#----#----#----#----#----#----#----
-#----#----#----#----#----#----#----#----#----#----#----#----#----#----#----#----#----#----#----#---
-#-#--#-#--#-#--#-#--#-#--#-#--#-#--#-#--#-#--#-#--#-#--#-#--#-#--#-#--#-#--#-#--#-#--#-#--#-#--#-#-
----------------------------------------------------------------------------------------------------
#-#--#-#--#-#--#-#--#-#--#-#--#-#--#-#--#-#--#-#--#-#--#-#--#-#--#-#--#-#--#-#--#-#--#-#--#-#--#-#--
#----#----#----#----#----#----#----#----#----#----#----#----#----#----#----#----#----#----#----#----
-#----#----#----#----#----#----#----#----#----#----#----#----#----#----#----#----#----#----#----#---
-#-#--#-#--#-#--#-#--#-#--#-#--#-#--#-#--#-#--#-#--#-#--#-#--#-#--#-#--#-#--#-#--#-#--#-#--#-#--#-#-
----------------------------------------------------------------------------------------------------
#-#--#-#--#-#--#-#--#-#--#-#--#-#--#-#--#-#--#-#--#-#--#-#--#-#--#-#--#-#--#-#--#-#--#-#--#-#--#-#--
#----#----#----#----#----#----#----#----#----#----#----#----#----#----#----#----#----#----#----#----
-#----#----#----#----#----#----#----#----#----#----#----#----#----#----#----#----#----#----#----#---
-#-#--#-#--#-#--#-#--#-#--#-#--#-#--#-#--#-#--#-#--#-#--#-#--#-#--#-#--#-#--#-#--#-#--#-#--#-#--#-#-
----------------------------------------------------------------------------------------------------
#-#--#-#--#-#--#-#--#-#--#-#--#-#--#-#--#-#--#-#--#-#--#-#--#-#--#-#--#-#--#-#--#-#--#-#--#-#--#-#--
#----#----#----#----#----#----#----#----#----#----#----#----#----#----#----#----#----#----#----#----
-#----#----#----#----#----#----#----#----#----#----#----#----#----#----#----#----#----#----#----#---
-#-#--#-#--#-#--#-#--#-#--#-#--#-#--#-#--#-#--#-#--#-#--#-#--#-#--#-#--#-#--#-#--#-#--#-#--#-#--#-#-
----------------------------------------------------------------------------------------------------
#-#--#-#--#-#--#-#--#-#--#-#--#-#--#-#--#-#--#-#--#-#--#-#--#-#--#-#--#-#--#-#--#-#--#-#--#-#--#-#--
#----#----#----#----#----#----#----#----#----#----#----#----#----#----#----#----#----#----#----#----
-#----#----#----#----#----#----#----#----#----#----#----#----#----#----#----#----#----#----#----#---
-#-#--#-#--#-#--#-#--#-#--#-#--#-#--#-#--#-#--#-#--#-#--#-#--#-#--#-#--#-#--#-#--#-#--#-#--#-#--#-#-
----------------------------------------------------------------------------------------------------
#-#--#-#--#-#--#-#--#-#--#-#--#-#--#-#--#-#--#-#--#-#--#-#--#-#--#-#--#-#--#-#--#-#--#-#--#-#--#-#--
#----#----#----#----#----#----#----#----#----#----#----#----#----#----#----#----#----#----#----#----
-#----#----#----#----#----#----#----#----#----#----#----#----#----#----#----#----#----#----#----#---
-#-#--#-#--#-#--#-#--#-#--#-#--#-#--#-#--#-#--#-#--#-#--#-#--#-#--#-#--#-#--#-#--#-#--#-#--#-#--#-#-
----------------------------------------------------------------------------------------------------
#-#--#-#--#-#--#-#--#-#--#-#--#-#--#-#--#-#--#-#--#-#--#-#--#-#--#-#--#-#--#-#--#-#--#-#--#-#--#-#--
#----#----#----#----#----#----#----#----#----#----#----#----#----#----#----#----#----#----#----#----
-#----#----#----#----#----#----#----#----#----#----#----#----#----#----#----#----#----#----#----#---
-#-#--#-#--#-#--#-#--#-#--#-#--#-#--#-#--#-#--#-#--#-#--#-#--#-#--#-#--#-#--#-#--#-#--#-#--#-#--#-#-
----------------------------------------------------------------------------------------------------
#-#--#-#--#-#--#-#--#-#--#-#--#-#--#-#--#-#--#-#--#-#--#-#--#-#--#-#--#-#--#-#--#-#--#-#--#-#--#-#--
#----#----#----#----#----#----#----#----#----#----#----#----#----#----#----#----#----#----#----#----
-#----#----#----#----#----#----#----#----#----#----#----#----#----#----#----#----#----#----#----#---
-#-#--#-#--#-#--#-#--#-#--#-#--#-#--#-#--#-#--#-#--#-#--#-#--#-#--#-#--#-#--#-#--#-#--#-#--#-#--#-#-
----------------------------------------------------------------------------------------------------
#-#--#-#--#-#--#-#--#-#--#-#--#-#--#-#--#-#--#-#--#-#--#-#--#-#--#-#--#-#--#-#--#-#--#-#--#-#--#-#--
#----#----#----#----#----#----#----#----#----#----#----#----#----#----#----#----#----#----#----#----
-#----#----#----#----#----#----#----#----#----#----#----#----#----#----#----#----#----#----#----#---
-#-#--#-#--#-#--#-#--#-#--#-#--#-#--#-#--#-#--#-#--#-#--#-#--#-#--#-#--#-#--#-#--#-#--#-#--#-#--#-#-
----------------------------------------------------------------------------------------------------
#-#--#-#--#-#--#-#--#-#--#-#--#-#--#-#--#-#--#-#--#-#--#-#--#-#--#-#--#-#--#-#--#-#--#-#--#-#--#-#--
#----#----#----#----#----#----#----#----#----#----#----#----#----#----#----#----#----#----#----#----
-#----#----#----#----#----#----#----#----#----#----#----#----#----#----#----#----#----#----#----#---
-#-#--#-#--#-#--#-#--#-#--#-#--#-#--#-#--#-#--#-#--#-#--#-#--#-#--#-#--#-#--#-#--#-#--#-#--#-#--#-#-
----------------------------------------------------------------------------------------------------
#-#--#-#--#-#--#-#--#-#--#-#--#-#--#-#--#-#--#-#--#-#--#-#--#-#--#-#--#-#--#-#--#-#--#-#--#-#--#-#--
#----#----#----#----#----#----#----#----#----#----#----#----#----#----#----#----#----#----#----#----
-#----#----#----#----#----#----#----#----#----#----#----#----#----#----#----#----#----#----#----#---
-#-#--#-#--#-#--#-#--#-#--#-#--#-#--#-#--#-#--#-#--#-#--#-#--#-#--#-#--#-#--#-#--#-#--#-#--#-#--#-#-
----------------------------------------------------------------------------------------------------
#-#--#-#--#-#--#-#--#-#--#-#--#-#--#-#--#-#--#-#--#-#--#-#--#-#--#-#--#-#--#-#--#-#--#-#--#-#--#-#--
#----#----#----#----#----#----#----#----#----#----#----#----#----#----#----#----#----#----#----#----
-#----#----#----#----#----#----#----#----#----#----#----#----#----#----#----#----#----#----#----#---
-#-#--#-#--#-#--#-#--#-#--#-#--#-#--#-#--#-#--#-#--#-#--#-#--#-#--#-#--#-#--#-#--#-#--#-#--#-#--#-#-