------------------------------
#---##---##---##---##---##---#
##---##---##---##---##---##---
--#----#----#----#----#----#--
-#----#----#----#----#----#---
------------------------------
#---##---##---##---##---##---#
##---##E--##---##---##---##---
--#----#----#----#----#----#--
-#----#----#----#----#----#---
------------------------------
#---##---##---##---##---##---#
##---##---##---##---##---##---
--#----#----#----#----#----#--
-#----#----#----#----#----#---
---------S--------------------
#---##---##---##---##---##---#
##---##---##---##---##---##---
--#----#----#----#----#----#--
-#----#----#----#----#----#---
------------------------------
#---##---##---##---##---##---#
##---##---##---##---##---##---
--#----#----#----#----#----#--
-#----#----#----#----#----#---
------------------------------
#---##---##---##---##---##---#
##---##---##---##---##---##---
--#----#----#----#----#----#--
-#----#----#----#----#----#---