#-#--#-#----#-#-###-#--#---#--###-#-#-----##--------#---##----###--#-##-#--#-------###-#-------##---
----##---#--####---#-------##--##--#--#-###-----------#-------#-----#--###-----#--##--#-----#--##---
##---#-#-#--##-------#-#-##---#--#----------#-#-----#--#------#-###-#----#----##-----#------#-#-#---
#-#--#-------#-#--##---------------#---#---##---#-##-------##---#-#-#--#----#--#--#--##-----#---#--#
#-#-#---#----#--#----#---###------#-#--#--#---##-##-#---#-#-##-#--##----#--#---#--##--#--#-------###
-###------#--#--##-----###--##--#----##--#--####---#-##--##-----##-#-##-#---#-##-----#------------#-
---#-#-----##--#-#-#-----#--#####-#---#--#-#-#-#--#----#-----#-----------#-#--------#---##---------#
--#------#-#--##-#--###-##--#---##---####----#-#---#---------#--------#-#------#----#--#-#---------#
-#-##-#-------#-##-##-#--######---#--#-#-#-#--#------###-#-----##---------#-#-#-----#----------##--#
#---#-#--#-#--#--#-#------#---#------#--#-##------#----##------#--------##--#-----###------#------##
-------------#-#-#--#-#-----#---###----#-------##------#-#--------------#---######--#-#-#--##-#-----
##---------#-#------#--#--------##-###--#----#-------###----#--#---#--#-----###-##---##----#---#--#-
--#-#---#------#--###----------#-#------#--#----#--##-------#--#--#----#--------#----#---#---#--####
--##------##----#-#-#---#--#-#---#--#----#------#---##-#--##-#-------####------#-------#--##--#--###
----#---#--#--#-#-###--#--#----------#-#--#-----##-#--##-###---#---#------#--#----##-#---#-#----#---
---##-#------------#---#-##----#-----###-----#----#-#------#----------#-----#--#-#---#-----#---###-#
-------#-------#-#----#---##-##----####-###-####--#---##-------#-#---#-#----#-------#---#--#-#-----#
#--------#---------##---------#--#---##----------#-#-----#--##---#-#---#---#-##------#---#--#--#----
---#--#----------##---#-#-----#-##----#--###--#-#--##-##-----##-------##---------------------#-#----
##----###----#------##--#-----##-##---#---##----#####-----##-###----#------------#-----#--#---#-#---
--##-#-------#--#-#---#----##--------###--------------##--------#-#-#--#-----#--------#--#-----#----
---#-----#----####----#--------#---#-----##--#-###-#-#-----------#----#-----#--###--#----#--#-#-##--
----##-##--#---------#--#-#-#--#-----#----------#-#-#-#-#---#--#-#----#------#------#--------------#
-#----###------#--#----#--#--##-#--###-###----##-#---#--##-----#-#--#------------###-#-#-#--##-#----
----#--#-#---------#----#---#--####--##-#---#-###------#--#-#--#--#-----#---#-----#-#----------##-#-
---#---#-#----##--#--##---##--###----#--#-#-#-------#---###------#-#--------#-#------#---#-#-------#
###----#---#-#-#-#-#----##-##-------#---#--------##--#--#-###---#---##--#-#--#-#-##----#--------#---
##-----------###------#-#-----#----###------------#------##----#--#-----#-#--#---#---#----#------#-#
----#--#---#----#-#---##--#-#--#-#--------#-------#--------------------#----#--##------#---------#--
-##----#-#--#-------###-#-#-#-------#----#-----------#-#-----###-----####-##--------##-----#----#--#
--#---###-----##-------##----##---##-#-----#----------#-------#-#--##-#--#-###--#--#---##-----#-####
-##--#-#-#--#--#----#-#-#---#----#--#------##-------#---#---#---##-#----#--#-##--#-#--------##--#---
###--#-#-##-#-#-#-----#---##------#--##-##--###--------#----#-###-------###-----#-----------##------
-#-##----#--#--#-#-----#---#------##-#-##--#---#-----#-####-----##--#---##-##--#-##-#-#--#-------#--
--##-----#------------#-##-#-###---##--##-#-##--#-#--##--#--##---#---###---##-----#-#--#--#---#--##-
------#-###-----##--##--#--#--##-----##-#--#--###---#-------####--#-##--##-#--#-#-#--------#--##--#-
--###---#---#------#-----#--#--#-------------#-#----#----##-----#----------##------##-##-##-----#--#
##------------------#---###-----------#--##--------#---#---##-###---#---#--##--#-------------------#
-------##-----##-------##--#---##-------------#--#------------##-##--#---#---###----#----#--#---#-##
#-----#-------#-##----##----#-#----#------##----#-#-------#------#---#-###---#--##---#-------##-#--#
#----#-##---#-#--#----#------##-----#---#-####------------------#------#-##-----#-#----#-#--##--#-#-
-----###--#-----#----#----####--#--#--#######-----#-----#-##--#---#----#----#-#-----#---#-###---##--
---#--###-#--------#---#-----#-#-#---#--#-----##-##-----#----#-#-##---#-------###-#-#--#-#---#-#-#--
#-###-#--#--#-#---##-----#--#--#-##-#-##--#----------#-#----#-#------##---#--#-##-#---###---###-#---
#----#-##----##---#####-#--###-----##--------#-----#--#---#-#---###--#-##----#--#---##-------##-#---
--#--#-##--#-##----#-#------#-#-#-#-#--#-------------##---#---------#-----#-##---###--##----------##
---####-#---#-##------#--#####--#--#---#----#----##----##--#----##------#---#----#-----#--#---#-----
-----##-#---####--###----#-#-#-----#-----#-##----###--#----#-----#-------####-#------##---------#--#
##-##-#-#----###----------#--#-----#---#-----------#--#----#--#-----#-###----#E----#-#-##-#-##------
-##-#######-#--#-#---#--#--#-#-##-#-#-#-#---------------#----##-#-----#----#---#--#-----------###---
-###---#--#------#---#-#--##--------##---#------##-##------##-#---#-#--##---#-##-###-----#---##-#-#-
----------#--#----#-#-#-#-#-#-###-----#---###-##----##--------##-#------#-#-------##-----#----------
--#---#-########--#----#---####----###--------------#-----##------#---#--#---##-------------##--#---
#-##--#-----#---#-----#--#--##----##------#-#-----#-####------#-#--#-----#---#--##---------#-#----##
-#-------#-###--#----###--#-#--##----##--#-#-#----#-##-###---##---#------#--#---------#---#----#--#-
##--##----#-##----#----###--#-#-#-#-#-#-##-##--------------#-###-----###-------#---#-##-------##--##
##-##---#------------#-#--#-#-----#-##--#-##----##-----------------#--##---##-----####-###-#-----#--
#-#-####-##------#-#---#-------#---#----------#--#-#-------#------#--##--#-----#--#-#-#--#-##-##----
---#-#----#-#--#----##---##-----##-#-#-##------------####--###-###--#--#-#--#-#-#-##---#----###--#-#
--#-----###------##--#----#-#-#--#--#--#----###--##-#----##---##-#----#----#--#--#-----#----#-----#-
#-#--#-----#---------#----##-#-----#---##--###---#---##-#--#--##--#--###---#-------#-#----#####-#---
#--#----###--####---#-----------------#-#--------###--#-------#---#-------##--#-----#-#-#-----##---#
-##----------#----#-#--#-----##-#-#--#--#---#---####--#-##-#-----#----###---------#-----#--------#--
-----------------###-#-##-#--#---#----###--------#--#-#---##-#---#---#--#--------##--##-#---#---###-
##--##-#--------#---------###-#--###---#--#---#---#----#---##--#---#--###-----#----------#####-#----
##--#-#-#-#------##---#----##S-#--###-----##------------#--##----------#-#----#--#-#---###----##--#-
--------#------#-------#-#---#---#-#-#-####----#--#---##----#-------###-----#-##--#----#--#-#-#-#---
--#-#--#-##-#--#-#----#----#-#-###--#-#-##-#--#-------#----#--###---#---##--------###-#-------#--##-
----#----#--#------#-------------#-##---#---##------#--#--------###-#----#--##-#-##----#--#---------
##-##---#--##-##---##-##-#-##-##--#---------------##---#--#---#-##---#---##---###-##---#---------#-#
-#-#----#-#--------###--#--------#--##----#---#---#--##-#-#--##-------#-----#--#---#--###----#--###-
---#-----#---#-###-##-##--#---#####------##-#--#-#-----##--###-###----#---####---##-#---#-------###-
##----------#----##--###-----#####---#-----------------#-#---#----#-###-------#-----#---#-----#--#-#
---##------###---#--------#-#-----####---##----#-#-#-#---#---#-#-#-#--#-#-----------#--#--#--#--#---
##--#-------#---#-----#--#---#-----#--#-#-------##-##-##---#-#----#--#-##--------##--#-###----#-----
#--------#-----##---###------------#--##-#----##-#----##-#--------------##-#-#----#--------#-#-#----
--------------##-###---#--#--#-----#--#----#--###------------#----#---------#--##----#-#---#----#---
-#-------#-------#----#-##---#-##------##-------#--#-#--##-----------#--###--##------##----#-#----#-
----##-##-#----#---##------##---##----#----#--#-----#-#-----#-###--------##----#--##-----##----##---
-#-#------#---#-#-----#---#-##-###-##------#-----#-------#-#------#------##-------###-#-#-----#--##-
----#-----------##--#---------#-#------#-#-----#-#-------#---#------#------###-----#-----#--#-#-----
---------------##--#-----#--###---#-#---##-#-##--#----##-##----###-##--#--------##---------##-#-----
---#-------##----#-#-------#--##--##-#####-----#-#-----#--------#-------##-#-#---#-#-------##----#--
-#--#-###---#-#-#-#-#------##-#-#-#-#-#----#---#--#-#----#--------##--##-#-----#-----------#--------
#---#-----#--#-#------###-----#-###---#---------#--##-##-#----#-#----#--#-----#--#-#----------------
-##-#--#---#----#-#-#-----#-#----#----#------######--#----#--#-----#-#------#--##---#-#---#---------
----#---#---------------#--#-----##-##---###--------#---#-#-#-#----------#------#-----##--#----###--
--#---#-#-#----##-##-###----###-#------#----#---###--#--##-#-#-#----##-#-###-##-###----#-------#----
-###----##-##----#-#-###----#-#----#--#---#--##----#---#----#--#---#---------#------#-#------#-----#
#----##-###----##-###-#-----#-#---#----------#---####-#--#---------##-#---###---#---------#-#------#
-#--#-#-----#-----#------#----##--------#----###-###----#-------#---------#-#---------------#-----#-
-##-##------#-#-#-###-##--#-----#-#####--#---#----#-----#--##----#----#-------##--#--------#--##----
##--------#------#---##------#---##-##----##----#--#---###-----#--#---####----##----#-#-----#----#--
----#-#---#-#-----#---##--###-----------------#--###--#-#-###--#-------#-#-----##-#---##---##--##---
#----##-#--##-##-###---##--#-#-----#----#-#-----###---####----###---------#-#--------#-------#-----#
------##-#---------#--#--#-#-##-#------##--#--#--#----##--#----#--#-#---#----------#-#-#-##------##-
-#---#-#---#--#-####-#-#-----#-##-##---#-----------#####-------#--#-###--##--------##--------#-#----
#---###---#-------###--#-##-#---#-#-----------#--##-#-#-#----#-------#---#----#--##--##----#--####--
#-------#--#---------#-------#-##--#----#--##---#-##---------------##----##-#------###--------#-#-#-
##-#--#--------------#-#---#----#---#--#-#------#------##-#--#-##---#-#---#-#--###---------###--#---