----#----#----#----#----#----#----#----#----#----#----#----#----#----#----#----#----#----#----#----#
----------------------------------------------------------------------------------------------------
#-##-#-##-#-##-#-##-#-##-#-##-#-##-#-##-#-##-#-##-#-##-#-##-#-##-#-##-#-##-#-##-#-##-#-##-#-##-#-##-
#-#--#-#--#-#--#-#--#-#--#-#--#-#--#-#--#-#--#-#--#-#--#-#--#-#--#-#--#-#--#-#--#-#--#-#--#-#--#-#--
#----#----#----#----#----#----#----#----#----#----#----#----#----#----#----#----#----#----#----#----
----#----#----#----#----#----#----#----#----#----#----#----#----#----#----#----#----#----#----#----#
----------------------------------------------------------------------------------------------------
#-##-#-##-#-##-#-##-#-##-#-##-#-##-#-##-#-##-#-##-#-##-#-##-#-##-#-##-#-##-#-##-#-##-#-##-#-##-#-##-
#-#--#-#--#-#--#-#--#-#--#-#--#-#--#-#--#-#--#-#--#-#--#-#--#-#--#-#--#-#--#-#--#-#--#-#--#-#--#-#--
#----#----#----#----#----#----#----#----#----#----#----#----#----#----#----#----#----#----#----#----
----#----#----#----#----#----#----#----#----#----#----#----#----#----#----#----#----#----#----#----#
----------------------------------------------------------------------------------------------------
#-##-#-##-#-##-#-##-#-##-#-##-#-##-#-##-#-##-#-##-#-##-#-##-#-##-#-##-#-##-#-##-#-##-#-##-#-##-#-##-
#-#--#-#--#-#--#-#--#-#--#-#--#-#--#-#--#-#--#-#--#-#--#-#--#-#--#-#--#-#--#-#--#-#--#-#--#-#--#-#--
#----#----#----#----#----#----#----#----#----#----#----#----#----#----#----#----#----#----#----#----
----#----#----#----#----#----#----#----#----#----#----#----#----#----#----#----#----#----#----#----#
----------------------------------------------------------------------------------------------------
#-##-#-##-#-##-#-##-#-##-#-##-#-##-#-##-#-##-#-##-#-##-#-##-#-##-#-##-#-##-#-##-#-##-#-##-#-##-#-##-
#-#--#-#--#-#--#-#--#-#--#-#--#-#--#-#--#-#--#-#--#-#--#-#--#-#--#-#--#-#--#-#--#-#--#-#--#-#--#-#--
#----#----#----#----#----#----#----#----#----#----#----#----#----#----#----#----#----#----#----#----
----#----#----#----#----#----#----#----#----#----#----#----#----#----#----#----#----#----#----#----#
----------------------------------------------------------------------------------------------------
#-##-#-##-#-##-#-##-#-##-#-##-#-##-#-##-#-##-#-##-#-##-#-##-#-##-#-##-#-##-#-##-#-##-#-##-#-##-#-##-
#-#--#-#--#-#--#-#--#-#--#-#--#-#--#-#--#-#--#-#--#-#--#-#--#-#--#-#--#-#--#-#--#-#--#-#--#-#--#-#--
#----#----#----#----#----#----#----#----#----#----#----#----#----#----#----#----#----#----#----#----
----#----#----#----#----#----#----#----#----#----#----#----#----#----#----#----#----#----#----#----#
----------------------------------------------------------------------------------------------------
#-##-#-##-#-##-#-##-#-##-#-##-#-##-#-##-#-##-#-##-#-##-#-##-#-##-#-##-#-##-#-##-#-##-#-##-#-##-#-##-
#-#--#-#--#-#--#-#--#-#--#-#--#-#--#-#--#-#--#-#--#-#--#-#--#-#--#-#--#-#--#-#--#-#--#-#--#-#--#-#--
#----#----#----#----#----#----#----#----#----#----#----#----#----#----#----#----#----#----#----#----
----#----#----#----#----#----#----#----#----#----#----#----#----#----#----#----#----#----#----#----#
----------------------------------------------------------------------------------------------------
#-##-#-##-#-##-#-##-#-##-#-##-#-##-#-##-#-##-#-##-#-##-#-##-#-##-#-##-#-##-#-##-#-##-#-##-#-##-#-##-
#-#--#-#--#-#--#-#--#-#--#-#--#-#--#-#--#-#--#-#--#-#--#-#--#-#--#-#--#-#--#-#--#-#--#-#--#-#--#-#--
#----#----#----#----#----#----#----#----#----#----#----#----#----#----#----#----#----#----#----#----
----#----#----#----#----#----#----#----#----#----#----#----#----#----#----#----#----#----#----#----#
----------------------------------------------------------------------------------------------------
#-##-#-##-#-##-#-##-#-##-#-##-#-##-#-##-#-##-#-##-#-##-#-##-#-##-#-##-#-##-#-##-#-##-#-##-#-##-#-##-
#-#--#-#--#-#--#-#--#-#--#-#--#-#--#-#--#-#--#-#--#-#--#-#--#-#--#-#--#-#--#-#--#-#--#-#--#-#--#-#--
#----#----#----#----#----#----#----#----#----#----#----#----#----#----#----#----#----#----#----#----
----#----#----#----#----#----#----#----#----#----#----#----#----#----#----#----#----#----#----#----#
----------------------------------------------------------------------------------------------------
#-##-#-##-#-##-#-##-#-##-#-##-#-##-#-##-#-##-#-##-#-##-#-##-#-##-#-##-#-##-#-##-#-##-#-##-#-##-#-##-
#-#--#-#--#-#--#-#--#-#--#-#--#-#--#-#--#-#--#-#--#-#--#-#--#-#--#-#--#-#--#-#--#-#--#-#--#-#--#-#--
#----#----#----#----#----#----#----#----#----#----#----#----#----#----#----#----#----#----#----#----
----#----#----#----#----#----#----#----#----#----#----#----#----#----#----#----#----#----#----#----#
----------------------------------------------------------------------------------------------------
#-##-#-##-#-##-#-##-#-##-#-##-#-##-#-##-#-##-#-##-#-##-#-##-#-##-#-##-#-##-#-##-#-##-#-##-#-##-#-##-
#-#--#-#--#-#--#-#--#-#--#-#--#-#--#-#--#-#--#-#--#-#--#-#--#-#--#-#--#-#--#-#--#-#--#-#--#-#--#-#--
#----#----#----#----#----#----#----#----#----#----#----#----#----#----#----#----#----#----#----#----
----#----#----#----#----#----#----#----#----#----#----#----#----#----#----#----#----#----#----#----#
----------------------------------------------------------------------------------------------------
#-##-#-##-#-##-#-##-#-##-#-##-#-##-#-##-#-##-#-##-#-##-#-##-#-##-#-##-#-##-#-##-#-##-#-##-#-##-#-##-
#-#--#-#--#-#--#-#--#-#--#-#--#-#--#-#--#-#--#-#--#-#--#-#--#-#--#-#--#-#--#-#--#-#--#-#--#-#--#-#--
#----#----#----#----#----#----#----#----#----#----#----#----#----#----#----#----#----#----#----#----
----#----#----#----#----#----#----#----#----#----#----#----#----#----#----#----#----#----#----#----#
------------------------------------------S---------------------------------------------------------
#-##-#-##-#-##-#-##-#-##-#-##-#-##-#-##-#-##-#-##-#-##-#-##-#-##-#-##-#-##-#-##-#-##-#-##-#-##-#-##-
#-#--#-#--#-#--#-#--#-#--#-#--#-#--#-#--#-#--#-#--#-#--#-#--#-#--#-#--#-#--#-#--#-#--#-#--#-#--#-#--
#----#----#----#----#----#----#----#----#----#----#----#----#----#----#----#----#----#----#----#----
----#----#----#----#----#----#----#----#----#----#----#----#----#----#----#----#----#----#----#----#
----------------------------------------------------------------------------------------------------
#-##-#-##-#-##-#-##-#-##-#-##-#-##-#-##-#-##-#-##-#-##-#-##-#-##-#-##-#-##-#-##-#-##-#-##-#-##-#-##-
#-#--#-#--#-#--#-#--#-#--#-#--#-#--#-#--#-#--#-#--#-#--#-#--#-#--#-#--#-#--#-#--#-#--#-#--#-#--#-#--
#----#----#----#----#----#----#----#----#----#----#----#----#----#----#----#----#----#----#----#----
----#----#----#----#----#----#----#----#----#----#----#----#----#----#----#----#----#----#----#----#
----------------------------------------------------------------------------------------------------
#-##-#-##-#-##-#-##-#-##-#-##-#-##-#-##-#-##-#-##-#-##-#-##-#-##-#-##-#-##-#-##-#-##-#-##-#-##-#-##-
#-#--#-#--#-#--#-#--#-#--#-#--#-#--#-#--#-#--#-#--#-#--#-#--#-#--#-#--#-#--#-#--#-#--#-#--#-#--#-#--
#----#----#----#----#----#----#----#----#----#----#----#----#----#----#----#----#----#----#----#----
----#----#----#----#----#----#----#----#----#----#----#----#----#----#----#----#----#----#----#----#
----------------------------------------------------------------------------------------------------
#-##-#-##-#-##-#-##-#-##-#-##-#-##-#-##-#-##-#-##-#-##-#-##-#-##-#-##-#-##-#-##-#-##-#-##-#-##-#-##-
#-#--#-#--#-#--#-#--#-#--#-#--#-#--#-#--#-#--#-#--#-#--#-#--#-#--#-#--#-#--#-#--#-#--#-#--#-#--#-#--
#----#----#----#----#----#----#----#----#----#----#----#----#----#----#----#----#----#----#----#----
----#----#----#----#----#----#----#----#----#----#----#----#----#----#----#----#----#----#----#----#
----------------------------------------------------------------------------------------------------
#-##-#-##-#-##-#-##-#-##-#-##-#-##-#-##-#-##-#-##-#-##-#-##-#-##-#-##-#-##-#-##-#-##-#-##-#-##-#-##-
#-#--#-#--#-#--#-#--#-#--#-#--#-#--#-#--#-#--#-#--#-#--#-#--#-#--#-#--#-#--#-#--#-#--#-#--#-#--#-#--
#----#----#----#----#----#----#----#----#----#----#----#----#----#----#----#----#----#----#----#----
----#----#----#----#----#----#----#----#----#----#----#----#----#----#----#----#----#----#----#----#
----------------------------------------------------------------------------------------------------
#-##-#-##-#-##-#-##-#-##-#-##-#-##-#-##-#-##-#-##-#-##-#-##-#-##-#-##-#-##-#-##-#-##-#-##-#-##-#-##-
#-#--#-#--#-#--#-#--#-#--#-#--#-#--#-#--#-#--#-#--#-#--#-#--#-#--#-#--#-#--#-#--#-#--#-#--#-#--#-#--
#----#----#----#----#----#----#----#----#----#----#----#----#----#----#----#----#----#----#----#----
----#----#----#----#----#----#----#----#----#----#----#----#----#----#----#----#----#----#----#----#
----------------------------------------------------------------------------------------------------
#-##-#-##-#-##-#-##-#-##-#-##-#-##-#-##-#-##-#-##-#-##-#-##-#-##-#-##-#-##-#-##-#-##-#-##-#-##-#-##-
#-#--#-#--#-#--#-#--#-#--#-#--#-#--#-#--#-#--#-#--#-#--#-#--#-#--#-#--#-#--#-#--#-#--#-#--#-#--#-#--
#----#----#----#----#----#----#----#----#----#----#----#----#----#----#----#----#----#----#----#----
----#----#----#----#----#----#----#----#----#----#----#----#----#----#----#----#----#----#----#----#
----------------------------------------------------------------------------------------------------
#-##-#-##-#-##-#-##-#-##-#-##-#-##-#-##-#-##-#-##-#-##-#-##-#-##-#-##-#-##-#-##-#-##-#-##-#-##-#-##-
#-#--#-#--#-#--#-#--#-#--#-#--#-#--#-#--#-#--#-#--#-#--#-#--#-#--#-#--#-#--#-#--#-#--#-#--#-#--#-#--
#----#----#----#----#----#----#----#----#----#----#----#----#----#----#----#----#----#----#----#----
----#----#----#----#----#----#----#----#----#----#----#----#----#----#----#----#----#----#----#----#
----------------------------------------------------------------------------------------------------
#-##-#-##-#-##-#-##-#-##-#-##-#-##-#-##-#-##-#-##-#-##-#-##-#-##-#-##-#-##-#-##-#-##-#-##-#-##-#-##-
#-#--#-#--#-#--#-#--#-#--#-#--#-#--#-#--#-#--#-#--#-#--#-#--#-#--#-#--#-#--#-#--#-#--#-#--#-#--#-#--
#----#----#----#---E#----#----#----#----#----#----#----#----#----#----#----#----#----#----#----#----