##-#-##-#-##-#-##-#-##-#-##-#-##-#-##-#-##-#-##-#-##-#-##-#-##-#-##-#-##-#-##-#-##-#-##-#-##-#-##-#-
-#----#----#----#----#----#----#----#----#----#----#----#----#----#----#----#----#----#----#----#---
-#----#----#----#----#----#----#----#----#----#----#----#----#----#----#----#----#----#----#----#---
---#----#----#----#----#----#----#----#----#----#----#----#----#----#----#----#----#----#----#----#-
---##---##---##---##---##---##---##---##---##---##---##---##---##---##---##---##---##---##---##---##
##-#-##-#-##-#-##-#-##-#-##-#-##-#-##-#-##-#-##-#-##-#-##-#-##-#-##-#-##-#-##-#-##-#-##-#-##-#-##-#-
-#----#----#----#----#----#----#----#----#----#----#----#----#----#----#----#----#----#----#----#---
-#----#----#----#----#----#----#----#----#----#----#----#----#----#----#----#----#----#----#----#---
---#----#----#----#----#----#----#----#----#----#----#----#----#----#----#----#----#----#----#----#-
---##---##---##---##---##---##---##---##---##---##---##---##---##---##---##---##---##---##---##---##
##-#-##-#-##-#-##-#-##-#-##-#-##-#-##-#-##-#-##-#-##-#-##-#-##-#-##-#-##-#-##-#-##-#-##-#-##-#-##-#-
-#----#----#----#----#----#----#----#----#----#----#----#----#----#----#----#----#----#----#----#---
-#----#----#----#----#----#----#----#----#----#----#----#----#----#----#----#----#----#----#----#---
---#----#----#----#----#----#----#----#----#----#----#----#----#----#----#----#----#----#----#----#-
---##---##---##---##---##---##---##---##---##---##---##---##---##---##---##---##---##---##---##---##
##-#-##-#-##-#-##-#-##-#-##-#-##-#-##-#-##-#-##-#-##-#-##-#-##-#-##-#-##-#-##-#-##-#-##-#-##-#-##-#-
-#----#----#----#----#----#----#----#----#----#----#----#----#----#----#----#----#----#----#----#---
-#----#----#----#----#----#----#----#----#----#----#----#----#----#----#----#----#----#----#----#---
---#----#----#----#----#----#----#----#----#----#----#----#----#----#----#----#----#----#----#----#-
---##---##---##---##---##---##---##---##---##---##---##---##---##---##---##---##---##---##---##---##
##-#-##-#-##-#-##-#-##-#-##-#-##-#-##-#-##-#-##-#-##-#-##-#-##-#-##-#-##-#-##-#-##-#-##-#-##-#-##-#-
-#----#----#----#----#----#----#----#----#----#----#----#----#----#----#----#----#----#----#----#---
-#----#----#----#----#----#----#----#----#----#----#----#----#----#----#----#----#----#----#----#---
---#----#----#----#----#----#----#----#--E-#----#----#----#----#----#----#----#----#----#----#----#-
---##---##---##---##---##---##---##---##---##---##---##---##---##---##---##---##---##---##---##---##
##-#-##-#-##-#-##-#-##-#-##-#-##-#-##-#-##-#-##-#-##-#-##-#-##-#-##-#-##-#-##-#-##-#-##-#-##-#-##-#-
-#----#----#----#----#----#----#----#----#----#----#----#----#----#----#----#----#----#----#----#---
-#----#----#----#----#----#----#----#----#----#----#----#----#----#----#----#----#----#----#----#---
---#----#----#----#----#----#----#----#----#----#----#----#----#----#----#----#----#----#----#----#-
---##---##---##---##---##---##---##---##---##---##---##---##---##---##---##---##---##---##---##---##
##-#-##-#-##-#-##-#-##-#-##-#-##-#-##-#-##-#-##-#-##-#-##-#-##-#-##-#-##-#-##-#-##-#-##-#-##-#-##-#-
-#----#----#----#----#----#----#----#----#----#----#----#----#----#----#----#----#----#----#----#---
-#----#----#----#----#----#----#----#----#----#----#----#----#----#----#----#----#----#----#----#---
---#----#----#----#----#----#----#----#----#----#----#----#----#----#----#----#----#----#----#----#-
---##---##---##---##---##---##---##---##---##---##---##---##---##---##-S-##---##---##---##---##---##
##-#-##-#-##-#-##-#-##-#-##-#-##-#-##-#-##-#-##-#-##-#-##-#-##-#-##-#-##-#-##-#-##-#-##-#-##-#-##-#-
-#----#----#----#----#----#----#----#----#----#----#----#----#----#----#----#----#----#----#----#---
-#----#----#----#----#----#----#----#----#----#----#----#----#----#----#----#----#----#----#----#---
---#----#----#----#----#----#----#----#----#----#----#----#----#----#----#----#----#----#----#----#-
---##---##---##---##---##---##---##---##---##---##---##---##---##---##---##---##---##---##---##---##
##-#-##-#-##-#-##-#-##-#-##-#-##-#-##-#-##-#-##-#-##-#-##-#-##-#-##-#-##-#-##-#-##-#-##-#-##-#-##-#-
-#----#----#----#----#----#----#----#----#----#----#----#----#----#----#----#----#----#----#----#---
-#----#----#----#----#----#----#----#----#----#----#----#----#----#----#----#----#----#----#----#---
---#----#----#----#----#----#----#----#----#----#----#----#----#----#----#----#----#----#----#----#-
---##---##---##---##---##---##---##---##---##---##---##---##---##---##---##---##---##---##---##---##
##-#-##-#-##-#-##-#-##-#-##-#-##-#-##-#-##-#-##-#-##-#-##-#-##-#-##-#-##-#-##-#-##-#-##-#-##-#-##-#-
-#----#----#----#----#----#----#----#----#----#----#----#----#----#----#----#----#----#----#----#---
-#----#----#----#----#----#----#----#----#----#----#----#----#----#----#----#----#----#----#----#---
---#----#----#----#----#----#----#----#----#----#----#----#----#----#----#----#----#----#----#----#-
---##---##---##---##---##---##---##---##---##---##---##---##---##---##---##---##---##---##---##---##
##-#-##-#-##-#-##-#-##-#-##-#-##-#-##-#-##-#-##-#-##-#-##-#-##-#-##-#-##-#-##-#-##-#-##-#-##-#-##-#-
-#----#----#----#----#----#----#----#----#----#----#----#----#----#----#----#----#----#----#----#---
-#----#----#----#----#----#----#----#----#----#----#----#----#----#----#----#----#----#----#----#---
---#----#----#----#----#----#----#----#----#----#----#----#----#----#----#----#----#----#----#----#-
---##---##---##---##---##---##---##---##---##---##---##---##---##---##---##---##---##---##---##---##
##-#-##-#-##-#-##-#-##-#-##-#-##-#-##-#-##-#-##-#-##-#-##-#-##-#-##-#-##-#-##-#-##-#-##-#-##-#-##-#-
-#----#----#----#----#----#----#----#----#----#----#----#----#----#----#----#----#----#----#----#---
-#----#----#----#----#----#----#----#----#----#----#----#----#----#----#----#----#----#----#----#---
---#----#----#----#----#----#----#----#----#----#----#----#----#----#----#----#----#----#----#----#-
---##---##---##---##---##---##---##---##---##---##---##---##---##---##---##---##---##---##---##---##
##-#-##-#-##-#-##-#-##-#-##-#-##-#-##-#-##-#-##-#-##-#-##-#-##-#-##-#-##-#-##-#-##-#-##-#-##-#-##-#-
-#----#----#----#----#----#----#----#----#----#----#----#----#----#----#----#----#----#----#----#---
-#----#----#----#----#----#----#----#----#----#----#----#----#----#----#----#----#----#----#----#---
---#----#----#----#----#----#----#----#----#----#----#----#----#----#----#----#----#----#----#----#-
---##---##---##---##---##---##---##---##---##---##---##---##---##---##---##---##---##---##---##---##
##-#-##-#-##-#-##-#-##-#-##-#-##-#-##-#-##-#-##-#-##-#-##-#-##-#-##-#-##-#-##-#-##-#-##-#-##-#-##-#-
-#----#----#----#----#----#----#----#----#----#----#----#----#----#----#----#----#----#----#----#---
-#----#----#----#----#----#----#----#----#----#----#----#----#----#----#----#----#----#----#----#---
---#----#----#----#----#----#----#----#----#----#----#----#----#----#----#----#----#----#----#----#-
---##---##---##---##---##---##---##---##---##---##---##---##---##---##---##---##---##---##---##---##
##-#-##-#-##-#-##-#-##-#-##-#-##-#-##-#-##-#-##-#-##-#-##-#-##-#-##-#-##-#-##-#-##-#-##-#-##-#-##-#-
-#----#----#----#----#----#----#----#----#----#----#----#----#----#----#----#----#----#----#----#---
-#----#----#----#----#----#----#----#----#----#----#----#----#----#----#----#----#----#----#----#---
---#----#----#----#----#----#----#----#----#----#----#----#----#----#----#----#----#----#----#----#-
---##---##---##---##---##---##---##---##---##---##---##---##---##---##---##---##---##---##---##---##
##-#-##-#-##-#-##-#-##-#-##-#-##-#-##-#-##-#-##-#-##-#-##-#-##-#-##-#-##-#-##-#-##-#-##-#-##-#-##-#-
-#----#----#----#----#----#----#----#----#----#----#----#----#----#----#----#----#----#----#----#---
-#----#----#----#----#----#----#----#----#----#----#----#----#----#----#----#----#----#----#----#---
---#----#----#----#----#----#----#----#----#----#----#----#----#----#----#----#----#----#----#----#-
---##---##---##---##---##---##---##---##---##---##---##---##---##---##---##---##---##---##---##---##
##-#-##-#-##-#-##-#-##-#-##-#-##-#-##-#-##-#-##-#-##-#-##-#-##-#-##-#-##-#-##-#-##-#-##-#-##-#-##-#-
-#----#----#----#----#----#----#----#----#----#----#----#----#----#----#----#----#----#----#----#---
-#----#----#----#----#----#----#----#----#----#----#----#----#----#----#----#----#----#----#----#---
---#----#----#----#----#----#----#----#----#----#----#----#----#----#----#----#----#----#----#----#-
---##---##---##---##---##---##---##---##---##---##---##---##---##---##---##---##---##---##---##---##
##-#-##-#-##-#-##-#-##-#-##-#-##-#-##-#-##-#-##-#-##-#-##-#-##-#-##-#-##-#-##-#-##-#-##-#-##-#-##-#-
-#----#----#----#----#----#----#----#----#----#----#----#----#----#----#----#----#----#----#----#---
-#----#----#----#----#----#----#----#----#----#----#----#----#----#----#----#----#----#----#----#---
---#----#----#----#----#----#----#----#----#----#----#----#----#----#----#----#----#----#----#----#-
---##---##---##---##---##---##---##---##---##---##---##---##---##---##---##---##---##---##---##---##
##-#-##-#-##-#-##-#-##-#-##-#-##-#-##-#-##-#-##-#-##-#-##-#-##-#-##-#-##-#-##-#-##-#-##-#-##-#-##-#-
-#----#----#----#----#----#----#----#----#----#----#----#----#----#----#----#----#----#----#----#---
-#----#----#----#----#----#----#----#----#----#----#----#----#----#----#----#----#----#----#----#---
---#----#----#----#----#----#----#----#----#----#----#----#----#----#----#----#----#----#----#----#-
---##---##---##---##---##---##---##---##---##---##---##---##---##---##---##---##---##---##---##---##
##-#-##-#-##-#-##-#-##-#-##-#-##-#-##-#-##-#-##-#-##-#-##-#-##-#-##-#-##-#-##-#-##-#-##-#-##-#-##-#-
-#----#----#----#----#----#----#----#----#----#----#----#----#----#----#----#----#----#----#----#---
-#----#----#----#----#----#----#----#----#----#----#----#----#----#----#----#----#----#----#----#---
---#----#----#----#----#----#----#----#----#----#----#----#----#----#----#----#----#----#----#----#-
---##---##---##---##---##---##---##---##---##---##---##---##---##---##---##---##---##---##---##---##