---#-#----#-#---#-------#-##-##-#------#------#--#------##---#-#-#--#--------#-#--##--##----#--#---#
--##--------##-#------#---#-#----##-----#----#-----#-#-#-------##-#-#-------##--##-----#----##--##--
-##-------#-----#-###-----###---#--------#####--#-----#-#-##-#-##------####--#-------#-#-----#-#--##
---##-#------#-#--#--------#####--#-#----####-##--###--#---------##------#----####-#---------#---###
#---#-----##--###--#-----#-------#--#-#-#---#-###-#---#-------#--------#-#--------###--#-#-#--#---#-
-####-#----#---------##----#----#-#----#-#--##------------#------------##-----#----#-------------##-
-###------------#--#-#--#-#---##--#----##---#---#-#-#-##----#-#--####----##--#--#--#--##--------##--
--#----#--#------------##---#---#-------#---#--##-#--####----------##------#-#--------#--------#--#-
-##----#--#---#----#-------#------#-#---##---#-#----##-----#---##----#----##-------#--#-#--------#--
#--##-#--#---#----##-#---###--#--#--###------#----------------#-##---#---#--##-#----#------#-#---#--
-#---##-###----#----###---------#------#----#---#-##--###------------###---#-#---###-#----------#---
------#----------###---------#---#--###---#----####-#-----#---###-#---###-----------#-##---#-#------
-#-#-###------#--##----#------#--#--##-#--##----##-#-#-#-####---#----##--#--#-----#--#------------#-
------#---##-----#---##-#---#--#--#------#----#---#-#----#-##-##--------##---##-----------#------#--
---#-#--##-#---##------------##----##-#-#----#------##----#--##--##-#---##-#-----#---#----##------#-
-----------###-#-##---#--##------##-##----##--#---###----#--#---###--##--#--#---#---------###-------
-##-#-#-#-###---###-----------#-#--#------##--##--#---#-##-----#-#--##-----#----#-###-###-#####-#---
-#-#--------#------##--###------#--------#-##-#---#--------#-------#----#---####---#####---#---#----
#-#-#------###---#--#-----#####--------#--##-##-----#---#---#-#-------------#--#----#-#--#----#--##-
------------#-#----##-----#-----#---------#--------#--#--#-------#-#-#----#-#--#---#####-----#-#---#
#---#-----#-----#-------##--------#---#-#-#-#--##---#--#----#---------------#---#####--#--#-#--#----
#-----#----#----#-#-#-------#---##-##-####-----#--#--##---#-------#---#-#--#---#--#--------#--#----#
#-##-#-#----##-----#-##---#-#----#-#----#--##------#--------------#-----##--##----#-#-------#-------
#--#-----##---##-------#-----#--#--##---##----#-#-#---#-#---#-#----#--#---#-#-#----#--######-#------
##-----##--#-#---##-----##--------#-#-----#-----#-#----#-#--##----##-#------#-#-#-----#-----#--#---#
#-###---##---#-#---##-#-#--#--##-#-----##-#-#--##------------#--#-#---#-#-----##--##-##--##-#--#----
--###-#--#--##--------#-#-####--##--####---------##------#---#----------#---####---#-#----#------#-#
--------#-#---##-#---###-#--##--##-##------#--#----#--#--#--#-----###---------#-#---------##-##--#-#
#-----#--------#-###--##-----#--#----#-#-#-##-------#-#---#-------------------##-----#-----#--#--##-
#--#--###-###---#---#--##-###--#----#--#-##------#-#---#-#----#-----#-###--##--##--###-#---------#--
-#-#-#---#-#-#---##-------##-----##-#-####-##--#-#-----#--###--#-#-##---#-------#--------#-#---#-#-#
##---#--#-#-##---#-#---#---------#---#-------#-#---#--#-#---#---#-----##--#----#-####------#--------
--#-###-##----#---#--#-###-----#---#----#-#----###----#-##---#----#--#-#####-#---#-#--#-###-------#-
#-#-----#-----##--#---------#---#--#-#-##--#-#--##-###---#--#---------#-#-#---#-###-------##-----#--
#-###---#----###--#----#------#--#---#---#-##---------##-#------###-###-##--#------#-----#-#---#--##
-#----------##------#-#-##----#--#-----##-####-#-#--##-----##-----###--##----#-------#-------#----##
---##--#-#-----##-#-#---#--#---------------#-----##--#--#--#----#---#-#-----#------#-----#-#--##--#-
--#-----#-#----##---####----------###---#---------#--#---##--##-#--#-#----#--#----#--##---#----#----
--#-----#-#--#--#----#--#--#-#-#--#-#--##-########-##--##---###-#-#------#-###------#------##-#---#-
-#--------------####--#-----##--##-#-#-#-----#------#-#---#-#--#---##-#-------#--##-#-#---#-#-#--#--
#---#-##---------#--##--##--##----#----------#--##--#-#---##--#--#--##------##-#-----#--#-##------##
-##--#-#------#-----###-#----##-#-##-----##-----#---###--###-------#-----##--#--#---#-#---#-##-###-#
-----#--#-------###--------#-##-#--#-E---#---#-----#-#----##--------#-#-----------##----#-#---------
##------#----#----##---##-----------#--------#-##-##-#---###--##-#----#--##-----##----------#-#--#--
#--##--#----#----##--------------#--#------##-------#-####-###---#-----#--#----------#---#--#---#--#
--#-#--------#-#-#-##------###---#-----#-#---------##--#------#-##----------#----#------##---------#
#-#-#---#----#-------#-##--#---#-#-----#--##--#----#----#---###-##-#--#-----##-----#-#-#------#-##--
-#--##---------------#-------#--#-------##-###----##--#----#-----##---#-#----#---#--#-##-------#-#-#
----#-------##-##-----#-#-#----#-#--#----#-#-#-#------#-----#-----#---###--##-----#---#---#-#--#----
#---#-###-----#----#--##-----#--#--##----##--#-#---##-----#-#--#----#--#--#--------#-------#--#-#---
##-------------#----##---#-##--#---#------##---#---#-##---#-##----##---#-----##--##---##-##---##---#
#--------###-#------------###-#-#--#---##-#-#-#-#----##-----#-#----#-#--#--------#-##--##-#-#------#
-#------#--#-#----#----------------#-#-##---#-#---#----##-#-#-##--#------------##-------#------#-##-
-##----#-##--#-##------#--------#--#--##-#--#--#--####-#--##------##-#-------##------##-###--#-----#
##-#-------#-#----------#------#-##-#--#---#------#--#-#---#--#---#-##-#----#-##-#----#---##-##-#---
----#---#------#-#-#---###-#--#---#----#--#-##--#-#-----#--#-----#---#-##-----##--------------#-####
---#---#-#-##--------------#------#--##--#---##--------#-#-##-######--#-#-#--------#-----#----------
-------#--#-#----##----##----#----#--#--#--#-#-#--#--###------##-----####----##--###--#-#--#-##-----
-----#---##---#--#---##----------##---#----##---#------#-##-##------#----#-------##-#--#------#-#---
--##------#--#------##--###---##--##-----#-##------####--##------#--#-#----#----------##--#---#-----
#-#---#------#-#----#--##-###---#-#-----------#-#---####-##------#-#--#-----#---##--#--#--#---#-----
-##-#-------##--##--#--------##-----###--##--#------#--#---#-#----#-#------#-#--#----##--#----#-#---
#--#-#-##---##--#---------##--##---#-#-----##-#-----##-#-----------#-#-----##-----####-#-#----#---##
####-------#---#-#------------#---#--#-#-##-#-#-##---#-----#-------###----##---#----------####-#--##
----#------##-#----##------###--##---##----##-----##-------#--------#-----#-------#--------#-#-#-#-#
#----#-##-#----#--##-#-#------#----#---##------#-##----#--#----##----#---------##-#----#---#-#-#-###
#--#-#---#-#---#-#--#----#-#---#-###-----#---##----#-------##--#-#-##-#-#--------------##---#-------
----##-----#----##-#-##-----#-------#--#-###------#-#----####-##--#------------#------#--#-#--#-----
-------####-----#--##-------#-#-###-#-#-#------#--#--##-#----#---------#-#-----#----#------##-#-###-
--#---#-#---###-#---##-#---#--##-#----##-----###-#--------#####-##-----#-#------#-----#-###---#-##--
#-##---------#---------------###------#---#-#----###-----#-#---#-##-#----#-------------#----#------#
-----#-----#-##-#-##--##---#-####-#--#-#-###--#-#--#--###--####-----#---#-#---##-#---####-##--#--#--
--#--#-#------##-#-##----#-####--#--####----#--#--##----#------------#----#-#-#--#---#------------##
----#--#---#-#---#-#----------------#---##-##--#------------##----#--------#-#-#-#--#-----#---#----#
#----#-#--------#-------#--#---#----#-----###--#--#----#------###--#---------#-#---##--######--#-#--
--##-##------#-#-----#--#---##----#---#-#-------#----#-#---#-#-##-#---##--#--#------#-----###-----#-
-#---#-#-##----------##----#-#--#--#-#-#-#---#-##--------------##-##---#-#-##-----#-#---#----#-#----
##--#--#--######------#---#----#---#-#--#----------##---##---#-#-----###-###-#-#-#S-#--#------#-----
#----#-##---#-#--#-###--#-#--##---##-#------#----#-####-------------#---#----------------#----------
--#-#--#-#--#-#-------#--#---#---#----#--#-------#--#---#---#-------##-#-##--#------##---##--#--#---
#-#--------#--#------#------------#-#--#-###------------------------#-#-#-#--------#-#--#---#-------
---###----#----#----#--#---##----##--#--------#-#----------#---##-#--#--###-###-#--#------#-------##
-#--#---------#-------#-#---#-------#------##---##-#-------------#----#----#---###---------#--#---#-
---#-#----#-------#------##--#---#-------#-##----#------#-#---###--#-------#----#--##-##--##----##-#
#-------#--#-----#---------#--#--##--#-##-------##-#------#----#---#---##---##--#-##--#------#-#--#-
-----#----#------#-#---#-#-#---#--#--#-#----#---#-##-#-#--#-##----#---#-#-----####-###---#----##----
-#-##--#---------#-#-#--#####-#-#-------#-##-----#---#-----#----------#-#--#---#-----#--#-----#-#-#-
--##-##---------##----###--#-#-#--##----#------#----#--#---#-----##-#-#----#-#-------#-##--#-----#--
-----##--#---###--#--------#---##-----#----------##---#----##---#----#-#--#--##-#--##-----#----#----
-#-------#-#---##--##-#-------#----#-##--##---##-##------###--#####-#-#---#--#----------------#--##-
--##-----#--#-#--##-#-###-###-#########----#------#-#-#-#-#---##---#--#--------#---------#----##--#-
-----#--#--##---##-#-#----#-###--#-#---#------#-#----###-#--#-------#-----#-----##-#----------####--
--##----#-##---#-#-###-----#-#---#-#-----#--#--##-#--#---#--##-------------#--#--###-#---#----#--##-
---#-#--#####-#---#----##-#----####-###-------#-#--------#-####-###--#-----##--------#--#-#---#---#-
-------#--#-#----#-------#-#-------#-----##--#-#---###-----#---#--#---------------##-#---------#--#-
-#-#----##-#-#-#---#-##-#-##----#--#-##---##-##-#---##-#------------#----------#-----##-----#-------
-#--#--#--#--#-----#--##------------##-#-#--#--#----#--##-#-#--#------#---#---#-#-##-#-#-##-------##
#----#-#---#---#-###---#--------###------#--------####--#-----------------------#-------##--#---#---
-#---#--#--------------------#-#-#--#-#----------#-#------#-----#--##--##-------#---#--#--#--#-####-
##--------#--#---###--##--#-##-#----##--###-#-------#----##--#--------##-------##--##---------#-----