-##---##---##---##---##---##---##---##---##---##---##---##---##---##---##---##---##---##---##---##--
----------------------------------------------------------------------------------------------------
#-##-#-##-#-##-#-##-#-##-#-##-#-##-#-##-#-##-#-##-#-##-#-##-#-##-#-##-#-##-#-##-#-##-#-##-#-##-#-##-
----------------------------------------------------------------------------------------------------
--##---##---##---##---##---##---##---##---##---##---##---##---##---##---##---##---##---##---##---##-
-##---##---##---##---##---##---##---##---##---##---##---##---##---##---##---##---##---##---##---##--
----------------------------------------------------------------------------------------------------
#-##-#-##-#-##-#-##-#-##-#-##-#-##-#-##-#-##-#-##-#-##-#-##-#-##-#-##-#-##-#-##-#-##-#-##-#-##-#-##-
----------------------------------------------------------------------------------------------------
--##---##---##---##---##---##---##---##---##---##---##---##---##---##---##---##---##---##---##---##-
-##---##---##---##---##---##---##---##---##---##---##---##---##---##---##---##---##---##---##---##--
----------------------------------------------------------------------------------------------------
#-##-#-##-#-##-#-##-#-##-#-##-#-##-#-##-#-##-#-##-#-##-#-##-#-##-#-##-#-##-#-##-#-##-#-##-#-##-#-##-
---------------------------------------------------------------------------------S------------------
--##---##---##---##---##---##---##---##---##---##---##---##---##---##---##---##---##---##---##---##-
-##---##---##---##---##---##---##---##---##---##---##---##---##---##---##---##---##---##---##---##--
----------------------------------------------------------------------------------------------------
#-##-#-##-#-##-#-##-#-##-#-##-#-##-#-##-#-##-#-##-#-##-#-##-#-##-#-##-#-##-#-##-#-##-#-##-#-##-#-##-
----------------------------------------------------------------------------------------------------
--##---##---##---##---##---##---##---##---##---##---##---##---##---##---##---##---##---##---##---##-
-##---##---##---##---##---##---##---##---##---##---##---##---##---##---##---##---##---##---##---##--
----------------------------------------------------------------------------------------------------
#-##-#-##-#-##-#-##-#-##-#-##-#-##-#-##-#-##-#-##-#-##-#-##-#-##-#-##-#-##-#-##-#-##-#-##-#-##-#-##-
----------------------------------------------------------------------------------------------------
--##---##---##---##---##---##---##---##---##---##---##---##---##---##---##---##---##---##---##---##-
-##---##---##---##---##---##---##---##---##---##---##---##---##---##---##---##---##---##---##---##--
----------------------------------------------------------------------------------------------------
#-##-#-##-#-##-#-##-#-##-#-##-#-##-#-##-#-##-#-##-#-##-#-##-#-##-#-##-#-##-#-##-#-##-#-##-#-##-#-##-
----------------------------------------------------------------------------------------------------
--##---##---##---##---##---##---##---##---##---##---##---##---##---##---##---##---##---##---##---##-
-##---##---##---##---##---##---##---##---##---##---##---##---##---##---##---##---##---##---##---##--
----------------------------------------------------------------------------------------------------
#-##-#-##-#-##-#-##-#-##-#-##-#-##-#-##-#-##-#-##-#-##-#-##-#-##-#-##-#-##-#-##-#-##-#-##-#-##-#-##-
----------------------------------------------------------------------------------------------------
--##---##---##---##---##---##---##---##---##---##---##---##---##---##---##---##---##---##---##---##-
-##---##---##---##---##---##---##---##---##---##---##---##---##---##---##---##---##---##---##---##--
----------------------------------------------------------------------------------------------------
#-##-#-##-#-##-#-##-#-##-#-##-#-##-#-##-#-##-#-##-#-##-#-##-#-##-#-##-#-##-#-##-#-##-#-##-#-##-#-##-
----------------------------------------------------------------------------------------------------
--##---##---##---##---##---##---##---##---##---##---##---##---##---##---##---##---##---##---##---##-
-##---##---##---##---##---##---##---##---##---##---##---##---##---##---##---##---##---##---##---##--
----------------------------------------------------------------------------------------------------
#-##-#-##-#-##-#-##-#-##-#-##-#-##-#-##-#-##-#-##-#-##-#-##-#-##-#-##-#-##-#-##-#-##-#-##-#-##-#-##-
----------------------------------------------------------------------------------------------------
--##---##---##---##---##---##---##---##---##---##---##---##---##---##---##---##---##---##---##---##-
-##---##---##---##---##---##---##---##---##---##---##---##---##---##---##---##---##---##---##---##--
----------------------------------------------------------------------------------------------------
#-##-#-##-#-##-#-##-#-##-#-##-#-##-#-##-#-##-#-##-#-##-#-##-#-##-#-##-#-##-#-##-#-##-#-##-#-##-#-##-
----------------------------------------------------------------------------------------------------
--##---##---##---##---##---##---##---##---##---##---##---##---##---##---##---##---##---##---##---##-
-##---##---##---##---##---##---##---##---##---##---##---##---##---##---##---##---##---##---##---##--
----------------------------------------------------------------------------------------------------
#-##-#-##-#-##-#-##-#-##-#-##-#-##-#-##-#-##-#-##-#-##-#-##-#-##-#-##-#-##E#-##-#-##-#-##-#-##-#-##-
----------------------------------------------------------------------------------------------------
--##---##---##---##---##---##---##---##---##---##---##---##---##---##---##---##---##---##---##---##-
-##---##---##---##---##---##---##---##---##---##---##---##---##---##---##---##---##---##---##---##--
----------------------------------------------------------------------------------------------------
#-##-#-##-#-##-#-##-#-##-#-##-#-##-#-##-#-##-#-##-#-##-#-##-#-##-#-##-#-##-#-##-#-##-#-##-#-##-#-##-
----------------------------------------------------------------------------------------------------
--##---##---##---##---##---##---##---##---##---##---##---##---##---##---##---##---##---##---##---##-
-##---##---##---##---##---##---##---##---##---##---##---##---##---##---##---##---##---##---##---##--
----------------------------------------------------------------------------------------------------
#-##-#-##-#-##-#-##-#-##-#-##-#-##-#-##-#-##-#-##-#-##-#-##-#-##-#-##-#-##-#-##-#-##-#-##-#-##-#-##-
----------------------------------------------------------------------------------------------------
--##---##---##---##---##---##---##---##---##---##---##---##---##---##---##---##---##---##---##---##-
-##---##---##---##---##---##---##---##---##---##---##---##---##---##---##---##---##---##---##---##--
----------------------------------------------------------------------------------------------------
#-##-#-##-#-##-#-##-#-##-#-##-#-##-#-##-#-##-#-##-#-##-#-##-#-##-#-##-#-##-#-##-#-##-#-##-#-##-#-##-
----------------------------------------------------------------------------------------------------
--##---##---##---##---##---##---##---##---##---##---##---##---##---##---##---##---##---##---##---##-
-##---##---##---##---##---##---##---##---##---##---##---##---##---##---##---##---##---##---##---##--
----------------------------------------------------------------------------------------------------
#-##-#-##-#-##-#-##-#-##-#-##-#-##-#-##-#-##-#-##-#-##-#-##-#-##-#-##-#-##-#-##-#-##-#-##-#-##-#-##-
----------------------------------------------------------------------------------------------------
--##---##---##---##---##---##---##---##---##---##---##---##---##---##---##---##---##---##---##---##-
-##---##---##---##---##---##---##---##---##---##---##---##---##---##---##---##---##---##---##---##--
----------------------------------------------------------------------------------------------------
#-##-#-##-#-##-#-##-#-##-#-##-#-##-#-##-#-##-#-##-#-##-#-##-#-##-#-##-#-##-#-##-#-##-#-##-#-##-#-##-
----------------------------------------------------------------------------------------------------
--##---##---##---##---##---##---##---##---##---##---##---##---##---##---##---##---##---##---##---##-
-##---##---##---##---##---##---##---##---##---##---##---##---##---##---##---##---##---##---##---##--
----------------------------------------------------------------------------------------------------
#-##-#-##-#-##-#-##-#-##-#-##-#-##-#-##-#-##-#-##-#-##-#-##-#-##-#-##-#-##-#-##-#-##-#-##-#-##-#-##-
----------------------------------------------------------------------------------------------------
--##---##---##---##---##---##---##---##---##---##---##---##---##---##---##---##---##---##---##---##-
-##---##---##---##---##---##---##---##---##---##---##---##---##---##---##---##---##---##---##---##--
----------------------------------------------------------------------------------------------------
#-##-#-##-#-##-#-##-#-##-#-##-#-##-#-##-#-##-#-##-#-##-#-##-#-##-#-##-#-##-#-##-#-##-#-##-#-##-#-##-
----------------------------------------------------------------------------------------------------
--##---##---##---##---##---##---##---##---##---##---##---##---##---##---##---##---##---##---##---##-
-##---##---##---##---##---##---##---##---##---##---##---##---##---##---##---##---##---##---##---##--
----------------------------------------------------------------------------------------------------
#-##-#-##-#-##-#-##-#-##-#-##-#-##-#-##-#-##-#-##-#-##-#-##-#-##-#-##-#-##-#-##-#-##-#-##-#-##-#-##-
----------------------------------------------------------------------------------------------------
--##---##---##---##---##---##---##---##---##---##---##---##---##---##---##---##---##---##---##---##-
-##---##---##---##---##---##---##---##---##---##---##---##---##---##---##---##---##---##---##---##--
----------------------------------------------------------------------------------------------------
#-##-#-##-#-##-#-##-#-##-#-##-#-##-#-##-#-##-#-##-#-##-#-##-#-##-#-##-#-##-#-##-#-##-#-##-#-##-#-##-
----------------------------------------------------------------------------------------------------
--##---##---##---##---##---##---##---##---##---##---##---##---##---##---##---##---##---##---##---##-