----------------------------------------------------------------------------------------------------
-#-#--#-#--#-#--#-#--#-#--#-#--#-#--#-#--#-#--#-#--#-#--#-#--#-#--#-#--#-#--#-#--#-#--#-#--#-#--#-#-
--#----#----#----#----#----#----#----#----#----#----#----#----#----#----#----#----#----#----#----#--
-###--###--###--###--###--###--###--###--###--###--###--###--###--###--###--###--###--###--###--###-
-#----#----#----#----#----#----#----#----#----#----#----#----#----#----#----#----#----#----#----#---
----------------------------------------------------------------------------------------------------
-#-#--#-#--#-#--#-#--#-#--#-#--#-#--#-#--#-#--#-#--#-#--#-#--#-#--#-#--#-#--#-#--#-#--#-#--#-#--#-#-
--#----#----#----#----#----#----#----#----#----#----#----#----#----#----#----#----#----#----#----#--
-###--###--###--###--###--###--###--###--###--###--###--###--###--###--###--###--###--###--###--###-
-#----#----#----#----#----#----#----#----#----#----#----#----#----#----#----#----#----#----#----#---
----------------------------------------------------------------------------------------------------
-#-#--#-#--#-#--#-#--#-#--#-#--#-#--#-#--#-#--#-#--#S#--#-#--#-#--#-#--#-#--#-#--#-#--#-#--#-#--#-#-
--#----#----#----#----#----#----#----#----#----#----#----#----#----#----#----#----#----#----#----#--
-###--###--###--###--###--###--###--###--###--###--###--###--###--###--###--###--###--###--###--###-
-#----#----#----#----#----#----#----#----#----#----#----#----#----#----#----#----#----#----#----#---
----------------------------------------------------------------------------------------------------
-#-#--#-#--#-#--#-#--#-#--#-#--#-#--#-#--#-#--#-#--#-#--#-#--#-#--#-#--#-#--#-#--#-#--#-#--#-#--#-#-
--#----#----#----#----#----#----#----#----#----#----#----#----#----#----#----#----#----#----#----#--
-###--###--###--###--###--###--###--###--###--###--###--###--###--###--###--###--###--###--###--###-
-#----#----#----#----#----#----#----#----#----#----#----#----#----#----#----#----#----#----#----#---
----------------------------------------------------------------------------------------------------
-#-#--#-#--#-#--#-#--#-#--#-#--#-#--#-#--#-#--#-#--#-#--#-#--#-#--#-#--#-#--#-#--#-#--#-#--#-#--#-#-
--#----#----#----#----#----#----#----#----#----#----#----#----#----#----#----#----#----#----#----#--
-###--###--###--###--###--###--###--###--###--###--###--###--###--###--###--###--###--###--###--###-
-#----#----#----#----#----#----#----#----#----#----#----#----#----#----#----#----#----#----#----#---
----------------------------------------------------------------------------------------------------
-#-#--#-#--#-#--#-#--#-#--#-#--#-#--#-#--#-#--#-#--#-#--#-#--#-#--#-#--#-#--#-#--#-#--#-#--#-#--#-#-
--#----#----#----#----#----#----#----#----#----#----#----#----#----#----#----#----#----#----#----#--
-###--###--###--###--###--###--###--###--###--###--###--###--###--###--###--###--###--###--###--###-
-#----#----#----#----#----#----#----#----#----#----#----#----#----#----#----#----#----#----#----#---
----------------------------------------------------------------------------------------------------
-#-#--#-#--#-#--#-#--#-#--#-#--#-#--#-#--#-#--#-#--#-#--#-#--#-#--#-#--#-#--#-#--#-#--#-#--#-#--#-#-
--#----#----#----#----#----#----#----#----#----#----#----#----#----#----#----#----#----#----#----#--
-###--###--###--###--###--###--###--###--###--###--###--###--###--###--###--###--###--###--###--###-
-#----#----#----#----#----#----#----#----#----#----#----#----#----#----#----#----#----#----#----#---
----------------------------------------------------------------------------------------------------
-#-#--#-#--#-#--#-#--#-#--#-#--#-#--#-#--#-#--#-#--#-#--#-#--#-#--#-#--#-#--#-#--#-#--#-#--#-#--#-#-
--#----#----#----#----#----#----#----#----#----#----#----#----#----#----#----#----#----#----#----#--
-###--###--###--###--###--###--###--###--###--###--###--###--###--###--###--###--###--###--###--###-
-#----#----#----#----#----#----#----#----#----#----#----#----#----#----#----#----#----#----#----#---
----------------------------------------------------------------------------------------------------
-#-#--#-#--#-#--#-#--#-#--#-#--#-#--#-#--#-#--#-#--#-#--#-#--#-#--#-#--#-#--#-#--#-#--#-#--#-#--#-#-
--#----#----#----#----#----#----#----#----#----#----#----#----#----#----#----#----#----#----#----#--
-###--###--###--###--###--###--###--###--###--###--###--###--###--###--###--###--###--###--###--###-
-#----#----#----#----#----#----#----#----#----#----#----#----#----#----#----#----#----#----#----#---
----------------------------------------------------------------------------------------------------
-#-#--#-#--#-#--#-#--#-#--#-#--#-#--#-#--#-#--#-#--#-#--#-#--#-#--#-#--#-#--#-#--#-#--#-#--#-#--#-#-
--#----#----#----#----#----#----#----#----#----#----#----#----#----#----#----#----#----#----#----#--
-###--###--###--###--###--###--###--###--###--###--###--###--###--###--###--###--###--###--###--###-
-#----#----#----#----#----#----#----#----#----#----#----#----#----#----#----#----#----#----#----#---
----------------------------------------------------------------------------------------------------
-#-#--#-#--#-#--#-#--#-#--#-#--#-#--#-#--#-#--#-#--#-#--#-#--#-#--#-#--#-#--#-#--#-#--#-#--#-#--#-#-
--#----#----#----#----#----#----#----#----#----#----#----#----#----#----#----#---E#----#----#----#--
-###--###--###--###--###--###--###--###--###--###--###--###--###--###--###--###--###--###--###--###-
-#----#----#----#----#----#----#----#----#----#----#----#----#----#----#----#----#----#----#----#---
----------------------------------------------------------------------------------------------------
-#-#--#-#--#-#--#-#--#-#--#-#--#-#--#-#--#-#--#-#--#-#--#-#--#-#--#-#--#-#--#-#--#-#--#-#--#-#--#-#-
--#----#----#----#----#----#----#----#----#----#----#----#----#----#----#----#----#----#----#----#--
-###--###--###--###--###--###--###--###--###--###--###--###--###--###--###--###--###--###--###--###-
-#----#----#----#----#----#----#----#----#----#----#----#----#----#----#----#----#----#----#----#---
----------------------------------------------------------------------------------------------------
-#-#--#-#--#-#--#-#--#-#--#-#--#-#--#-#--#-#--#-#--#-#--#-#--#-#--#-#--#-#--#-#--#-#--#-#--#-#--#-#-
--#----#----#----#----#----#----#----#----#----#----#----#----#----#----#----#----#----#----#----#--
-###--###--###--###--###--###--###--###--###--###--###--###--###--###--###--###--###--###--###--###-
-#----#----#----#----#----#----#----#----#----#----#----#----#----#----#----#----#----#----#----#---
----------------------------------------------------------------------------------------------------
-#-#--#-#--#-#--#-#--#-#--#-#--#-#--#-#--#-#--#-#--#-#--#-#--#-#--#-#--#-#--#-#--#-#--#-#--#-#--#-#-
--#----#----#----#----#----#----#----#----#----#----#----#----#----#----#----#----#----#----#----#--
-###--###--###--###--###--###--###--###--###--###--###--###--###--###--###--###--###--###--###--###-
-#----#----#----#----#----#----#----#----#----#----#----#----#----#----#----#----#----#----#----#---
----------------------------------------------------------------------------------------------------
-#-#--#-#--#-#--#-#--#-#--#-#--#-#--#-#--#-#--#-#--#-#--#-#--#-#--#-#--#-#--#-#--#-#--#-#--#-#--#-#-
--#----#----#----#----#----#----#----#----#----#----#----#----#----#----#----#----#----#----#----#--
-###--###--###--###--###--###--###--###--###--###--###--###--###--###--###--###--###--###--###--###-
-#----#----#----#----#----#----#----#----#----#----#----#----#----#----#----#----#----#----#----#---
----------------------------------------------------------------------------------------------------
-#-#--#-#--#-#--#-#--#-#--#-#--#-#--#-#--#-#--#-#--#-#--#-#--#-#--#-#--#-#--#-#--#-#--#-#--#-#--#-#-
--#----#----#----#----#----#----#----#----#----#----#----#----#----#----#----#----#----#----#----#--
-###--###--###--###--###--###--###--###--###--###--###--###--###--###--###--###--###--###--###--###-
-#----#----#----#----#----#----#----#----#----#----#----#----#----#----#----#----#----#----#----#---
----------------------------------------------------------------------------------------------------
-#-#--#-#--#-#--#-#--#-#--#-#--#-#--#-#--#-#--#-#--#-#--#-#--#-#--#-#--#-#--#-#--#-#--#-#--#-#--#-#-
--#----#----#----#----#----#----#----#----#----#----#----#----#----#----#----#----#----#----#----#--
-###--###--###--###--###--###--###--###--###--###--###--###--###--###--###--###--###--###--###--###-
-#----#----#----#----#----#----#----#----#----#----#----#----#----#----#----#----#----#----#----#---
----------------------------------------------------------------------------------------------------
-#-#--#-#--#-#--#-#--#-#--#-#--#-#--#-#--#-#--#-#--#-#--#-#--#-#--#-#--#-#--#-#--#-#--#-#--#-#--#-#-
--#----#----#----#----#----#----#----#----#----#----#----#----#----#----#----#----#----#----#----#--
-###--###--###--###--###--###--###--###--###--###--###--###--###--###--###--###--###--###--###--###-
-#----#----#----#----#----#----#----#----#----#----#----#----#----#----#----#----#----#----#----#---
----------------------------------------------------------------------------------------------------
-#-#--#-#--#-#--#-#--#-#--#-#--#-#--#-#--#-#--#-#--#-#--#-#--#-#--#-#--#-#--#-#--#-#--#-#--#-#--#-#-
--#----#----#----#----#----#----#----#----#----#----#----#----#----#----#----#----#----#----#----#--
-###--###--###--###--###--###--###--###--###--###--###--###--###--###--###--###--###--###--###--###-
-#----#----#----#----#----#----#----#----#----#----#----#----#----#----#----#----#----#----#----#---
----------------------------------------------------------------------------------------------------
-#-#--#-#--#-#--#-#--#-#--#-#--#-#--#-#--#-#--#-#--#-#--#-#--#-#--#-#--#-#--#-#--#-#--#-#--#-#--#-#-
--#----#----#----#----#----#----#----#----#----#----#----#----#----#----#----#----#----#----#----#--
-###--###--###--###--###--###--###--###--###--###--###--###--###--###--###--###--###--###--###--###-
-#----#----#----#----#----#----#----#----#----#----#----#----#----#----#----#----#----#----#----#---