----#--#---#-------#-----#-----#-#####----#-----#-#--##-#----##-#--###---------###----#-#-#-----#--#
---#---#-#--#-------##--##-------#---#--##-#-#-----#----#-##------#------##-#--#--###--------------#
--#--#------#-#---#-------#--#-#----#--#--#------#--#---##-##--#--##----#----#--#----#-#-----#---###
#------##-----#-#--#-##-#-#--#-###---#--#-----#--#--------#------------#---#-----#--------#---#-----
----#------------#--#-#---#-##-#--#---#--##--##-##--##---#----#-##-#---------#--##-#--#-#-#--#-#----
----------##------###--##-#-#---#-----#---#---------#---###---##--#---#----#---#-#--------##-----#--
-#-##-#-##------#---##------#-#---------#--------#--##-##--------#-#-----##---###------#--#--------#
-#-#----------#-#--#-##--#-##--#---#--##--#----------#----###-#-#-##----##-##--#-----##----#-#----#-
---#---#---#--------------#-----#--------#--#-##-#---#--#-#----------#-##--#-----#----##--#---#-#---
--#---#-#-#-#------------------####-#---##--#-----#----#-#--##-#-##--##--##---#-#---##------#----##-
#------------#--#-#--#-#---#--#--##--#--#---##-#---#-------#-#--#----------#-#--------#-#------#--#-
#--#-#--#-#--#----------#--#----####-#---#--------####-----#--#-----#-####-#---##-#-#--#--#--#----##
--#--#--------#-----#-##--#--#-##--##-#-#--#----##--###--#-#---#------#-#---#---#-#-#-#--##-------#-
#-##-####-##----#--##--#--#-#-----##---#-#-#-#--#-#--------#---##-#----#----###-###-----#----##---##
###-----##--##--#---#---#----#------##-#-----##-#---###-#----------##------###--#--------------#----
#---#--#---#--#----#----##-#---#--#--###-#---#----###-------#--#---------#------###---#####---##-#--
#--#-#--##----#-------#----#--#--##-------#------###---------#-####--##--#------#---------#-###--#--
-#-------#-----#-#-#-##---#--#--#-#----------------##----#--#----#-##---##-#----#-#---#---#-#---#--#
---#-------##--#####-##----------#-#-#-------###---#-#---#-----#---#-#--###---#----#-------#-------#
---#-#-#--#---#-------#####--####-##-##--##--##--#-##-----#-#-----#----------##-###-#--------#-##-#-
-----#-###--###---------------#--##-#--#-#-#-#-#------#-#-#---------#-##---#-#--##---#----##---#---#
-##-#-----###-#---#----###-#-------##------#---###----##----------#-------------------##-----#--#---
#----#-------#-----#-#-#-##----#----#---#---####----###--#---#-#---#----####--###--###-#-#-#-#-----#
-----#-#----#-#--#--#--#---#-#-###-#---#-###---#---#-#---#-#--------#-----##--#--------#-----#-###--
-###-#---#-#---#-#--##-#----#--#---#----##-#--#-#----#---#----#-#---#----#-#-#--##--------#------#--
-#-----#-----#-#--#-----#-#--#-#-##------#--###-##-------------------#----------##--#---#-#-#---#---
###-#-----#-#--#-#---##-----#-----##-----#------##--##-#---##--#-#-#------###-----#-#--#-##----#--#-
-#---#--#--#---------##--#---##-#---#-##-#-#-#-----##--#---#---#--#---------#---##---#---##---#-----
--#--#-#----#-#----#-#-#-#----#--#--#---##-##------##----------------#-#----#--#-----------------##-
-###-#-#------##-#-#-#--------#--#--------#-###---#-#-----##---##-##--###-----#-#--#-#------#-###---
##----#--#----##-###--###---#----#---#-#----#-----#-#-##-####--#--#-----#--#-----##--#---#----#-----
---#-----#-#-#-----------#--#-#-#--#-----#-#########--###--#---#------#---------#----##-#-----#####-
-#------#--#---#---#----##-#-#-#--#--##-#-##-#--##-#---#--#--------#-#--#-##--#----------#-##-###---
--#-#-#--------##--#-##--##-##-----#---##-#-#-#------#---#--#-----#-##-#--##-----##--------#-#--###-
-----#-------------#--#--#-#---#---#--#-##-#---#-----#--#-##-#---------#--#----------#-----#-#--#---
--##---#-------#-----#---##---##--#-#--#---##--#--------#----#--#---#-----------##------###--##----#
-#-#-#---#-----#------#---#-------##-------#--##---###-##----#--##----#----##-#--##-#--------------#
-------#--#---#-----##-#---#--#---#-####---------##-------##----------------#--#-#--#---#---#--##---
--S--#-------#-#----#-##-###---###-#-##--#----------#--#-##--#-------##-----#---##-###---#--------#-
----#--#-#--#-------#------------#----##-------#-#-------#------##-##----#--#----#----##--#--##----#
#-----#--#------#-#-#-#--#--#-----#-##--###-----#-#--------#-#-------#--#-------##-##----------##---
--#--#----#--#-#--##-#----####---#-#----#---#-#-#--------#-#-#-#-###--#---##---------#-----##-#--#--
#--#-#-----##--#--##--#----#---------#-#---#----#--#-----##--##----##-----#-#--#--------#----##-#---
---#---##-###-##-##-#--###--##----#--#-#-#--#----###--#----#---##----##-#-#---------#-#-##------##--
-##----------------###--####---##---#--#----#-----###-##--##-#-#-#----#------##-#--#-----#-#--#-#-##
#---------##-----#-------###---#-#---#----###-#---#-#----##---#--##-----#-#------#--##---#--#-#----#
----#---###--###-#--#----------##--#----##--#--#---#-##---##---#-#-#-##---#------####----#-#--------
#----##-#--#---#-#---##---##---------#------#--##-------#----#---##-#----#--------#-###----#-###---#
-#-------##----###-#E#-#-----#--###---#---#-----#-#-#------##-#---#-#-#-##---#--#-##-----##-------#-
#-#---#-#--###-#--##-#----#----#---#-------#-#-----##-##------#-###-----#--##----------###----#-----
--#---##--##---#--#---------##-#--#---#-------##-#--#-##--#----#----###------#-------#---##---##-#--
-----#-----##--##---------#-----#--#-#----#---#-----#-----##---#-#-#-#---###-#--------------######--
-------#--#----#----#-#-##------##---##--#---#--#-##----##--#----------##-------###------#----#-----
-##-----#---------##---#----#-#--#-##-----##-#-#-----#------##-#----##--##--###------#-#-------####-
--##-#---#--##-##-#-#-------##-##--#------#-##---#------###-##-#--##--#--#-#---#----#----#-#--##----
------#--#----#--#--#---#----##--#-##-------------#----##-#--------#--#--#---------#--#---#--#-#---#
------------#-#---#---#--------#-#-#---##----#--#--###---##--#----#---##--##--#------#--#--#----##--
--###-------##-#-##-----#--#--##-#----##--#--------#------#---###-##----#-#--------#-------##-#-##-#
---###--#-#---#---##--#----------##---#-##----#-----###-#--#-#---#--#---#-##-#----#-###---##--#-----
#----#-#--#--####--#-#--#-###-#------#---------#--#--#--##-#--#----#-------###-----#--#-----------#-
--#-------##--#----#---##--#-----#-------#-----#--##------##---#-#--####--#-#------##----##--#-----#
----##------#---------#----#---#-#---#----------------#----------#-----#-##--###----#----#--#------#
###-#-#-----####-#-#----#-##--------#----------#------#--##-#-##----#####-#---###----#---#-----##-#-
--#---------#-#------###---------#--#------#--#--##-#---#--#--##---#--#-#---#-#--####-##--#------##-
--##-#-----###-#----#-----#--------#-#-------------##--#------##---#-##--#---#--###-#--#--#-###-#---
--------###-#-#-------#-##----------#------#-#------#####----#---#---------------#---#-----#-##-#---
--#---##---#---#--#--#--#---#---#-----#-##-------------#--##-#--##-#-#----#-#------#---------##----#
-#--------------#--##-----#-#--#--#----#----#--#-##--#-#--##-----#-#----------#--#-----#-##---------
------#-----#--####--#------###--#--#----------#-------######-#--#--------###-##----#---#------#----
##---#---##----##--##-#---#---------##---###--#--###--#-----#-###-------#---##--#-----#-##-##---#-##
--#-----#-#-----#----#---#---#----##-#---##-----###----#---#--##-##----#--------#-#-----------#--#--
--------##----#---#-#-#--#-####---#--#--#-#-#-#---###-###-#--##-------#----#---#----------#----#-###
#-----#-------##--#-#-#-------#-##-#----#-------#--#------##----#--#-###--#--#---##--#----#-#---#-##
#-##-#-##---#--#-------####--#####-#--##-------#--##-#-#-#---###-#--###-###--#---#----##----#--#-##-
--##--###-----##-----#--##--#--#--###----#----#-----#--------##-------#---#--#-#--------#-####----#-
-#----###----#-#----#-----#-----#--#------#------#--------------######---#---##---##-----#--#-----##
#------#-##----#-----#----##----#-----##--##------#-----#---##--------------#----------#-##---------
-------#-##----#----#-#-#--#----#----#-#--#-----##---#-##------#---#----------------------#-###---#-
--####-#--#--#---#------#--#-#-#--#-##-##---#---#-#---#-###--#--------#---##---#-##-#----#--##--#-#-
------#---------#-##--#--#-#----#----#-##----#--------------#---------------#---#----#--#----##-----
-----##---###-----#---#-#-----##---##-#----###----#------#------##-#----#----#--#-----#------#-#----
#----####---#---#-------##----------------------------####--#-----#--#----#--##-#--#--#-----##----#-
#---#---#--#---###----#--###-----#-#-----#--------##--#-#------##-###-#-######----#--##-##-#-#----#-
-##--##---##-#-#-------#----##---#--##-####----#---##---#-----#--#-------------#------#---##--------
###-#####--#---#--#-----##-###-#----#-#---#---------####--##----##---#----#-#---------#----#---##-##
----####----#----#-##-----------#-##----##-----#-#--###----#####--####----##-----#---------#----##-#
-#-------#----#----#-#--#-#-#-----#---#--#--------##-#-##-##---##-------##--###-#----#------#-##----
------##----#-#--#---#-#-#--#--#--#-----------#--------#-##-------#--##--##------#----##-#--#--#----
-#--#-###----###-##-#----#-##---#-#-##--#-##--##--#-#-##-------------##--##--#-#--#-#--#-#------###-
-------#--#----------#------#------#---##--###-#----------#-#-#-----#----#--#--#--#---#------#-----#
--#-------#-----#--#------#--##----#-----###-------#-##----#-----#------#--------#--#---#-#------#-#
-#-----#-#----##----##-####--#-#-#-###------##--#---##----##--#------#-------#--#--#---------#-#-###
---#-##------#-----#--##-###----#--##----#--#--##----##---#--#---#-###--------#--#-#-##-##----#-----
-------##--###---#------##-#-#-##--###---##-#--#--------#####-------##---#--#--#-##-#-----#----#----
##--#-----##--------#-------####--------------#------#-------------#-#----##-#--###-#-#----#-####--#
--#--#-----#---#-#-----------------------#-#----------------###-##---#--##------#-#-#----##---#--#-#
------------#---##----------###----#----#-----#--##---#--#-###--#--#-#---##-#-----------##--#------#
--------##---##-#------#----------#--#--#-#---#-#-----#--#---##-#---##--------####----#-##------##-#
##-##--######-#----###----#-#---#-#-#-#----#-------#----##---------##--#----##--#---#-----#-------##
--#-###---##-##---#---##---#-----#--------###-#-#-#-#--###--------#----#----#-#--##-##----#---#-----