----------------------------------------------------------------------------------------------------
-#----#----#----#----#----#----#----#----#----#----#----#----#----#----#----#----#----#----#----#---
--##---##---##---##---##---##---##---##---##---##---##---##---##---##---##---##---##---##---##---##-
#---##---##---##---##---##---##---##---##---##---##---##---##---##---##---##---##---##---##---##---#
---##---##---##---##---##---##---##---##---##---##---##---##---##---##---##---##---##---##---##---##
----------------------------------------------------------------------------------------------------
-#----#----#----#----#----#----#----#----#----#----#----#----#----#----#----#----#----#----#----#---
--##---##---##---##---##---##---##---##---##---##---##---##---##---##---##---##---##---##---##---##-
#---##---##---##---##---##---##---##---##---##---##---##---##---##---##---##---##---##---##---##---#
---##---##---##---##---##---##---##---##---##---##---##---##---##---##---##---##---##---##---##---##
------------------------------------------------------E---------------------------------------------
-#----#----#----#----#----#----#----#----#----#----#----#----#----#----#----#----#----#----#----#---
--##---##---##---##---##---##---##---##---##---##---##---##---##---##---##---##---##---##---##---##-
#---##---##---##---##---##---##---##---##---##---##---##---##---##---##---##---##---##---##---##---#
---##---##---##---##---##---##---##---##---##---##---##---##---##---##---##---##---##---##---##---##
----------------------------------------------------------------------------------------------------
-#----#----#----#----#----#----#----#----#----#----#----#----#----#----#----#----#----#----#----#---
--##---##---##---##---##---##---##---##---##---##---##---##---##---##---##---##---##---##---##---##-
#---##---##---##---##---##---##---##---##---##---##---##---##---##---##---##---##---##---##---##---#
---##---##---##---##---##---##---##---##---##---##---##---##---##---##---##---##---##---##---##---##
----------------------------------------------------------------------------------------------------
-#----#----#----#----#----#----#----#----#----#----#----#----#----#----#----#----#----#----#----#---
--##---##---##---##---##---##---##---##---##---##---##---##---##---##---##---##---##---##---##---##-
#---##---##---##---##---##---##---##---##---##---##---##---##---##---##---##---##---##---##---##---#
---##---##---##---##---##---##---##---##---##---##---##---##---##---##---##---##---##---##---##---##
----------------------------------------------------------------------------------------------------
-#----#----#----#----#----#----#----#----#----#----#----#----#----#----#----#----#----#----#----#---
--##---##---##---##---##---##---##---##---##---##---##---##---##---##---##---##---##---##---##---##-
#---##---##---##---##---##---##---##---##---##---##---##---##---##---##---##---##---##---##---##---#
---##---##---##---##---##---##---##---##---##---##---##---##---##---##---##---##---##---##---##---##
----------------------------------------------------------------------------------------------------
-#----#----#----#----#----#----#----#----#----#----#----#----#----#----#----#----#----#----#----#---
--##---##---##---##---##---##---##---##---##---##---##---##---##---##---##---##---##---##---##---##-
#---##---##---##---##---##---##---##---##---##---##---##---##---##---##---##---##---##---##---##---#
---##---##---##---##---##---##---##---##---##---##---##---##---##---##---##---##---##---##---##---##
----------------------------------------------------------------------------------------------------
-#----#----#----#----#----#----#----#----#----#----#----#----#----#----#----#----#----#----#----#---
--##---##---##---##---##---##---##---##---##---##---##---##---##---##---##---##---##---##---##---##-
#---##---##---##---##---##---##---##---##---##---##---##---##---##---##---##---##---##---##---##---#
---##---##---##---##---##---##---##---##---##---##---##---##---##---##---##---##---##---##---##---##
----------------------------------------------------------------------------------------------------
-#----#----#----#----#----#----#----#----#----#----#----#----#----#----#----#----#----#----#----#---
--##---##---##---##---##---##---##---##---##---##---##---##---##---##---##---##---##---##---##---##-
#---##---##---##---##---##---##---##---##---##---##---##---##---##---##---##---##---##---##---##---#
---##---##---##---##---##---##---##---##---##---##---##---##---##---##---##---##---##---##---##---##
----------------------------------------------------------------------------------------------------
-#----#----#----#----#----#----#----#----#----#----#----#----#----#----#----#----#----#----#----#---
--##---##---##---##---##---##---##---##---##---##---##---##---##---##---##---##---##---##---##---##-
#---##---##---##---##---##---##---##---##---##---##---##---##---##---##---##---##---##---##---##---#
---##---##---##---##---##---##---##---##---##---##---##---##---##---##---##---##---##---##---##---##
----------------------------------------------------------------------------------------------------
-#----#----#----#----#----#----#----#----#----#----#----#----#----#----#----#----#----#----#----#---
--##---##---##---##---##---##---##---##---##---##---##---##---##---##---##---##---##---##---##---##-
#---##---##---##---##---##---##---##---##---##---##---##---##---##---##---##---##---##---##---##---#
---##---##---##---##---##---##---##---##---##---##---##---##---##---##---##---##---##---##---##---##
----------------------------------------------------------------------------------------------------
-#----#----#----#----#----#----#----#----#----#----#----#----#----#----#----#----#----#----#----#---
--##---##---##---##---##---##---##---##---##---##---##---##---##---##---##---##---##---##---##---##-
#---##---##---##---##---##---##---##---##---##---##---##---##---##---##---##---##---##---##---##---#
---##---##---##---##---##---##---##---##---##---##---##---##---##---##---##---##---##---##---##---##
----------------------------------------------------------------------------------------------------
-#----#----#----#----#----#----#----#----#----#----#----#----#----#----#----#----#----#----#----#---
--##---##---##---##---##---##---##---##---##---##---##---##---##---##---##---##---##---##---##---##-
#---##---##---##---##---##---##---##---##---##---##---##---##---##---##---##---##---##---##---##---#
---##---##---##---##---##---##---##---##-S-##---##---##---##---##---##---##---##---##---##---##---##
----------------------------------------------------------------------------------------------------
-#----#----#----#----#----#----#----#----#----#----#----#----#----#----#----#----#----#----#----#---
--##---##---##---##---##---##---##---##---##---##---##---##---##---##---##---##---##---##---##---##-
#---##---##---##---##---##---##---##---##---##---##---##---##---##---##---##---##---##---##---##---#
---##---##---##---##---##---##---##---##---##---##---##---##---##---##---##---##---##---##---##---##
----------------------------------------------------------------------------------------------------
-#----#----#----#----#----#----#----#----#----#----#----#----#----#----#----#----#----#----#----#---
--##---##---##---##---##---##---##---##---##---##---##---##---##---##---##---##---##---##---##---##-
#---##---##---##---##---##---##---##---##---##---##---##---##---##---##---##---##---##---##---##---#
---##---##---##---##---##---##---##---##---##---##---##---##---##---##---##---##---##---##---##---##
----------------------------------------------------------------------------------------------------
-#----#----#----#----#----#----#----#----#----#----#----#----#----#----#----#----#----#----#----#---
--##---##---##---##---##---##---##---##---##---##---##---##---##---##---##---##---##---##---##---##-
#---##---##---##---##---##---##---##---##---##---##---##---##---##---##---##---##---##---##---##---#
---##---##---##---##---##---##---##---##---##---##---##---##---##---##---##---##---##---##---##---##
----------------------------------------------------------------------------------------------------
-#----#----#----#----#----#----#----#----#----#----#----#----#----#----#----#----#----#----#----#---
--##---##---##---##---##---##---##---##---##---##---##---##---##---##---##---##---##---##---##---##-
#---##---##---##---##---##---##---##---##---##---##---##---##---##---##---##---##---##---##---##---#
---##---##---##---##---##---##---##---##---##---##---##---##---##---##---##---##---##---##---##---##
----------------------------------------------------------------------------------------------------
-#----#----#----#----#----#----#----#----#----#----#----#----#----#----#----#----#----#----#----#---
--##---##---##---##---##---##---##---##---##---##---##---##---##---##---##---##---##---##---##---##-
#---##---##---##---##---##---##---##---##---##---##---##---##---##---##---##---##---##---##---##---#
---##---##---##---##---##---##---##---##---##---##---##---##---##---##---##---##---##---##---##---##
----------------------------------------------------------------------------------------------------
-#----#----#----#----#----#----#----#----#----#----#----#----#----#----#----#----#----#----#----#---
--##---##---##---##---##---##---##---##---##---##---##---##---##---##---##---##---##---##---##---##-
#---##---##---##---##---##---##---##---##---##---##---##---##---##---##---##---##---##---##---##---#
---##---##---##---##---##---##---##---##---##---##---##---##---##---##---##---##---##---##---##---##
----------------------------------------------------------------------------------------------------
-#----#----#----#----#----#----#----#----#----#----#----#----#----#----#----#----#----#----#----#---
--##---##---##---##---##---##---##---##---##---##---##---##---##---##---##---##---##---##---##---##-
#---##---##---##---##---##---##---##---##---##---##---##---##---##---##---##---##---##---##---##---#
---##---##---##---##---##---##---##---##---##---##---##---##---##---##---##---##---##---##---##---##