---#----#----#----#----#----#----#----#----#----#----#----#----#----#----#----#----#----#----#----#-
-###--###--###--###--###--###--###--###--###--###--###--###--###--###--###--###--###--###--###--###-
#----#----#----#----#----#----#----#----#----#----#----#----#----#----#----#----#----#----#----#----
##---##---##---##---##---##---##---##---##---##---##---##---##---##---##---##---##---##---##---##---
#----#----#----#----#----#----#----#----#----#----#----#----#----#----#----#----#----#----#----#----
---#----#----#----#----#----#----#----#----#----#----#----#----#----#----#----#----#----#----#----#-
-###--###--###--###--###--###--###--###--###--###--###--###--###--###--###--###--###--###--###--###-
#----#----#----#----#----#----#----#----#----#----#----#----#----#----#----#----#----#----#----#----
##---##---##E--##---##---##---##---##---##---##---##---##---##---##---##---##---##---##---##---##---
#----#----#----#----#----#----#----#----#----#----#----#----#----#----#----#----#----#----#----#----
---#----#----#----#----#----#----#----#----#----#----#----#----#----#----#----#----#----#----#----#-
-###--###--###--###--###--###--###--###--###--###--###--###--###--###--###--###--###--###--###--###-
#----#----#----#----#----#----#----#----#----#----#----#----#----#----#----#----#----#----#----#----
##---##---##---##---##---##---##---##---##---##---##---##---##---##---##---##---##---##---##---##---
#----#----#----#----#----#----#----#----#----#----#----#----#----#----#----#----#----#----#----#----
---#----#----#----#----#----#----#----#----#----#----#----#----#----#----#----#----#----#----#----#-
-###--###--###--###--###--###--###--###--###--###--###--###--###--###--###--###--###--###--###--###-
#----#----#----#----#----#----#----#----#----#----#----#----#----#----#----#----#----#----#----#----
##---##---##---##---##---##---##---##---##---##---##---##---##---##---##---##---##---##---##---##---
#----#----#----#----#----#----#----#----#----#----#----#----#----#----#----#----#----#----#----#----
---#----#----#----#----#----#----#----#----#----#----#----#----#----#----#----#----#----#----#----#-
-###--###--###--###--###--###--###--###--###--###--###--###--###--###--###--###--###--###--###--###-
#----#----#----#----#----#----#----#----#----#----#----#----#----#----#----#----#----#----#----#----
##---##---##---##---##---##---##---##---##---##---##---##---##---##---##---##---##---##---##---##---
#----#----#----#----#----#----#----#----#----#----#----#----#----#----#----#----#----#----#----#----
---#----#----#----#----#----#----#----#----#----#----#----#----#----#----#----#----#----#----#----#-
-###--###--###--###--###--###--###--###--###--###--###--###--###--###--###--###--###--###--###--###-
#----#----#----#----#----#----#----#----#----#----#----#----#----#----#----#----#----#----#----#----
##---##---##---##---##---##---##---##---##---##---##---##---##---##---##---##---##---##---##---##---
#----#----#----#----#----#----#----#----#----#----#----#----#----#----#----#----#----#----#----#----
---#----#----#----#----#----#----#----#----#----#----#----#----#----#----#----#----#----#----#----#-
-###--###--###--###--###--###--###--###--###--###--###--###--###--###--###--###--###--###--###--###-
#----#----#----#----#----#----#----#----#----#----#----#----#----#----#----#----#----#----#----#----
##---##---##---##---##---##---##---##---##---##---##---##---##---##---##---##---##---##---##---##---
#----#----#----#----#----#----#----#----#----#----#----#----#----#----#----#----#----#----#----#----
---#----#----#----#----#----#----#----#----#----#----#----#----#----#----#----#----#----#----#----#-
-###--###--###--###--###--###--###--###--###--###--###--###--###--###--###--###--###--###--###--###-
#----#----#----#----#----#----#----#----#----#----#----#----#----#----#----#----#----#----#----#----
##---##---##---##---##---##---##---##---##---##---##---##---##---##---##---##---##---##---##---##---
#----#----#----#----#----#----#----#----#----#----#----#----#----#----#----#----#----#----#----#----
---#----#----#----#----#----#----#----#----#----#----#----#----#----#----#----#----#----#----#----#-
-###--###--###--###--###--###--###--###--###--###--###--###--###--###--###--###--###--###--###--###-
#----#----#----#----#----#----#----#----#----#----#----#----#----#----#----#----#----#----#----#----
##---##---##---##---##---##---##---##---##---##---##---##---##---##---##---##---##---##---##---##---
#----#----#----#----#----#----#----#----#----#----#----#----#----#----#----#----#----#----#----#----
---#----#----#----#----#----#----#----#----#----#----#----#----#----#----#----#----#----#----#----#-
-###--###--###--###--###--###--###--###--###--###--###--###--###--###--###--###--###--###--###--###-
#----#----#----#----#----#----#----#----#----#----#----#----#----#----#----#----#----#----#----#----
##---##---##---##---##---##---##---##---##---##---##---##---##---##---##---##---##---##---##---##---
#----#----#----#----#----#----#----#----#----#----#----#----#----#----#----#----#----#----#----#----
---#----#----#----#----#----#----#----#----#----#----#----#----#----#----#----#----#----#----#----#-
-###--###--###--###--###--###--###--###--###--###--###--###--###--###--###--###--###--###--###--###-
#----#----#----#----#----#----#----#----#----#----#----#----#----#----#----#----#----#----#----#----
##---##---##---##---##---##---##---##---##---##---##---##---##---##---##---##---##---##---##---##---
#----#----#----#----#----#----#----#----#----#----#----#----#----#----#----#----#----#----#----#----
---#----#----#----#----#----#----#----#----#----#----#----#----#----#----#----#----#----#----#----#-
-###--###--###--###--###--###--###--###--###--###--###--###--###--###--###--###--###--###--###--###-
#----#----#----#----#----#----#----#----#----#----#----#----#----#----#----#----#----#----#----#----
##---##---##---##---##---##---##---##---##---##---##---##---##---##---##---##---##---##---##---##---
#----#----#----#----#----#----#----#----#----#----#----#----#----#----#----#----#----#----#----#----
---#----#----#----#----#----#----#----#----#----#----#----#----#----#----#----#----#----#----#----#-
-###--###--###--###--###--###--###--###--###--###--###--###--###--###--###--###--###--###--###--###-
#----#----#----#----#----#----#----#----#----#----#----#----#----#----#----#----#----#----#----#----
##---##---##---##---##---##---##---##---##---##---##---##---##---##---##---##---##---##---##---##---
#----#----#----#----#----#----#----#----#----#----#----#----#----#----#----#----#----#----#----#----
---#----#----#----#----#----#----#----#----#----#----#----#----#----#----#----#----#----#----#----#-
-###--###--###--###--###--###--###--###--###--###--###--###--###--###--###--###--###--###--###--###-
#----#----#----#----#----#----#----#----#----#----#----#----#----#----#----#----#----#----#----#----
##---##---##---##---##---##---##---##---##---##---##---##---##---##---##---##---##---##---##---##---
#----#----#----#----#----#----#----#----#----#----#----#----#----#----#----#----#----#----#----#----
---#----#----#----#----#----#----#----#----#----#----#----#----#----#----#----#----#----#----#----#-
-###--###--###--###--###--###--###--###--###--###--###--###--###--###--###--###--###--###--###--###-
#----#----#----#----#----#----#----#----#----#----#----#----#----#----#----#----#----#----#----#----
##---##---##---##---##---##---##---##---##---##---##---##---##---##---##---##---##---##---##---##---
#----#----#----#----#----#----#----#--S-#----#----#----#----#----#----#----#----#----#----#----#----
---#----#----#----#----#----#----#----#----#----#----#----#----#----#----#----#----#----#----#----#-
-###--###--###--###--###--###--###--###--###--###--###--###--###--###--###--###--###--###--###--###-
#----#----#----#----#----#----#----#----#----#----#----#----#----#----#----#----#----#----#----#----
##---##---##---##---##---##---##---##---##---##---##---##---##---##---##---##---##---##---##---##---
#----#----#----#----#----#----#----#----#----#----#----#----#----#----#----#----#----#----#----#----
---#----#----#----#----#----#----#----#----#----#----#----#----#----#----#----#----#----#----#----#-
-###--###--###--###--###--###--###--###--###--###--###--###--###--###--###--###--###--###--###--###-
#----#----#----#----#----#----#----#----#----#----#----#----#----#----#----#----#----#----#----#----
##---##---##---##---##---##---##---##---##---##---##---##---##---##---##---##---##---##---##---##---
#----#----#----#----#----#----#----#----#----#----#----#----#----#----#----#----#----#----#----#----
---#----#----#----#----#----#----#----#----#----#----#----#----#----#----#----#----#----#----#----#-
-###--###--###--###--###--###--###--###--###--###--###--###--###--###--###--###--###--###--###--###-
#----#----#----#----#----#----#----#----#----#----#----#----#----#----#----#----#----#----#----#----
##---##---##---##---##---##---##---##---##---##---##---##---##---##---##---##---##---##---##---##---
#----#----#----#----#----#----#----#----#----#----#----#----#----#----#----#----#----#----#----#----
---#----#----#----#----#----#----#----#----#----#----#----#----#----#----#----#----#----#----#----#-
-###--###--###--###--###--###--###--###--###--###--###--###--###--###--###--###--###--###--###--###-
#----#----#----#----#----#----#----#----#----#----#----#----#----#----#----#----#----#----#----#----
##---##---##---##---##---##---##---##---##---##---##---##---##---##---##---##---##---##---##---##---
#----#----#----#----#----#----#----#----#----#----#----#----#----#----#----#----#----#----#----#----
---#----#----#----#----#----#----#----#----#----#----#----#----#----#----#----#----#----#----#----#-
-###--###--###--###--###--###--###--###--###--###--###--###--###--###--###--###--###--###--###--###-
#----#----#----#----#----#----#----#----#----#----#----#----#----#----#----#----#----#----#----#----
##---##---##---##---##---##---##---##---##---##---##---##---##---##---##---##---##---##---##---##---
#----#----#----#----#----#----#----#----#----#----#----#----#----#----#----#----#----#----#----#----