--#----#----#----#----#----#----#----#----#----#----#----#----#----#----#----#----#----#----#----#--
#----#----#----#----#----#----#----#----#----#----#----#----#----#----#----#----#----#----#----#----
##---##---##---##---##---##---##---##---##---##---##---##---##---##---##---##---##---##---##---##---
----#----#----#----#----#----#----#----#----#----#----#----#----#----#----#----#----#----#----#----#
#--#-#--#-#--#-#--#-#--#-#--#-#--#-#--#-#--#-#--#-#--#-#--#-#--#-#--#-#--#-#--#-#--#-#--#-#--#-#--#-
--#----#----#----#----#----#----#----#----#----#----#----#----#----#----#----#----#----#----#----#--
#----#----#----#----#----#----#----#----#----#----#----#----#----#----#----#----#----#----#----#----
##---##---##---##---##---##---##---##---##---##---##---##---##---##---##---##---##---##---##---##---
----#----#----#----#----#----#----#----#----#----#----#----#----#----#----#----#----#----#----#----#
#--#-#--#-#--#-#--#-#--#-#--#-#--#-#--#-#--#-#--#-#--#-#--#-#--#-#--#-#--#-#--#-#--#-#--#-#--#-#--#-
--#----#----#----#----#----#----#----#----#----#----#----#----#----#----#----#----#----#----#----#--
#----#----#----#----#----#----#----#----#----#----#----#----#----#----#----#----#----#----#----#----
##---##---##---##---##---##---##---##---##---##---##---##---##---##---##---##---##---##---##---##---
----#----#----#----#----#----#----#----#----#----#----#----#----#----#----#----#----#----#----#----#
#--#-#--#-#--#-#--#-#--#-#--#-#--#-#--#-#--#-#--#-#--#-#--#-#--#-#--#-#--#-#--#-#--#-#--#-#--#-#--#-
--#----#----#----#----#----#----#----#----#----#----#----#----#----#----#----#----#----#----#----#--
#----#----#----#----#----#----#----#----#----#----#----#----#----#----#----#----#----#----#----#----
##---##---##---##---##---##---##---##---##---##---##---##---##---##---##---##---##---##---##---##---
----#----#----#----#----#----#----#----#----#----#----#----#----#----#----#----#----#----#----#----#
#--#-#--#-#--#-#--#-#--#-#--#-#--#-#--#-#--#-#--#-#--#-#--#-#--#-#--#-#--#-#--#-#--#-#--#-#--#-#--#-
--#----#----#----#----#----#----#----#----#----#----#----#----#----#----#----#----#----#----#----#--
#----#----#----#----#----#----#----#----#----#----#----#----#----#----#----#----#----#----#----#----
##---##---##---##---##---##---##-E-##---##---##---##---##---##---##---##---##---##---##---##---##---
----#----#----#----#----#----#----#----#----#----#----#----#----#----#----#----#----#----#----#----#
#--#-#--#-#--#-#--#-#--#-#--#-#--#-#--#-#--#-#--#-#--#-#--#-#--#-#--#-#--#-#--#-#--#-#--#-#--#-#--#-
--#----#----#----#----#----#----#----#----#----#----#----#----#----#----#----#----#----#----#----#--
#----#----#----#----#----#----#----#----#----#----#----#----#----#----#----#----#----#----#----#----
##---##---##---##---##---##---##---##---##---##---##---##---##---##---##---##---##---##---##---##---
----#----#----#----#----#----#----#----#----#----#----#----#----#----#----#----#----#----#----#----#
#--#-#--#-#--#-#--#-#--#-#--#-#--#-#--#-#--#-#--#-#--#-#--#-#--#-#--#-#--#-#--#-#--#-#--#-#--#-#--#-
--#----#----#----#----#----#----#----#----#----#----#----#----#----#----#----#----#----#----#----#--
#----#----#----#----#----#----#----#----#----#----#----#----#----#----#----#----#----#----#----#----
##---##---##---##---##---##---##---##---##---##---##---##---##---##---##---##---##---##---##---##---
----#----#----#----#----#----#----#----#----#----#----#----#----#----#----#----#----#----#----#----#
#--#-#--#-#--#-#--#-#--#-#--#-#--#-#--#-#--#-#--#-#--#-#--#-#--#-#--#-#--#-#--#-#-S#-#--#-#--#-#--#-
--#----#----#----#----#----#----#----#----#----#----#----#----#----#----#----#----#----#----#----#--
#----#----#----#----#----#----#----#----#----#----#----#----#----#----#----#----#----#----#----#----
##---##---##---##---##---##---##---##---##---##---##---##---##---##---##---##---##---##---##---##---
----#----#----#----#----#----#----#----#----#----#----#----#----#----#----#----#----#----#----#----#
#--#-#--#-#--#-#--#-#--#-#--#-#--#-#--#-#--#-#--#-#--#-#--#-#--#-#--#-#--#-#--#-#--#-#--#-#--#-#--#-
--#----#----#----#----#----#----#----#----#----#----#----#----#----#----#----#----#----#----#----#--
#----#----#----#----#----#----#----#----#----#----#----#----#----#----#----#----#----#----#----#----
##---##---##---##---##---##---##---##---##---##---##---##---##---##---##---##---##---##---##---##---
----#----#----#----#----#----#----#----#----#----#----#----#----#----#----#----#----#----#----#----#
#--#-#--#-#--#-#--#-#--#-#--#-#--#-#--#-#--#-#--#-#--#-#--#-#--#-#--#-#--#-#--#-#--#-#--#-#--#-#--#-
--#----#----#----#----#----#----#----#----#----#----#----#----#----#----#----#----#----#----#----#--
#----#----#----#----#----#----#----#----#----#----#----#----#----#----#----#----#----#----#----#----
##---##---##---##---##---##---##---##---##---##---##---##---##---##---##---##---##---##---##---##---
----#----#----#----#----#----#----#----#----#----#----#----#----#----#----#----#----#----#----#----#
#--#-#--#-#--#-#--#-#--#-#--#-#--#-#--#-#--#-#--#-#--#-#--#-#--#-#--#-#--#-#--#-#--#-#--#-#--#-#--#-
--#----#----#----#----#----#----#----#----#----#----#----#----#----#----#----#----#----#----#----#--
#----#----#----#----#----#----#----#----#----#----#----#----#----#----#----#----#----#----#----#----
##---##---##---##---##---##---##---##---##---##---##---##---##---##---##---##---##---##---##---##---
----#----#----#----#----#----#----#----#----#----#----#----#----#----#----#----#----#----#----#----#
#--#-#--#-#--#-#--#-#--#-#--#-#--#-#--#-#--#-#--#-#--#-#--#-#--#-#--#-#--#-#--#-#--#-#--#-#--#-#--#-
--#----#----#----#----#----#----#----#----#----#----#----#----#----#----#----#----#----#----#----#--
#----#----#----#----#----#----#----#----#----#----#----#----#----#----#----#----#----#----#----#----
##---##---##---##---##---##---##---##---##---##---##---##---##---##---##---##---##---##---##---##---
----#----#----#----#----#----#----#----#----#----#----#----#----#----#----#----#----#----#----#----#
#--#-#--#-#--#-#--#-#--#-#--#-#--#-#--#-#--#-#--#-#--#-#--#-#--#-#--#-#--#-#--#-#--#-#--#-#--#-#--#-
--#----#----#----#----#----#----#----#----#----#----#----#----#----#----#----#----#----#----#----#--
#----#----#----#----#----#----#----#----#----#----#----#----#----#----#----#----#----#----#----#----
##---##---##---##---##---##---##---##---##---##---##---##---##---##---##---##---##---##---##---##---
----#----#----#----#----#----#----#----#----#----#----#----#----#----#----#----#----#----#----#----#
#--#-#--#-#--#-#--#-#--#-#--#-#--#-#--#-#--#-#--#-#--#-#--#-#--#-#--#-#--#-#--#-#--#-#--#-#--#-#--#-
--#----#----#----#----#----#----#----#----#----#----#----#----#----#----#----#----#----#----#----#--
#----#----#----#----#----#----#----#----#----#----#----#----#----#----#----#----#----#----#----#----
##---##---##---##---##---##---##---##---##---##---##---##---##---##---##---##---##---##---##---##---
----#----#----#----#----#----#----#----#----#----#----#----#----#----#----#----#----#----#----#----#
#--#-#--#-#--#-#--#-#--#-#--#-#--#-#--#-#--#-#--#-#--#-#--#-#--#-#--#-#--#-#--#-#--#-#--#-#--#-#--#-
--#----#----#----#----#----#----#----#----#----#----#----#----#----#----#----#----#----#----#----#--
#----#----#----#----#----#----#----#----#----#----#----#----#----#----#----#----#----#----#----#----
##---##---##---##---##---##---##---##---##---##---##---##---##---##---##---##---##---##---##---##---
----#----#----#----#----#----#----#----#----#----#----#----#----#----#----#----#----#----#----#----#
#--#-#--#-#--#-#--#-#--#-#--#-#--#-#--#-#--#-#--#-#--#-#--#-#--#-#--#-#--#-#--#-#--#-#--#-#--#-#--#-
--#----#----#----#----#----#----#----#----#----#----#----#----#----#----#----#----#----#----#----#--
#----#----#----#----#----#----#----#----#----#----#----#----#----#----#----#----#----#----#----#----
##---##---##---##---##---##---##---##---##---##---##---##---##---##---##---##---##---##---##---##---
----#----#----#----#----#----#----#----#----#----#----#----#----#----#----#----#----#----#----#----#
#--#-#--#-#--#-#--#-#--#-#--#-#--#-#--#-#--#-#--#-#--#-#--#-#--#-#--#-#--#-#--#-#--#-#--#-#--#-#--#-
--#----#----#----#----#----#----#----#----#----#----#----#----#----#----#----#----#----#----#----#--
#----#----#----#----#----#----#----#----#----#----#----#----#----#----#----#----#----#----#----#----
##---##---##---##---##---##---##---##---##---##---##---##---##---##---##---##---##---##---##---##---
----#----#----#----#----#----#----#----#----#----#----#----#----#----#----#----#----#----#----#----#
#--#-#--#-#--#-#--#-#--#-#--#-#--#-#--#-#--#-#--#-#--#-#--#-#--#-#--#-#--#-#--#-#--#-#--#-#--#-#--#-
--#----#----#----#----#----#----#----#----#----#----#----#----#----#----#----#----#----#----#----#--
#----#----#----#----#----#----#----#----#----#----#----#----#----#----#----#----#----#----#----#----
##---##---##---##---##---##---##---##---##---##---##---##---##---##---##---##---##---##---##---##---
----#----#----#----#----#----#----#----#----#----#----#----#----#----#----#----#----#----#----#----#
#--#-#--#-#--#-#--#-#--#-#--#-#--#-#--#-#--#-#--#-#--#-#--#-#--#-#--#-#--#-#--#-#--#-#--#-#--#-#--#-
--#----#----#----#----#----#----#----#----#----#----#----#----#----#----#----#----#----#----#----#--
#----#----#----#----#----#----#----#----#----#----#----#----#----#----#----#----#----#----#----#----
##---##---##---##---##---##---##---##---##---##---##---##---##---##---##---##---##---##---##---##---
----#----#----#----#----#----#----#----#----#----#----#----#----#----#----#----#----#----#----#----#
#--#-#--#-#--#-#--#-#--#-#--#-#--#-#--#-#--#-#--#-#--#-#--#-#--#-#--#-#--#-#--#-#--#-#--#-#--#-#--#-
--#----#----#----#----#----#----#----#----#----#----#----#----#----#----#----#----#----#----#----#--
#----#----#----#----#----#----#----#----#----#----#----#----#----#----#----#----#----#----#----#----
##---##---##---##---##---##---##---##---##---##---##---##---##---##---##---##---##---##---##---##---
----#----#----#----#----#----#----#----#----#----#----#----#----#----#----#----#----#----#----#----#
#--#-#--#-#--#-#--#-#--#-#--#-#--#-#--#-#--#-#--#-#--#-#--#-#--#-#--#-#--#-#--#-#--#-#--#-#--#-#--#-