##-#-##-#-##-#-##-#-##-#-##-#-##-#-##-#-##-#-##-#-##-#-##-#-##-#-##-#-##-#-##-#-##-#-##-#-##-#-##-#-
--#----#----#----#----#----#----#----#----#----#----#----#----#----#----#----#----#----#----#----#--
----------------------------------------------------------------------------------------------------
-#----#----#----#----#----#----#----#----#----#----#----#----#----#----#----#----#----#----#----#---
#-#--#-#--#-#--#-#--#-#--#-#--#-#--#-#--#-#--#-#--#-#--#-#--#-#--#-#--#-#--#-#--#-#--#-#--#-#--#-#--
##-#-##-#-##-#-##-#-##-#-##-#-##-#-##-#-##-#-##-#-##-#-##-#-##-#-##-#-##-#-##-#-##-#-##-#-##-#-##-#-
--#----#----#----#S---#----#----#----#----#----#----#----#----#----#----#----#----#----#----#----#--
----------------------------------------------------------------------------------------------------
-#----#----#----#----#----#----#----#----#----#----#----#----#----#----#----#----#----#----#----#---
#-#--#-#--#-#--#-#--#-#--#-#--#-#--#-#--#-#--#-#--#-#--#-#--#-#--#-#--#-#--#-#--#-#--#-#--#-#--#-#--
##-#-##-#-##-#-##-#-##-#-##-#-##-#-##-#-##-#-##-#-##-#-##-#-##-#-##-#-##-#-##-#-##-#-##-#-##-#-##-#-
--#----#----#----#----#----#----#----#----#----#----#----#----#----#----#----#----#----#----#----#--
----------------------------------------------------------------------------------------------------
-#----#----#----#----#----#----#----#----#----#----#----#----#----#----#----#----#----#----#----#---
#-#--#-#--#-#--#-#--#-#--#-#--#-#--#-#--#-#--#-#--#-#--#-#--#-#--#-#--#-#--#-#--#-#--#-#--#-#--#-#--
##-#-##-#-##-#-##-#-##-#-##-#-##-#-##-#-##-#-##-#-##-#-##-#-##-#-##-#-##-#-##-#-##-#-##-#-##-#-##-#-
--#----#----#----#----#----#----#----#----#----#----#----#----#----#----#----#----#----#----#----#--
----------------------------------------------------------------------------------------------------
-#----#----#----#----#----#----#----#----#----#----#----#----#----#----#----#----#----#----#----#---
#-#--#-#--#-#--#-#--#-#--#-#--#-#--#-#--#-#--#-#--#-#--#-#--#-#--#-#--#-#--#-#--#-#--#-#--#-#--#-#--
##-#-##-#-##-#-##-#-##-#-##-#-##-#-##-#-##-#-##-#-##-#-##-#-##-#-##-#-##-#-##-#-##-#-##-#-##-#-##-#-
--#----#----#----#----#----#----#----#----#----#----#----#----#----#----#----#----#----#----#----#--
----------------------------------------------------------------------------------------------------
-#----#----#----#----#----#----#----#----#----#----#----#----#----#----#----#----#----#----#----#---
#-#--#-#--#-#--#-#--#-#--#-#--#-#--#-#--#-#--#-#--#-#--#-#--#-#--#-#--#-#--#-#--#-#--#-#--#-#--#-#--
##-#-##-#-##-#-##-#-##-#-##-#-##-#-##-#-##-#-##-#-##-#-##-#-##-#-##-#-##-#-##-#-##-#-##-#-##-#-##-#-
--#----#----#----#----#----#----#----#----#----#----#----#----#----#----#----#----#----#----#----#--
----------------------------------------------------------------------------------------------------
-#----#----#----#----#----#----#----#----#----#----#----#----#----#----#----#----#----#----#----#---
#-#--#-#--#-#--#-#--#-#--#-#--#-#--#-#--#-#--#-#--#-#--#-#--#-#--#-#--#-#--#-#--#-#--#-#--#-#--#-#--
##-#-##-#-##-#-##-#-##-#-##-#-##-#-##-#-##-#-##-#-##-#-##-#-##-#-##-#-##-#-##-#-##-#-##-#-##-#-##-#-
--#----#----#----#----#----#----#----#----#----#----#----#----#----#----#----#----#----#----#----#--
----------------------------------------------------------------------------------------------------
-#----#----#----#----#----#----#----#----#----#----#----#----#----#----#----#----#----#----#----#---
#-#--#-#--#-#--#-#--#-#--#-#--#-#--#-#--#-#--#-#--#-#--#-#--#-#--#-#--#-#--#-#--#-#--#-#--#-#--#-#--
##-#-##-#-##-#-##-#-##-#-##-#-##-#-##-#-##-#-##-#-##-#-##-#-##-#-##-#-##-#-##-#-##-#-##-#-##-#-##-#-
--#----#----#----#----#----#----#----#----#----#----#----#----#----#----#----#----#----#----#----#--
----------------------------------------------------------------------------------------------------
-#----#----#----#---E#----#----#----#----#----#----#----#----#----#----#----#----#----#----#----#---
#-#--#-#--#-#--#-#--#-#--#-#--#-#--#-#--#-#--#-#--#-#--#-#--#-#--#-#--#-#--#-#--#-#--#-#--#-#--#-#--
##-#-##-#-##-#-##-#-##-#-##-#-##-#-##-#-##-#-##-#-##-#-##-#-##-#-##-#-##-#-##-#-##-#-##-#-##-#-##-#-
--#----#----#----#----#----#----#----#----#----#----#----#----#----#----#----#----#----#----#----#--
----------------------------------------------------------------------------------------------------
-#----#----#----#----#----#----#----#----#----#----#----#----#----#----#----#----#----#----#----#---
#-#--#-#--#-#--#-#--#-#--#-#--#-#--#-#--#-#--#-#--#-#--#-#--#-#--#-#--#-#--#-#--#-#--#-#--#-#--#-#--
##-#-##-#-##-#-##-#-##-#-##-#-##-#-##-#-##-#-##-#-##-#-##-#-##-#-##-#-##-#-##-#-##-#-##-#-##-#-##-#-
--#----#----#----#----#----#----#----#----#----#----#----#----#----#----#----#----#----#----#----#--
----------------------------------------------------------------------------------------------------
-#----#----#----#----#----#----#----#----#----#----#----#----#----#----#----#----#----#----#----#---
#-#--#-#--#-#--#-#--#-#--#-#--#-#--#-#--#-#--#-#--#-#--#-#--#-#--#-#--#-#--#-#--#-#--#-#--#-#--#-#--
##-#-##-#-##-#-##-#-##-#-##-#-##-#-##-#-##-#-##-#-##-#-##-#-##-#-##-#-##-#-##-#-##-#-##-#-##-#-##-#-
--#----#----#----#----#----#----#----#----#----#----#----#----#----#----#----#----#----#----#----#--
----------------------------------------------------------------------------------------------------
-#----#----#----#----#----#----#----#----#----#----#----#----#----#----#----#----#----#----#----#---
#-#--#-#--#-#--#-#--#-#--#-#--#-#--#-#--#-#--#-#--#-#--#-#--#-#--#-#--#-#--#-#--#-#--#-#--#-#--#-#--
##-#-##-#-##-#-##-#-##-#-##-#-##-#-##-#-##-#-##-#-##-#-##-#-##-#-##-#-##-#-##-#-##-#-##-#-##-#-##-#-
--#----#----#----#----#----#----#----#----#----#----#----#----#----#----#----#----#----#----#----#--
----------------------------------------------------------------------------------------------------
-#----#----#----#----#----#----#----#----#----#----#----#----#----#----#----#----#----#----#----#---
#-#--#-#--#-#--#-#--#-#--#-#--#-#--#-#--#-#--#-#--#-#--#-#--#-#--#-#--#-#--#-#--#-#--#-#--#-#--#-#--
##-#-##-#-##-#-##-#-##-#-##-#-##-#-##-#-##-#-##-#-##-#-##-#-##-#-##-#-##-#-##-#-##-#-##-#-##-#-##-#-
--#----#----#----#----#----#----#----#----#----#----#----#----#----#----#----#----#----#----#----#--
----------------------------------------------------------------------------------------------------
-#----#----#----#----#----#----#----#----#----#----#----#----#----#----#----#----#----#----#----#---
#-#--#-#--#-#--#-#--#-#--#-#--#-#--#-#--#-#--#-#--#-#--#-#--#-#--#-#--#-#--#-#--#-#--#-#--#-#--#-#--
##-#-##-#-##-#-##-#-##-#-##-#-##-#-##-#-##-#-##-#-##-#-##-#-##-#-##-#-##-#-##-#-##-#-##-#-##-#-##-#-
--#----#----#----#----#----#----#----#----#----#----#----#----#----#----#----#----#----#----#----#--
----------------------------------------------------------------------------------------------------
-#----#----#----#----#----#----#----#----#----#----#----#----#----#----#----#----#----#----#----#---
#-#--#-#--#-#--#-#--#-#--#-#--#-#--#-#--#-#--#-#--#-#--#-#--#-#--#-#--#-#--#-#--#-#--#-#--#-#--#-#--
##-#-##-#-##-#-##-#-##-#-##-#-##-#-##-#-##-#-##-#-##-#-##-#-##-#-##-#-##-#-##-#-##-#-##-#-##-#-##-#-
--#----#----#----#----#----#----#----#----#----#----#----#----#----#----#----#----#----#----#----#--
----------------------------------------------------------------------------------------------------
-#----#----#----#----#----#----#----#----#----#----#----#----#----#----#----#----#----#----#----#---
#-#--#-#--#-#--#-#--#-#--#-#--#-#--#-#--#-#--#-#--#-#--#-#--#-#--#-#--#-#--#-#--#-#--#-#--#-#--#-#--
##-#-##-#-##-#-##-#-##-#-##-#-##-#-##-#-##-#-##-#-##-#-##-#-##-#-##-#-##-#-##-#-##-#-##-#-##-#-##-#-
--#----#----#----#----#----#----#----#----#----#----#----#----#----#----#----#----#----#----#----#--
----------------------------------------------------------------------------------------------------
-#----#----#----#----#----#----#----#----#----#----#----#----#----#----#----#----#----#----#----#---
#-#--#-#--#-#--#-#--#-#--#-#--#-#--#-#--#-#--#-#--#-#--#-#--#-#--#-#--#-#--#-#--#-#--#-#--#-#--#-#--
##-#-##-#-##-#-##-#-##-#-##-#-##-#-##-#-##-#-##-#-##-#-##-#-##-#-##-#-##-#-##-#-##-#-##-#-##-#-##-#-
--#----#----#----#----#----#----#----#----#----#----#----#----#----#----#----#----#----#----#----#--
----------------------------------------------------------------------------------------------------
-#----#----#----#----#----#----#----#----#----#----#----#----#----#----#----#----#----#----#----#---
#-#--#-#--#-#--#-#--#-#--#-#--#-#--#-#--#-#--#-#--#-#--#-#--#-#--#-#--#-#--#-#--#-#--#-#--#-#--#-#--
##-#-##-#-##-#-##-#-##-#-##-#-##-#-##-#-##-#-##-#-##-#-##-#-##-#-##-#-##-#-##-#-##-#-##-#-##-#-##-#-
--#----#----#----#----#----#----#----#----#----#----#----#----#----#----#----#----#----#----#----#--
----------------------------------------------------------------------------------------------------
-#----#----#----#----#----#----#----#----#----#----#----#----#----#----#----#----#----#----#----#---
#-#--#-#--#-#--#-#--#-#--#-#--#-#--#-#--#-#--#-#--#-#--#-#--#-#--#-#--#-#--#-#--#-#--#-#--#-#--#-#--
##-#-##-#-##-#-##-#-##-#-##-#-##-#-##-#-##-#-##-#-##-#-##-#-##-#-##-#-##-#-##-#-##-#-##-#-##-#-##-#-
--#----#----#----#----#----#----#----#----#----#----#----#----#----#----#----#----#----#----#----#--
----------------------------------------------------------------------------------------------------
-#----#----#----#----#----#----#----#----#----#----#----#----#----#----#----#----#----#----#----#---
#-#--#-#--#-#--#-#--#-#--#-#--#-#--#-#--#-#--#-#--#-#--#-#--#-#--#-#--#-#--#-#--#-#--#-#--#-#--#-#--
##-#-##-#-##-#-##-#-##-#-##-#-##-#-##-#-##-#-##-#-##-#-##-#-##-#-##-#-##-#-##-#-##-#-##-#-##-#-##-#-
--#----#----#----#----#----#----#----#----#----#----#----#----#----#----#----#----#----#----#----#--
----------------------------------------------------------------------------------------------------
-#----#----#----#----#----#----#----#----#----#----#----#----#----#----#----#----#----#----#----#---
#-#--#-#--#-#--#-#--#-#--#-#--#-#--#-#--#-#--#-#--#-#--#-#--#-#--#-#--#-#--#-#--#-#--#-#--#-#--#-#--