-###--###--###--###--###--###--###--###--###--###--###--###--###--###--###--###--###--###--###--###-
---##---##---##---##---##--S##---##---##---##---##---##---##---##---##---##---##---##---##---##---##
#----#----#----#----#----#----#----#----#----#----#----#----#----#----#----#----#----#----#----#----
----------------------------------------------------------------------------------------------------
-##---##---##---##---##---##---##---##---##---##---##---##---##---##---##---##---##---##---##---##--
-###--###--###--###--###--###--###--###--###--###--###--###--###--###--###--###--###--###--###--###-
---##---##---##---##---##---##---##---##---##---##---##---##---##---##---##---##---##---##---##---##
#----#----#----#----#----#----#----#----#----#----#----#----#----#----#----#----#----#----#----#----
----------------------------------------------------------------------------------------------------
-##---##---##---##---##---##---##---##---##---##---##---##---##---##---##---##---##---##---##---##--
-###--###--###--###--###--###--###--###--###--###--###--###--###--###--###--###--###--###--###--###-
---##---##---##---##---##---##---##---##---##---##---##---##---##---##---##---##---##---##---##---##
#----#----#----#----#----#----#----#----#----#----#----#----#----#----#----#----#----#----#----#----
----------------------------------------------------------------------------------------------------
-##---##---##---##---##---##---##---##---##---##---##---##---##---##---##---##---##---##---##---##--
-###--###--###--###--###--###--###--###--###--###--###--###--###--###--###--###--###--###--###--###-
---##---##---##---##---##---##---##---##---##---##---##---##---##---##---##---##---##---##---##---##
#----#----#----#----#----#----#----#----#----#----#----#----#----#----#----#----#----#----#----#----
----------------------------------------------------------------------------------------------------
-##---##---##---##---##---##---##---##---##---##---##---##---##---##---##---##---##---##---##---##--
-###--###--###--###--###--###--###--###--###--###--###--###--###--###--###--###--###--###--###--###-
---##---##---##---##---##---##---##---##---##---##---##---##---##---##---##---##---##---##---##---##
#----#----#----#----#----#----#----#----#----#----#----#----#----#----#----#----#----#----#----#----
----------------------------------------------------------------------------------------------------
-##---##---##---##---##---##---##---##---##---##---##---##---##---##---##---##---##---##---##---##--
-###--###--###--###--###--###--###--###--###--###--###--###--###--###--###--###--###--###--###--###-
---##---##---##---##---##---##---##---##---##---##---##---##---##---##---##---##---##---##---##---##
#----#----#----#----#----#----#----#----#----#----#----#----#----#----#----#----#----#----#----#----
----------------------------------------------------------------------------------------------------
-##---##---##---##---##---##---##---##---##---##---##---##---##---##---##---##---##---##---##---##--
-###--###--###--###--###--###--###--###--###--###--###--###--###--###--###--###--###--###--###--###-
---##---##---##---##---##---##---##---##---##---##---##---##---##---##---##---##---##---##---##---##
#----#----#----#----#----#----#----#----#----#----#----#----#----#----#----#----#----#----#----#----
----------------------------------------------------------------------------------------------------
-##---##---##---##---##---##---##---##---##---##---##---##---##---##---##---##---##---##---##---##--
-###--###--###--###--###--###--###--###--###--###--###--###--###--###--###--###--###--###--###--###-
---##---##---##---##---##---##---##---##---##---##---##---##---##---##---##---##---##---##---##---##
#----#----#----#----#----#----#----#----#----#----#----#----#----#----#----#----#----#----#----#----
----------------------------------------------------------------------------------------------------
-##---##---##---##---##---##---##---##---##---##---##---##---##---##---##---##---##---##---##---##--
-###--###--###--###--###--###--###--###--###--###--###--###--###--###--###--###--###--###--###--###-
---##---##---##---##---##---##---##---##---##---##---##---##---##---##---##---##---##---##---##---##
#----#----#----#----#----#----#----#----#----#----#----#----#----#----#----#----#----#----#----#----
----------------------------------------------------------------------------------------------------
-##---##---##---##---##---##---##---##---##---##---##---##---##---##---##---##---##---##---##---##--
-###--###--###--###--###--###--###--###--###--###--###--###--###--###--###--###--###--###--###--###-
---##---##---##---##---##---##---##---##---##---##---##---##---##---##---##---##---##---##---##---##
#----#----#----#----#----#----#----#----#----#----#----#----#----#----#----#----#----#----#----#----
----------------------------------------------------------------------------------------------------
-##---##---##---##---##---##---##---##---##---##---##---##---##---##---##---##---##---##---##---##--
-###--###--###--###--###--###--###--###--###--###--###--###--###--###--###--###--###--###--###--###-
---##---##---##---##---##---##---##---##---##---##---##---##---##---##---##---##---##---##---##---##
#----#----#----#----#----#----#----#----#----#----#----#----#----#----#----#----#----#----#----#----
----------------------------------------------------------------------------------------------------
-##---##---##---##---##---##---##---##---##---##---##---##---##---##---##---##---##---##---##---##--
-###--###--###--###--###--###--###--###--###--###--###--###--###--###--###--###--###--###--###--###-
---##---##---##---##---##---##---##---##---##---##---##---##---##---##---##---##---##---##---##---##
#----#----#----#----#----#----#----#----#----#----#----#----#----#----#----#----#----#----#----#----
----------------------------------------------------------------------------------------------------
-##---##---##---##---##---##---##---##---##---##---##---##---##---##---##---##---##---##---##---##--
-###--###--###--###--###--###--###--###--###--###--###--###--###--###--###--###--###--###--###--###-
---##---##---##---##---##---##---##---##---##---##---##---##---##---##---##---##---##---##---##---##
#----#----#----#----#----#----#----#----#----#----#----#----#----#----#----#----#----#----#----#----
----------------------------------------------------------------------------------------------------
-##---##---##---##---##---##---##---##---##---##---##---##---##---##---##---##---##---##---##---##--
-###--###--###--###--###--###--###--###--###--###--###--###--###--###--###--###--###--###--###--###-
---##---##---##---##---##---##---##---##---##---##---##---##---##---##---##---##---##---##---##---##
#----#----#----#----#----#----#----#----#----#----#----#----#----#----#----#----#----#----#----#----
----------------------------------------------------------------------------------------------------
-##---##---##---##---##---##---##---##---##---##---##---##---##---##---##---##---##---##---##---##--
-###--###--###--###--###--###--###--###--###--###--###--###--###--###--###--###--###--###--###--###-
---##---##---##---##---##---##---##---##---##---##---##---##---##---##---##---##---##---##---##---##
#----#----#----#----#----#----#----#----#----#----#----#----#----#----#----#----#----#----#----#----
----------------------------------------------------------------------------------------------------
-##---##---##---##---##---##---##---##---##---##---##---##---##---##---##---##---##---##---##---##--
-###--###--###--###--###--###--###--###--###--###--###--###--###--###--###--###--###--###--###--###-
---##---##---##---##---##---##---##---##---##---##---##---##---##---##---##---##---##---##---##---##
#----#----#----#----#----#----#----#----#----#----#----#----#----#----#----#----#----#----#----#----
----------------------------------------------------------------------------------------------------
-##---##---##---##---##---##---##---##---##---##---##---##---##---##---##---##---##---##---##---##--
-###--###--###--###--###--###--###--###--###--###--###--###--###--###--###--###--###--###--###--###-
---##---##---##---##---##---##---##---##---##---##---##---##---##---##---##---##---##---##---##---##
#----#----#----#----#----#----#----#----#----#----#----#----#----#----#----#----#----#----#----#----
----------------------------------------------------------------------------------------------------
-##---##---##---##---##---##---##---##---##---##---##---##---##---##---##---##---##---##---##---##--
-###--###--###--###--###--###--###--###--###--###--###--###--###--###--###--###--###--###--###--###-
---##---##---##---##---##---##---##---##---##---##---##---##---##---##---##-E-##---##---##---##---##
#----#----#----#----#----#----#----#----#----#----#----#----#----#----#----#----#----#----#----#----
----------------------------------------------------------------------------------------------------
-##---##---##---##---##---##---##---##---##---##---##---##---##---##---##---##---##---##---##---##--
-###--###--###--###--###--###--###--###--###--###--###--###--###--###--###--###--###--###--###--###-
---##---##---##---##---##---##---##---##---##---##---##---##---##---##---##---##---##---##---##---##
#----#----#----#----#----#----#----#----#----#----#----#----#----#----#----#----#----#----#----#----
----------------------------------------------------------------------------------------------------
-##---##---##---##---##---##---##---##---##---##---##---##---##---##---##---##---##---##---##---##--
-###--###--###--###--###--###--###--###--###--###--###--###--###--###--###--###--###--###--###--###-
---##---##---##---##---##---##---##---##---##---##---##---##---##---##---##---##---##---##---##---##
#----#----#----#----#----#----#----#----#----#----#----#----#----#----#----#----#----#----#----#----
----------------------------------------------------------------------------------------------------
-##---##---##---##---##---##---##---##---##---##---##---##---##---##---##---##---##---##---##---##--