----------------------------------------------------------------------------------------------------
-###--###--###--###--###--###--###--###--###--###--###--###--###--###--###--###--###--###--###--###-
---##---##---##---##---##---##---##---##---##---##---##---##---##---##---##---##---##---##---##---##
#----#----#----#----#----#----#----#----#----#----#----#----#----#----#----#----#----#----#----#----
----------------------------------------------------------------------------------------------------
----------------------------------------------------------------------------------------------------
-###--###--###--###--###--###--###--###--###--###--###--###--###--###--###--###--###--###--###--###-
---##---##---##---##---##---##---##---##---##---##---##---##---##---##---##---##---##---##---##---##
#----#----#----#----#----#----#----#----#----#----#----#----#----#----#----#----#----#----#----#----
----------------------------------------------------------------------------------------------------
----------------------------------------------------------------------------------------------------
-###--###--###--###--###--###--###--###--###--###--###--###--###--###--###--###--###--###--###--###-
---##---##---##---##---##---##---##---##---##---##---##---##---##---##---##---##---##---##---##---##
#----#----#----#----#----#----#----#----#----#----#----#----#----#----#----#----#----#----#----#----
----------------------------------------------------------------------------------------------------
----------------------------------------------------------------------------------------------------
-###--###--###--###--###--###--###--###--###--###--###--###--###--###--###--###--###--###--###--###-
---##---##---##---##---##---##---##---##---##---##---##---##---##---##---##---##---##---##---##---##
#----#----#----#----#----#----#----#----#----#----#----#----#----#----#----#----#----#----#----#----
----------------------------------------------------------------------------------------------------
----------------------------------------------------------------------------------------------------
-###--###--###--###--###--###--###--###--###--###--###--###--###--###--###--###--###--###--###--###-
---##---##---##---##---##---##---##---##---##---##---##---##---##---##---##---##---##---##---##---##
#----#----#----#----#----#----#----#----#----#----#----#----#----#----#----#----#----#----#----#----
----------------------------------------------------------------------------------------------------
----------------------------------------------------------------------------------------------------
-###--###--###--###--###--###--###--###--###--###--###--###--###--###--###--###--###--###--###--###-
---##---##---##---##---##---##---##---##---##---##---##---##---##---##---##---##---##---##---##---##
#----#----#----#----#----#----#----#----#----#----#----#----#----#----#----#----#----#----#----#----
----------------------------------------------------------------------------------------------------
----------------------------------------------------------------------------------------------------
-###--###--###--###--###--###--###--###--###--###--###--###--###--###--###--###--###--###--###--###-
---##---##---##---##---##---##---##---##---##---##---##---##---##---##---##---##---##---##---##---##
#----#----#----#----#----#----#----#----#----#----#----#----#----#----#----#----#----#----#----#----
----------------------------------------------------------------------------------------------------
----------------------------------------------------------------------------------------------------
-###--###--###--###--###--###--###--###--###--###--###--###--###--###--###--###--###--###--###--###-
---##---##---##---##---##---##---##---##---##---##---##---##---##---##---##---##---##---##---##---##
#----#----#----#----#----#----#----#----#----#----#----#----#----#----#----#----#----#----#----#----
----------------------------------------------------------------------------------------------------
----------------------------------------------------------------------------------------------------
-###--###--###--###--###--###--###--###--###--###--###--###--###--###--###--###--###--###--###--###-
---##---##---##---##---##---##---##---##---##---##---##---##---##---##---##---##---##---##---##---##
#----#----#----#----#----#----#----#----#----#----#----#----#----#----#----#----#----#----#----#----
----------------------------------------------------------------------------------------------------
----------------------------------------------------------------------------------------------------
-###--###--###--###--###--###--###--###--###--###--###--###--###--###--###--###--###--###--###--###-
---##---##---##---##---##---##---##---##---##---##---##---##---##---##---##---##---##---##---##---##
#----#----#----#----#----#----#----#----#----#----#----#----#----#----#----#----#----#----#----#----
----------------------------------------------------------------------------------------------------
----------------------------------------------------------------------------------------------------
-###--###--###--###--###--###--###--###--###--###--###--###--###--###--###--###--###--###--###--###-
---##---##---##---##---##---##---##---##---##---##---##---##---##---##---##---##---##---##---##---##
#----#----#----#----#----#----#----#----#----#----#----#----#----#----#----#----#----#----#----#----
----------------------------------------------------------------------------------------------------
----------------------------------------------------------------------------------------------------
-###--###--###--###--###--###--###--###--###--###--###--###--###--###--###--###--###--###--###--###-
---##---##---##---##---##---##---##---##---##---##---##---##---##---##---##---##---##---##---##---##
#----#----#----#----#----#----#----#----#----#----#----#----#----#----#----#----#----#----#----#----
----------------------------------------------------------------------------------------------------
----------------------------------------------------------------------------------------------------
-###--###--###--###--###--###--###--###--###--###--###--###--###--###--###--###--###--###--###--###-
---##---##---##---##---##---##---##---##---##---##---##---##---##---##---##---##---##---##---##---##
#----#----#----#----#----#----#----#----#----#----#----#----#----#----#----#----#----#----#----#----
----------------------------------------------------------------------------------------------------
----------------------------------------------------------------------------------------------------
-###--###--###--###--###--###--###--###--###--###--###--###--###--###--###--###--###--###--###--###-
---##---##---##---##---##---##---##---##---##---##---##---##---##---##---##---##---##---##---##---##
#----#----#----#----#----#----#----#----#----#----#----#----#----#----#----#----#----#----#----#----
----------------------------------------------------------------------------------------------------
----------------------------------------------------------------------------------------------------
-###--###--###--###--###--###--###--###--###--###--###--###--###--###--###--###--###--###--###--###-
---##---##---##---##---##---##---##---##---##-E-##---##---##---##---##---##---##---##---##---##---##
#----#----#----#----#----#----#----#----#----#----#----#----#----#----#----#----#----#----#----#----
----------------------------------------------------------------------------------------------------
----------------------------------------------------------------------------------------------------
-###--###--###--###--###--###--###--###--###--###--###--###--###--###--###--###--###--###--###--###-
---##---##---##---##---##---##---##---##---##---##---##---##---##---##---##---##---##---##---##---##
#----#----#----#----#----#----#----#----#----#----#----#----#----#----#----#----#----#----#----#----
----------------------------------------------------------------------------------------------------
----------------------------------------------------------------------------------------------------
-###--###--###--###--###--###--###--###--###--###--###--###--###--###--###--###--###--###--###--###-
---##---##---##---##---##---##---##---##---##---##---##---##---##---##---##---##---##---##---##---##
#----#----#----#----#----#----#----#----#----#----#----#----#----#----#----#----#----#----#----#----
----------------------------------------------------------------------------------------------------
----------------------------------------------------------------------------------------------------
-###--###--###--###--###--###--###--###--###--###--###--###--###--###--###--###--###--###--###--###-
---##---##---##---##---##---##---##---##---##---##---##---##---##---##---##---##---##---##---##---##
#----#----#----#----#----#----#----#----#----#----#----#----#----#----#----#----#----#----#----#----
----------------------------------------------------------------------------------------------------
----------------------------------------------------------------------------------------------------
-###--###--###--###--###--###--###--###--###--###--###--###--###--###--###--###--###--###--###--###-
---##---##---##---##---##---##---##---##---##---##---##---##---##---##---##---##---##---##---##---##
#----#----#----#----#----#----#----#----#----#----#----#----#----#---S#----#----#----#----#----#----
----------------------------------------------------------------------------------------------------
----------------------------------------------------------------------------------------------------
-###--###--###--###--###--###--###--###--###--###--###--###--###--###--###--###--###--###--###--###-
---##---##---##---##---##---##---##---##---##---##---##---##---##---##---##---##---##---##---##---##
#----#----#----#----#----#----#----#----#----#----#----#----#----#----#----#----#----#----#----#----
----------------------------------------------------------------------------------------------------