---#----#----#----#----#----#----#----#----#----#----#----#----#----#----#----#----#----#----#----#-
---##---##---##---##---##---##---##---##---##---##---##---##---##---##---##---##---##---##---##---##
----#----#----#----#----#----#----#----#----#----#----#----#----#----#----#----#----#----#----#----#
#--###--###--###--###--###--###--###--###--###--###--###--###--###--###--###--###--###--###--###--##
----------------------------------------------------------------------------------------------------
---#----#----#----#----#----#----#----#----#----#----#----#----#----#----#----#----#----#----#----#-
---##---##---##---##---##---##---##---##---##---##---##---##---##---##---##---##---##---##---##---##
----#----#----#----#----#----#----#----#----#----#----#----#----#----#----#----#----#----#----#----#
#--###--###--###--###--###--###--###--###--###--###--###--###--###--###--###--###--###--###--###--##
-------------------------------------------------S--------------------------------------------------
---#----#----#----#----#----#----#----#----#----#----#----#----#----#----#----#----#----#----#----#-
---##---##---##---##---##---##---##---##---##---##---##---##---##---##---##---##---##---##---##---##
----#----#----#----#----#----#----#----#----#----#----#----#----#----#----#----#----#----#----#----#
#--###--###--###--###--###--###--###--###--###--###--###--###--###--###--###--###--###--###--###--##
----------------------------------------------------------------------------------------------------
---#----#----#----#----#----#----#----#----#----#----#----#----#----#----#----#----#----#----#----#-
---##---##---##---##---##---##---##---##---##---##---##---##---##---##---##---##---##---##---##---##
----#----#----#----#----#----#----#----#----#----#----#----#----#----#----#----#----#----#----#----#
#--###--###--###--###--###--###--###--###--###--###--###--###--###--###--###--###--###--###--###--##
----------------------------------------------------------------------------------------------------
---#----#----#----#----#----#----#----#----#----#----#----#----#----#----#----#----#----#----#----#-
---##---##---##---##---##---##---##---##---##---##---##---##---##---##---##---##---##---##---##---##
----#----#----#----#----#----#----#----#----#----#----#----#----#----#----#----#----#----#----#----#
#--###--###--###--###--###--###--###--###--###--###--###--###--###--###--###--###--###--###--###--##
----------------------------------------------------------------------------------------------------
---#----#----#----#----#----#E---#----#----#----#----#----#----#----#----#----#----#----#----#----#-
---##---##---##---##---##---##---##---##---##---##---##---##---##---##---##---##---##---##---##---##
----#----#----#----#----#----#----#----#----#----#----#----#----#----#----#----#----#----#----#----#
#--###--###--###--###--###--###--###--###--###--###--###--###--###--###--###--###--###--###--###--##
----------------------------------------------------------------------------------------------------
---#----#----#----#----#----#----#----#----#----#----#----#----#----#----#----#----#----#----#----#-
---##---##---##---##---##---##---##---##---##---##---##---##---##---##---##---##---##---##---##---##
----#----#----#----#----#----#----#----#----#----#----#----#----#----#----#----#----#----#----#----#
#--###--###--###--###--###--###--###--###--###--###--###--###--###--###--###--###--###--###--###--##
----------------------------------------------------------------------------------------------------
---#----#----#----#----#----#----#----#----#----#----#----#----#----#----#----#----#----#----#----#-
---##---##---##---##---##---##---##---##---##---##---##---##---##---##---##---##---##---##---##---##
----#----#----#----#----#----#----#----#----#----#----#----#----#----#----#----#----#----#----#----#
#--###--###--###--###--###--###--###--###--###--###--###--###--###--###--###--###--###--###--###--##
----------------------------------------------------------------------------------------------------
---#----#----#----#----#----#----#----#----#----#----#----#----#----#----#----#----#----#----#----#-
---##---##---##---##---##---##---##---##---##---##---##---##---##---##---##---##---##---##---##---##
----#----#----#----#----#----#----#----#----#----#----#----#----#----#----#----#----#----#----#----#
#--###--###--###--###--###--###--###--###--###--###--###--###--###--###--###--###--###--###--###--##
----------------------------------------------------------------------------------------------------
---#----#----#----#----#----#----#----#----#----#----#----#----#----#----#----#----#----#----#----#-
---##---##---##---##---##---##---##---##---##---##---##---##---##---##---##---##---##---##---##---##
----#----#----#----#----#----#----#----#----#----#----#----#----#----#----#----#----#----#----#----#
#--###--###--###--###--###--###--###--###--###--###--###--###--###--###--###--###--###--###--###--##
----------------------------------------------------------------------------------------------------
---#----#----#----#----#----#----#----#----#----#----#----#----#----#----#----#----#----#----#----#-
---##---##---##---##---##---##---##---##---##---##---##---##---##---##---##---##---##---##---##---##
----#----#----#----#----#----#----#----#----#----#----#----#----#----#----#----#----#----#----#----#
#--###--###--###--###--###--###--###--###--###--###--###--###--###--###--###--###--###--###--###--##
----------------------------------------------------------------------------------------------------
---#----#----#----#----#----#----#----#----#----#----#----#----#----#----#----#----#----#----#----#-
---##---##---##---##---##---##---##---##---##---##---##---##---##---##---##---##---##---##---##---##
----#----#----#----#----#----#----#----#----#----#----#----#----#----#----#----#----#----#----#----#
#--###--###--###--###--###--###--###--###--###--###--###--###--###--###--###--###--###--###--###--##
----------------------------------------------------------------------------------------------------
---#----#----#----#----#----#----#----#----#----#----#----#----#----#----#----#----#----#----#----#-
---##---##---##---##---##---##---##---##---##---##---##---##---##---##---##---##---##---##---##---##
----#----#----#----#----#----#----#----#----#----#----#----#----#----#----#----#----#----#----#----#
#--###--###--###--###--###--###--###--###--###--###--###--###--###--###--###--###--###--###--###--##
----------------------------------------------------------------------------------------------------
---#----#----#----#----#----#----#----#----#----#----#----#----#----#----#----#----#----#----#----#-
---##---##---##---##---##---##---##---##---##---##---##---##---##---##---##---##---##---##---##---##
----#----#----#----#----#----#----#----#----#----#----#----#----#----#----#----#----#----#----#----#
#--###--###--###--###--###--###--###--###--###--###--###--###--###--###--###--###--###--###--###--##
----------------------------------------------------------------------------------------------------
---#----#----#----#----#----#----#----#----#----#----#----#----#----#----#----#----#----#----#----#-
---##---##---##---##---##---##---##---##---##---##---##---##---##---##---##---##---##---##---##---##
----#----#----#----#----#----#----#----#----#----#----#----#----#----#----#----#----#----#----#----#
#--###--###--###--###--###--###--###--###--###--###--###--###--###--###--###--###--###--###--###--##
----------------------------------------------------------------------------------------------------
---#----#----#----#----#----#----#----#----#----#----#----#----#----#----#----#----#----#----#----#-
---##---##---##---##---##---##---##---##---##---##---##---##---##---##---##---##---##---##---##---##
----#----#----#----#----#----#----#----#----#----#----#----#----#----#----#----#----#----#----#----#
#--###--###--###--###--###--###--###--###--###--###--###--###--###--###--###--###--###--###--###--##
----------------------------------------------------------------------------------------------------
---#----#----#----#----#----#----#----#----#----#----#----#----#----#----#----#----#----#----#----#-
---##---##---##---##---##---##---##---##---##---##---##---##---##---##---##---##---##---##---##---##
----#----#----#----#----#----#----#----#----#----#----#----#----#----#----#----#----#----#----#----#
#--###--###--###--###--###--###--###--###--###--###--###--###--###--###--###--###--###--###--###--##
----------------------------------------------------------------------------------------------------
---#----#----#----#----#----#----#----#----#----#----#----#----#----#----#----#----#----#----#----#-
---##---##---##---##---##---##---##---##---##---##---##---##---##---##---##---##---##---##---##---##
----#----#----#----#----#----#----#----#----#----#----#----#----#----#----#----#----#----#----#----#
#--###--###--###--###--###--###--###--###--###--###--###--###--###--###--###--###--###--###--###--##
----------------------------------------------------------------------------------------------------
---#----#----#----#----#----#----#----#----#----#----#----#----#----#----#----#----#----#----#----#-
---##---##---##---##---##---##---##---##---##---##---##---##---##---##---##---##---##---##---##---##
----#----#----#----#----#----#----#----#----#----#----#----#----#----#----#----#----#----#----#----#
#--###--###--###--###--###--###--###--###--###--###--###--###--###--###--###--###--###--###--###--##
----------------------------------------------------------------------------------------------------
---#----#----#----#----#----#----#----#----#----#----#----#----#----#----#----#----#----#----#----#-
---##---##---##---##---##---##---##---##---##---##---##---##---##---##---##---##---##---##---##---##
----#----#----#----#----#----#----#----#----#----#----#----#----#----#----#----#----#----#----#----#
#--###--###--###--###--###--###--###--###--###--###--###--###--###--###--###--###--###--###--###--##
----------------------------------------------------------------------------------------------------