###-###--------##----#----##---#-#-#------#-----##-#--#----#------#-------##----#-##-#--#-----#--#--
#----------#-------##----##----#---------#-#----##----#--###---##-#----##--#------#----#-##----#####
--#----#--##----------#-####---#--#-##---##-#-#--#--#-#--#--#------#--#----------#-#-##---#-------#-
#--------#------#---#----------#---#-----##-#--#-#---##--####-#--#--#---##----------###---------#---
--#-##----###--#------##----##-#-#-------##------#---------##-#-----#-------##---#---#---#----#--#-#
##-#----#-#-###-##-#-#-----#-#-#-###--#--#----#--#-----#-#-#--#------------#-#--#----#---#-#--#---#-
#---#--#----####----#-#-#---------####---###-----##-##---##--##-#-#-----#--#-#----#-------#--------#
-----#---------------####-#---##----##-#----------#--#---#--------#----#------------#---#-----------
#---------##-##--#--------#-#------#--#-##--E###-#------##-#-#--------##---#--#-----------##----#---
-----------#----#--#--#-------###-----##--#-###--##------##----#---##--#--#------##-##---#-#-##-----
---#---##-#------------#--#--#-##-----#----#----###---##-###-------##-#-#---#-------------#----#----
--------#--#---#-##---#-#----##---##--##-----#-#--#------#--##--#-#------##-----##------##----##-#--
--##-----##--#-#-#-------#-----#--##-----#--#--#--------#-#---#--------------#-#--#-#-##----------##
-----#---#--#-#---#--##-#---#-##-----##---#------#-----#-#-#-##--###-#---------#-#####----###---##-#
--#------#-----#-#--#-###---#-##------------#-##---#---#---#--#----#---#--##-###-##--###---#-#--###-
#-----#---#--#-#-----#-#--#####-#------#-#---##----##-##-------#-#--##--#----#-#####-##----#-----#--
##-#-------------##--------##-#----##-----##--#---#--#-##-##------#------#---#-###----##-#-###---#--
#-#-#-------#--------#--##----#-#-----#---#----#--#-----#-#--##-#-#--#-#-#--------#---#-----##-#-#--
#-----##-----#-#--#------#-------#---#---------#------#---##-----------------##--#-###----#-#---###-
#--#----##--#-##-----------##---###----#-----#--#---#--#-------#---#--------#-#---#-------#-----##-#
##--##--------#--#-#--#-#--------------###-----#---#---#------##---#-#-#-----------------###--#-----
--#--#---#---#---#-#----#-------#-----##--###-------#-----#---##--###----#####--####---------------#
#-##--##---##-##-----#---#-#--#--##--#---#-#--------#--###---###-------##-------#----##-#-##----###-
-#--#---#----##-#-#----#-----#---#--#---#-#--------#-##--#----------#-#--#-#---#-#-#--#-----#--##-#-
-####-###----------------#--#---#----#---##-#-#------##---##----#----#-#-##-##--###--####-----#---#-
------#---#-#----##--###-##-#-------#---#--------#--#--##-####----#--##------#----##----S---#--##---
#-#-#----#--###--#--#---##---#-##-#-------##--#----#--------##-----#-###----###---##-###----------#-
#---#-#-##--#---#--#----#--#---##-##---#---#-##--##---#--##----##-#---#------##---####--#--#-##-----
---#-##--#------##---#--#--#----##--#--#--##----##-----#--#-#-#----------#--###-##-##------##-#-#-##
#--#-##---#---#------##-#------#--#-#---#--#-#-------#-#---#-#-#--#-------#-----------#-#-##-----###
--##------#-#-------##----------#--##---#--#---#------##-#-##-#-#---##----#-#---------#-----#--#-###
--#-#---#-----##----#-----#--#-#-----#--##-#------#----##---#---##----#-##---#-----#-#--#----##-##--
-##----#---#---##--##----#-#---#-##--#-##--#--------------#----#-------------#--#-###-------------#-
#--##---#---###----#-----#--####-#--##--#-------##----------#-##---#-----##---#-##-#---#----#--#-###
---#-#----#--#---#---##--#####-#-------#-#-#-------#------#-#-----###--#---#-##--#----#####-#---##--
-##----#---##-----###-------#-#--#-#---##-#-#--------#---##--------##---#--#-#--#--#---#--##--##---#
--#-#-#-----##-----##--##-----#-----#---####------#-##---###--##-##---##--##-------#----#-#--#-#-#--
-#--------#----------#---#----###--------------##----##---------------#---#--##-------#----#-#-#####
##-#--#--------------------##--#--##-###--#-##-#--##-#----#--#----#--##-----##---#-#-###----#----#--
-#-#------#####-----##--#------#--------#---#-#---#-#-##---#--##------###---##---##-#-#------------#
#---#--#----#-#-#----#-##-##--#--##----#-##-#----#---#----#-#----#----#-##---#-##-##----#--#---#----
-------------#-#--#-----#-#--#---####--##----##-####-----#---##-#-#---#-###--#-#--#-----#-#-------##
-#--#-#------#---#---#-----#--------#-#-##-#-###---#--#--------#--#-#---#--#-------#----###-#-##----
---#-####--#-#---#--#-----###---#-------#-----------###----#-#---------#-#-------#-----##--##----###
---#---###-#-#------#------#----#--------##---#---##-#-##-------#--#--#-----#----##--##-#----#---#--
-###-----#-####-#-------#----#--#---------##-###-------#-#-#-#-#-----#--------#-----##-#-------#----
--##---##------##--###-#-#-----#-----####------###--------#-#--#-----#--------#---#--##---#-#-------
-----#---##--#-#----###-#-#----#-#-#-----##---#-##--#--##--##---#---------#------##---#----#--#-#---
#--------#--#---#-----##--#----####-##-#-#---#-#-----##----#-----#--#---#-#-##---#-#----##--#--#--##
----#-----#-----#---#-#----#------------#---#--##-----##------##--##-#-#---#-----#-------#-#-###----
------#-#-------#-#--####---##-#-##--#----------##-----##-###-#--#-#-#-##-##--#-#---#---------#--#--
-#-----#----------##-#-#---------#-------#----#----#-#-#--#---#--#-----------#-#-#--#--------##-#-#-
-#--##--#------##--------##-##-#-###-#-----#--##--#--#--##-##----#-#---#-#--##-----------#--------#-
##-------#----###--#-#--###--#-------##--#------#---#-#-#-##----#--#---##-----#--#-#-#------#----#--
#------#-----------#---------#----#-----------#---#-------#----#--#####-----#-----#-#--#------#-#-##
--#---#------#----#-#-------#----#-##-##------#--#-##--##--#---#-----#-#--#-----#-##--#---##-#------
------##--#-#-##---#-#----#--#--###---#-----#----#-#--##--------#--#-###-----#---#----##------#----#
-#---------#--#-----#----------#---#---#-######----##----###--##----###-#-#--#---#-----#-#------##--
#--#--------##---###--#-------------##-###---#-#---#----#---###-#------##--#-#---#--##--##--#-------
--#--#--#-----#-#---#-----##-#-###---###--#-----#--#----##---#--#--#---#---#-##---#-------#---#--#--
#----#--#------##-#-----##---#--#-###----#---#--##------#-#-----##-----#-#--##-#-------#---#-#------
-----#---##-#-#--##-#-----------#-------#---#-#-#-#-#-#--#----#-#--------#-#-#-----#--#---#---------
--##-#-#------#---#---##------------##-#-#--##----#----#---#----#---#---#---#-#--##-#-----#--#--####
--#--###-----#-------#-#-#---###-##--##--#--#-#---#-##-#--##-------##-#--#--####-------#-#----#-----
-----#-##-#-#-#--#####-#------#--#---#--#-----#-##-##--------#-#-#---#-#---#---##-#-##--#--#---#---#
---------###-#-------##--#-##--------#--##--------#-------##-----#----##--#---#-##---##-##-----#----
----#----##----#-#---#---##-#--#-------##--#-----##-#--#-##-#------##-----#--#---#-##----#####------
--------#---##-------#-#-##-#--#----------------#---#-#----##------#-#---#--###-#--#-#----##-#----#-
---------------------#----#--#--#-#---##--##--------##-----#--#--#---##--#-#-#-#-#-###------#-#--#-#
------#-----#------#--------##--------#----#--#---#--#-----##-#---##---------#-#-#-#-------------#--
#---#-#------#---#-#-#---##--##--###----#------#----#------#---##---##------#--#---#-####-#-#--##-##
--#--##--#-#-#-#---#---#-----#--##--#----##-#-#-------#####-----##--#---#------##---------#-#-------
-#---#--#---#------#--#-#-##-###-#--##---#------#---#---#--##--#--------#--#-#--------#----###--##--
-#--#-#----##--#------#--###-#----------##-#-#-##----####-####---####-##---##-#-#--#--#---#----###--
--------##--#---##---#-##--##-#-------##---#-##--#-----##--###-----#-----#--##---------------##-##--
-###-----#----#----#--#----#---#-#--------#----#---------#---#-----------#--#--#----#---#-#--#-####-
##----#-#-#-#----#----------###---#-#-#---#--##----#--#------#-----###---------#----#-#----#----#-#-
#---#------##-#----###-#----#--------##-----#-#-----#----#---##-###----#-#-------#----#####---##-#--
#-#------###-###---##-----#--#--#---#----#-----#-#----##-#------#-##--#-#--#-------#------------#-#-
--#---##--#--###--#-------------#---------#---#---##-#-----######--#---#---##-------#---#-###-------
--##--------#--####----#---#---------#----#---#----#------#-#-#---#---#####-#----#--##------##------
#--#--#---#----#-----##-#------##-##----#-----#---#--##-------#----##--##---##--------#------#--#---
-#--#---------#--#####---#--###---#-#-#-####-#-#-------#-#--#-#----#-#--#-----###--#-#--#-----------
-###-##-----#-----##-##---#----#-#-#--------##-##---#---#-##---------#---##----##-------#-#-#-------
####--#---#---##-----#------------#--#-#--#-#-#-#--##-###------#--#--#-#-#----#-#-#-------#--#####--
----#-----##----#--##-----#-#---#--###-----#--#--#----#-#-#------#--#-#-#--------#-----##---###----#
#---#-#-#--#---#----------#-#---##-#-#--#------#-#---###------##--#-#-#---##--#-##--###----------#-#
--#-------#-#-#-##---#---#-------#---#-------------##-#-----###---###----##-#-#---#-------#--#-----#
-##---#--##---#-#-#-#-#-#---#----#-----#---#----#--##-----#----#---#---------#-----#---##-----#-----
-##--#----#--###--------#--------#-#---#--##--#--#--#----#---#--#---#--#--#--#--------------#-#--#--
--#-#--#---##--##-#---##----#--#-------#---------#-------##-###-#--#-##--#----#------------#---#----
-###-##-#####--##-###-#------------##--#-#------#---#-#-#--#---#---#--###----##--#-#-#----#-----#-#-
#----#-#-#--#---####---#--#----#--#----#--##-------###------#---------#--#----#-##---####----------#
--#-#------------------#-------##---#---#-----#----#-##-------###----#----#-----------#-##-------#--
--#-#-#-#-#-----#-#--#----#---#--###--#------------##-#-----#-----------###-------##-------#-#-#--#-
#-------#-##-#######-##---##------#-----#-#----##--------##--#-#-----#--------#-#-#---##------#-----
--##---#-------##-##---#-#-#-------#-###-------------#-----#-#--#--##-##----##---#--#----#--#--##-##
-#-#--#--###---#--------#####---#--#--##-----#------###----#--###---##--##-----#-#-###---#-#----##--
----#---#--#------#####-------##-----#-------#----#--#-#----#--#-###--#--#------#--#-------#--#-#---
----##------##------#-##---#-#--##-#----#----#------------##--#------##-#--#-##---#-##-------##--#-#