---#----#----#----#----#----#----#----#----#----#----#----#----#----#----#----#----#----#----#----#-
---##---##---##---##---##---##---##---##---##---##---##---##---##---##---##---##---##---##---##---##
----------------------------------------------------------------------------------------------------
-#-#--#-#--#-#--#-#--#-#--#-#--#-#--#-#--#-#--#-#--#-#--#-#--#-#--#-#--#-#--#-#--#-#--#-#--#-#--#-#-
----#----#----#----#----#----#----#----#----#----#----#----#----#----#----#----#----#----#----#----#
---#----#----#----#----#----#----#----#----#----#----#----#----#----#----#----#----#----#----#----#-
---##---##---##---##---##---##---##---##---##---##---##---##---##---##---##---##---##---##---##---##
----------------------------------------------------------------------------------------------------
-#-#--#-#--#-#--#-#--#-#--#-#--#-#--#-#--#-#--#-#--#-#--#-#--#-#--#-#--#-#--#-#--#-#--#-#--#-#--#-#-
----#----#----#----#----#----#----#----#----#----#----#----#----#----#----#----#----#----#----#----#
---#----#----#----#----#----#----#----#----#----#----#----#----#----#----#----#----#----#----#----#-
---##---##---##---##---##---##---##---##---##---##---##---##---##---##---##---##---##---##---##---##
----------------------------------------------------------------------------------------------------
-#-#--#-#--#-#--#-#--#-#--#-#--#-#--#-#--#-#--#-#--#-#--#-#--#-#--#-#--#-#--#-#--#-#--#-#--#-#--#-#-
----#----#----#----#----#----#----#----#----#----#----#----#----#----#----#----#----#----#----#----#
---#----#----#----#----#----#----#----#----#----#----#----#----#----#----#----#----#----#----#----#-
---##---##---##---##---##---##---##---##---##---##---##---##---##---##---##---##---##---##---##---##
----------------------------------------------------------------------------------------------------
-#-#--#-#--#-#--#-#--#-#--#-#--#-#--#-#--#-#--#-#--#-#--#-#--#-#--#-#--#-#--#-#--#-#--#-#--#-#--#-#-
----#----#----#----#----#----#----#----#----#----#----#----#----#----#----#----#----#----#----#----#
---#----#----#----#----#----#----#----#----#----#----#----#----#----#----#----#----#----#----#----#-
---##---##---##---##---##---##---##---##---##---##---##---##---##---##---##---##---##---##---##---##
---------------------------------------------------------------------------E------------------------
-#-#--#-#--#-#--#-#--#-#--#-#--#-#--#-#--#-#--#-#--#-#--#-#--#-#--#-#--#-#--#-#--#-#--#-#--#-#--#-#-
----#----#----#----#----#----#----#----#----#----#----#----#----#----#----#----#----#----#----#----#
---#----#----#----#----#----#----#----#----#----#----#----#----#----#----#----#----#----#----#----#-
---##---##---##---##---##---##---##---##---##---##---##---##---##---##---##---##---##---##---##---##
----------------------------------------------------------------------------------------------------
-#-#--#-#--#-#--#-#--#-#--#-#--#-#--#-#--#-#--#-#--#-#--#-#--#-#--#-#--#-#--#-#--#-#--#-#--#-#--#-#-
----#----#----#----#----#----#----#----#----#----#----#----#----#----#----#----#----#----#----#----#
---#----#----#----#----#----#----#----#----#----#----#----#----#----#----#----#----#----#----#----#-
---##---##---##---##---##---##---##---##---##---##---##---##---##---##---##---##---##---##---##---##
----------------------------------------------------------------------------------------------------
-#-#--#-#--#-#--#-#--#-#--#-#--#-#--#-#--#-#--#-#--#-#--#-#--#-#--#-#--#-#--#-#--#-#--#-#--#-#--#-#-
----#----#----#----#----#----#----#----#----#----#----#----#----#----#----#----#----#----#----#----#
---#----#----#----#----#----#----#----#----#----#----#----#----#----#----#----#----#----#----#----#-
---##---##---##---##---##---##---##---##---##---##---##---##---##---##---##---##---##---##---##---##
----------------------------------------------------------------------------------------------------
-#-#--#-#--#-#--#-#--#-#--#-#--#-#--#-#--#-#--#-#--#-#--#-#--#-#--#-#--#-#--#-#--#-#--#-#--#-#--#-#-
----#----#----#----#----#----#----#----#----#----#----#----#----#----#----#----#----#----#----#----#
---#----#----#----#----#----#----#----#----#----#----#----#----#----#----#----#----#----#----#----#-
---##---##---##---##---##---##---##---##---##---##---##---##---##---##---##---##---##---##---##---##
----------------------------------------------------------------------------------------------------
-#-#--#-#--#-#--#-#--#-#--#-#--#-#--#-#--#-#--#-#--#-#--#-#--#-#--#-#--#-#--#-#--#-#--#-#--#-#--#-#-
----#----#----#----#----#----#----#----#----#----#----#----#----#----#----#----#----#----#----#----#
---#----#----#----#----#----#----#----#----#----#----#----#----#----#----#----#----#----#----#----#-
---##---##---##---##---##---##---##---##---##---##---##---##---##---##---##---##---##---##---##---##
----------------------------------------------------------------------------------------------------
-#-#--#-#--#-#--#-#--#-#--#-#--#-#--#-#--#-#--#-#--#-#--#-#--#-#--#-#--#-#--#-#--#-#--#-#--#-#--#-#-
----#----#----#----#----#----#----#----#----#----#----#----#----#----#----#----#----#----#----#----#
---#----#----#----#----#----#----#----#----#----#----#----#----#----#----#----#----#----#----#----#-
---##---##---##---##---##---##---##---##---##---##---##---##---##---##---##---##---##---##---##---##
----------------------------------------------------------------------------------------------------
-#-#--#-#--#-#--#-#--#-#--#-#--#-#--#-#--#-#--#-#--#-#--#-#--#-#--#-#--#-#--#-#--#-#--#-#--#-#--#-#-
----#----#----#----#----#----#----#----#----#----#----#----#----#----#----#----#----#----#----#----#
---#----#----#----#----#----#----#----#----#----#----#----#----#----#----#----#----#----#----#----#-
---##---##---##---##---##---##---##---##---##---##---##---##---##---##---##---##---##---##---##---##
----------------------------------------------------------------------------------------------------
-#-#--#-#--#-#--#-#--#-#--#-#--#-#--#-#--#-#--#-#--#-#--#-#--#-#--#-#--#-#--#-#--#-#--#-#--#-#--#-#-
----#----#----#----#----#----#----#----#----#----#----#----#----#----#----#----#----#----#----#----#
---#----#----#----#----#----#----#----#----#----#----#----#----#----#----#----#----#----#----#----#-
---##---##---##---##---##---##---##---##---##---##---##---##---##---##---##---##---##---##---##---##
----------------------------------------------------------------------------------------------------
-#-#--#-#--#-#--#-#--#-#--#-#--#-#--#-#--#-#--#-#--#-#--#-#--#-#--#-#--#-#--#-#--#-#--#-#--#-#--#-#-
----#----#----#----#----#----#----#----#----#----#----#----#----#----#----#----#----#----#----#----#
---#----#----#----#----#----#----#----#----#----#----#----#----#----#----#----#----#----#----#----#-
---##---##---##---##---##---##---##---##---##---##---##---##---##---##---##---##---##---##---##---##
----------------------------------------------------------------------------------------------------
-#-#--#-#--#-#--#-#--#-#--#-#--#-#--#-#--#-#--#-#--#-#--#-#--#-#--#-#--#-#--#-#--#-#--#-#--#-#--#-#-
----#----#----#----#----#----#----#----#----#----#----#----#----#----#----#----#----#----#----#----#
---#----#----#----#----#----#----#----#----#----#----#----#----#----#----#----#----#----#----#----#-
---##---##---##---##---##---##---##---##---##---##---##---##---##---##---##---##---##---##---##---##
----------------------------------------------------------------------------------------------------
-#-#--#-#--#-#--#-#--#-#--#-#--#-#--#-#--#-#--#-#--#-#--#-#--#-#--#-#--#-#--#-#--#-#--#-#--#-#--#-#-
----#----#----#----#----#----#----#----#----#----#----#----#----#----#----#----#----#----#----#----#
---#----#----#----#----#----#----#----#----#----#----#----#----#----#----#----#----#----#----#----#-
---##---##---##---##---##---##---##---##---##---##---##---##---##---##---##---##---##---##---##---##
----------------------------------------------------------------------------------------------------
-#-#--#-#--#-#--#-#--#-#--#-#--#-#--#-#--#-#--#-#--#-#--#-#--#-#--#-#--#-#--#-#--#-#--#-#--#-#--#-#-
----#---S#----#----#----#----#----#----#----#----#----#----#----#----#----#----#----#----#----#----#
---#----#----#----#----#----#----#----#----#----#----#----#----#----#----#----#----#----#----#----#-
---##---##---##---##---##---##---##---##---##---##---##---##---##---##---##---##---##---##---##---##
----------------------------------------------------------------------------------------------------
-#-#--#-#--#-#--#-#--#-#--#-#--#-#--#-#--#-#--#-#--#-#--#-#--#-#--#-#--#-#--#-#--#-#--#-#--#-#--#-#-
----#----#----#----#----#----#----#----#----#----#----#----#----#----#----#----#----#----#----#----#
---#----#----#----#----#----#----#----#----#----#----#----#----#----#----#----#----#----#----#----#-
---##---##---##---##---##---##---##---##---##---##---##---##---##---##---##---##---##---##---##---##
----------------------------------------------------------------------------------------------------
-#-#--#-#--#-#--#-#--#-#--#-#--#-#--#-#--#-#--#-#--#-#--#-#--#-#--#-#--#-#--#-#--#-#--#-#--#-#--#-#-
----#----#----#----#----#----#----#----#----#----#----#----#----#----#----#----#----#----#----#----#
---#----#----#----#----#----#----#----#----#----#----#----#----#----#----#----#----#----#----#----#-
---##---##---##---##---##---##---##---##---##---##---##---##---##---##---##---##---##---##---##---##
----------------------------------------------------------------------------------------------------
-#-#--#-#--#-#--#-#--#-#--#-#--#-#--#-#--#-#--#-#--#-#--#-#--#-#--#-#--#-#--#-#--#-#--#-#--#-#--#-#-
----#----#----#----#----#----#----#----#----#----#----#----#----#----#----#----#----#----#----#----#
---#----#----#----#----#----#----#----#----#----#----#----#----#----#----#----#----#----#----#----#-
---##---##---##---##---##---##---##---##---##---##---##---##---##---##---##---##---##---##---##---##
----------------------------------------------------------------------------------------------------
-#-#--#-#--#-#--#-#--#-#--#-#--#-#--#-#--#-#--#-#--#-#--#-#--#-#--#-#--#-#--#-#--#-#--#-#--#-#--#-#-
----#----#----#----#----#----#----#----#----#----#----#----#----#----#----#----#----#----#----#----#