#--#-----###-----###---##--#----#----#------#-#--##----------#-----------#-#-##-##------#--------#-#
##--------#-#-##-#--#--###--#--##----###---#--#--#---#-------##-#-#--#---###-#--##--#-----------#--#
#---------#---#--#-#--#--###--#-###-#--#-----------#------#-##--##--#-#--##-----#---#-##-#-##-------
-------------##-------------#-###-#-####---#----###-----#--------#--##-#-#---#----#----#---##-----##
-#-#----#----#-##----#---#-----------##-----#------#------#--------#-----##--------#---##------#----
-#--------#######---##---#-----------##-#-#----##-##--#--##-#------------###---#---###---#--#----#-#
-------##---------#--#-----#-----#--------#-####-#-----#------#-#----#--##---##---##-----#--#--###--
-#--##----#--####---#-#--#####------#--##-----###-#-#------###---#--#-----##---#---#--#-#---#------#
---#-###----##-#-##---###-#-----#---------##-##---------##----------#----#-------#-----------#-----#
-#------#-#-##----#--#-##-----#--##--#-#-----##--####-##-#------#-----###--#-----#----#--#-##------#
---#----#-##------#--#---####--------#--------#---#--------##-##-#--#--#--#--------#--------#--####-
#-#-#--------#-#--#-----#--#---------#--#-#---#--#-#-----------##---#-----#-#---#-##--------#----#--
--##--#-#-#----------------#-#-------#-----#--#-##-----#-----#--#---##-#-#-#-#--#-#---##-----#-----#
-#---#--###-----##-----------##-#---#----#---##-#-#---##----#--###-----#---#------------##--#-------
------#-#--##-#---#--#-----#-#-#--#-#-#--#---------#---###---##-#--##------#--##----#-----#-#-#-#-##
--#-----------#-##-#-------####--#------#-#---#-----#--##-#----##---------##---###--#-------#---#-#-
---------#-#-#----#----------#--#---#--###---#---#--#--#---#-#---#-#-----#----#----##--#-----#--##--
#-----##----#-####--###---#---------#------#-----#-#---------#--#----#----####--#-#-#------##-------
--#--------##----------##-----------##---###--#-#--###----#----#-##--##----------#--##---###--#-#---
------#-#--##------####-------##-----###---#-#-#----#---#------#-#-#---#---#------#-##----#-#--#----
-------#-##--#---#---###---##--###-#---#----#---------##--#--#-----##---#---####--##-#----#------#-#
----###--#---#--###-#---##-##-----#------------#---#-#-----------------#--#-----##-##---#-#-------#-
--###-----#-###-#--------#----##--------#-##----#-#--#---#----##-----#-##------#--------#--##-----##
--------##----#---##------#--------###-----------#-#-#-#--#----#---#-#----------##----#-#--#---##---
-##---##---#--#--#-#---#----###---#----##---##---#-#-#------#----##--#--##-#-##-#-#-#-##------#--#--
---#--###--###-#--#----##-----###---#--###--#---#------#---#-#---###-#-----##-#-#-#----##----#-#---#
------##-#-#-----####-----------###-#--#-#--#--#---#---##----#-#-#--#------#----##-##----##---#-----
-----#-#-#---#####------#--#----#--------##-#----##--##------#-##-#-#-#-----#-----#------##-##---##-
-#-----#-#--#--#---#-##----#-------#------#-#--#--#--#---##-##-#----#---#--------#---#--#--#-#-----#
---##-----#---#-----#-##-------#--##-###-------#--##--##--#---#------#-#-------#-#---#--##-#--#--#--
-##-#----##----##-#-#---#------#----#----###---#--#----------##-#--#-------#-###--#-##-#---##-#---#-
--------#-#---#-----#--####--#---#---#--#------#--####--#-#-------#----#-#---#-#--------###-----#---
##-#----------#--#--#--#-#--#---#-##---#--#---#--#--------#--#-----##---#--##----------###-----##---
#----#--###--#---##-#--#--#-#--##---#-##------###---#-##--##---###-----------#-----#-----#--#-#-##--
---#--#--#---#---#--#-#--------------#--#-#---------#---##----##-----#-#-##-------##-------#-#-#----
---#------#--#-#-------------##-#-#---#-##--------##--#-#-----##----##------##----##--#-#-###-------
-##----#-##-#-##--#--###---#-##---#-#-#-###------#------##--#-#---#---#---##-#---#----#------#--#--#
---#---##-#----#------#--#-#----#--#----#-##-#---#-#-#-----##--#----#-#-#----###------##----###--##-
--##--##-#-##--#--#-#-#-#---------##-#--#--##-#---##----#---#--##----###--##----###----#----#----#-#
--#-#---##-----#-###---#-##-----##--##---#-----#-#-##--#--------#----#-#----#-#--#-#-#----#-----#---
-#----##-#----#---###-----###---#------#----#----##-#-#-----##-#-#------##-#---------#--#-----###--#
##-#----#----#----------#-#-##--#--#----#---#----#-######-----####-----##-#----------##-------#---#-
-#-##-E-#--###--##-#----##-#----#----#----#--#----##-----#---------#--#--##---------#----#---##-----
#-##--#---#--------#--##--#----#---#-##--------#----##--#-#-##--##-#--####---#-##---#----#-#-#----#-
#---##---------##-----#-#----###-----#--S#------##---#-#-#-#-----###--#-----#--#----#---#-##--##--##
---#---#---#----##-----------#--#---#--##-##----#---###----#----#-#-----#-##-#---#-###------###-##-#
#-#-----##-##------#-##--##---#-#-------#-#-#-------#-----#----------#-#-----------###-----#----##--
##--#-##--##--#-----#-##---#------------------#-#----#-------#------#--#-------###-#--#-----#---#---
##---------#--#------#------#-##--#------#-------#-------#--#--------------------##--#-##--#-------#
#---##----------##---#----#---#--#--#--#-#---#------#-------#-#--#-----##-------#--------#-----#-#--
-#-#-###-#--------#--#-#-#---------#------#-----------#--#--#-------------#-#-------#-#---#-##---#--
##--#--#--#####-#----#----#-#---#-------#-##---##---##--#-##-#-#---##-#------#-------#--#-------#---
#-#-#---#--#------#--#-#-#-#-----#-#--##-####--#-#-#--#---##------#--#-##--#----------#--#------#-#-
#####-----#-##-----#--#-##--#---#----#------#----#-##--#--##--#--#---#-------##---#-#--##----#-###-#
#-#-----#-#----##-##--#-------#---#-----#--#--##----###-----#-###-#-#----#--#-----##--#----------#--
--#-#----#---##----##------#----------#---##-#---#------#-#--#-#-##--#--##--####-#----#-#---#-------
-#-##----------##----###---#----#---###--#-#-##-##---------------##-----#-#-----##---####------#----
-------##--#---#---#----###-##-#-##-####--###-#-#---##---#-#-----#-##---#-#-#----#--------------#-#-
#----###-----#----##---#--#--#--###-#---##-----#-#-#----------#--#---##----##-##-----##-##---------#
---------#-#---#------##-#---#---------#---##------#--##-#---#--#-##-###-------#-#--#-#-#---------##
-----##---#---##---#-#--#-##------------##-#-------#------#-###-###-#-##---#-------#---##-#---#-----
-##---------#--#----------#------#---#------------##-#-###-#--------##---##-#--#---#----#--##-###-#-
---#------#-#-##--------##----###--###---#-#--#---#---#-#---####----###--#--#---------#--#-#-#--#---
#-##--#-##--##---#---##-------#-#-------#--##---#---##-#---#--##-#----#-#----####-------##-#----#---
-#----##------#--#-------#--#-#-##---#-#-#-#---#-#--#------####---#-----#--#-#---------#------#----#
#-#-##-##--#--#-###---#-----#-----###---#------##----###-----#---#----##-----#-----#-#-------#--#---
--####----#----##-----#---##---##-#------#----#-#--#-#-#----##-----##------###--#-#-----##--#-------
-###-----##-----------##---------#----#----#-#----##-#----###-#---#------#-#-#----#---###--#-#---#--
---#-#-##-#--#-##--#------------#--#--##---#----#-#-#-------#---##--#------#---#-#---#--#-##------#-
---#--#-------#-#-#-#-##---#-#---##--#-----#-----##----##----#-#---###-----#--#--###-------##----#--
##--#----##-----##--#------------------##----------#--#---#----------#-#-#-#-#--##-------#--##-----#
-#---#-##-##-#-------#--#-###--##----#--#--------#-#-###-###-#-#-#-##-----##---#--#--#------##----##
--###--#-#---#-##--#--#--#-------------#-----------#--#-#----#-#-#-----#---#------#-#----###-#---#--
---#--#------#-#----#-#-#-#--#-----#-------##--#-----#--#-----#-#------#-#------#-#-------##-#------
--#-------#--##-#-----####------#-#---#----#-##-##--##--#-#----------#-#--#-#---###---#-#-#-----#---
----#-------#-#--#-#--------#-------##-#----------##-#----------#---##---##--##---##---#---#--#--##-
#-##------#--#-------------#--#-#---#--#----#--------#---#----#-#-#---#-#----##-----###---------#-#-
--#-###----####-#-----#-------##----#-#-------#-#------##-----#-###---#-#---##-#--#----#--#--###----
-----#---#-------#-#----#-#-------#-#---------###--###--------#-##---#-------###-----#--#------#---#
---###-##--####--##-#-#--#-##----##--#-#--#---#--#------##------#----###---#--##---##----#---#--#--#
---#--##----#--#----#-##-#--#---#--#-###---##---##-----#-#--##--#-#-----#----#-#---#--#----##-------
---#---#---#-##-###--------###----##--###----#--##--------#--#--#-----#-##----#-----#--#---###-#----
---##---------#-#----###-#---##--#-------#-###-----#-----------##-----#--##------#--------#-------#-
---#---#----#--#-----#-#-----#-##---------#-----#-#---#-#---####--#-#-#-####-##-#-#--#--#------##---
##-----##-##-#-#-------#----------#-#--#--#-##-#--#-#----#-##-###-#-#-##--#---#---##-----##-------#-
----#-#--####---------#----#--#-----#----####--#-#----#-#-#--##--#---#--#-----------#----#----------
------##-------#-------#-------#-##---------------#--#---##-#---#-----#-----#-#---#-#---####-#------
#--#---#-#-##--#-#-------#-#-#-----##---##-###--------#----#----#---#------#-#---##---#-#---####-###
##------##-##-#----###---#-#-#-#---------##-#-#-#-----#-###---##--##---#----#-#----##-#-----#-------
-----#-#-#-##--##----#----##------#----##-#-##-###-###--#-------#---#-----#-#--#-#---#--#--##-------
--#-----#----------##----#####------#----#--#----#-####--#---##----#--#-##---#---#--###-----#-------
####----#------####-----#----#---------#-#####----#-#---#---#-#-#-#-----##-------#--------#---------
----#----#------##--###-#-------#----##--##--##----#-------##----#---##-#-#--------#-##-------##--#-
-------#-#-#--#-#------------#----###-------#--#-----#---##---#------#-----##-----------#--#--#--#--
----#-##-#-####-----#-##-----#---##-------##---#-#-#------#--#----##-#------##-------##--#--##--#-#-
-----##----#-#----#-----##---##--#---#-#-#-##----###-#-----#-##-------##-------####----##-#---------
--####-##--#-#-#--#--#------###----#---##-----##---#-#-##-#-####-##-#-----------#-----###---#-------
-----#---#-#--#-#-#-----------##-#-#-##---#-#-#-----#---#----#-###-##-#-###---#-#----####-----#-#-#-
---#-#-#---#-#-#-#----##-------##--##----##------#-##-#--#-##----#--##--#--#--###---#-#----###------
-##--##----#----#------#-#-#--#-#----------------##--##----##--##------------#----#----#-#--####---#