--##---##---##---##---##---##---##---##---##---##---##---##---##---##---##---##---##---##---##---##-
----------------------------------------------------------------------------------------------------
-#----#----#----#----#----#----#----#----#----#----#----#----#----#----#----#----#----#----#----#---
-##---##---##---##---##---##---##---##---##---##---##---##---##---##---##---##---##---##---##---##--
-#-#--#-#--#-#--#-#--#-#--#-#--#-#--#-#--#-#--#-#--#-#--#-#--#-#--#-#--#-#--#-#--#-#--#-#--#-#--#-#-
--##---##---##---##---##---##---##---##---##---##---##---##---##---##---##---##---##---##---##---##-
----------------------------------------------------------------------------------------------------
-#----#----#----#----#----#----#----#----#----#----#----#----#----#----#----#----#----#----#----#---
-##---##---##---##---##---##---##---##---##---##---##---##---##---##---##---##---##---##---##---##--
-#-#--#-#--#-#--#-#--#-#--#-#--#-#--#-#--#-#--#-#--#-#--#-#--#-#--#-#--#-#--#-#--#-#--#-#--#-#--#-#-
--##---##---##---##---##---##---##---##---##---##---##---##---##---##---##---##---##---##---##---##-
----------------------------------------------------------------------------------------------------
-#----#----#----#----#----#----#----#----#----#----#----#----#----#----#----#----#----#----#----#---
-##---##---##---##---##---##---##---##---##---##---##---##---##---##---##---##---##---##---##---##--
-#-#--#-#--#-#--#-#--#-#--#-#--#-#--#-#--#-#--#-#--#-#--#-#--#-#--#-#--#-#--#-#--#-#--#-#--#-#--#-#-
--##---##---##---##---##---##---##---##---##---##---##---##---##---##---##---##---##---##---##---##-
----------------------------------------------------------------------------------------------------
-#----#----#----#----#----#----#----#----#----#----#----#----#----#----#----#----#----#----#----#---
-##---##---##---##---##---##---##---##---##---##---##---##---##---##---##---##---##---##---##---##--
-#-#--#-#--#-#--#-#--#-#--#-#--#-#--#-#--#-#--#-#--#-#--#-#--#-#--#-#--#-#--#-#--#-#--#-#--#-#-E#-#-
--##---##---##---##---##---##---##---##---##---##---##---##---##---##---##---##---##---##---##---##-
----------------------------------------------------------------------------------------------------
-#----#----#----#----#----#----#----#----#----#----#----#----#----#----#----#----#----#----#----#---
-##---##---##---##---##---##---##---##---##---##---##---##---##---##---##---##---##---##---##---##--
-#-#--#-#--#-#--#-#--#-#--#-#--#-#--#-#--#-#--#-#--#-#--#-#--#-#--#-#--#-#--#-#--#-#--#-#--#-#--#-#-
--##---##---##---##---##---##---##---##---##---##---##---##---##---##---##---##---##---##---##---##-
----------------------------------------------------------------------------------------------------
-#----#----#----#----#----#----#----#----#----#----#----#----#----#----#----#----#----#----#----#---
-##---##---##---##---##---##---##---##---##---##---##---##---##---##---##---##---##---##---##---##--
-#-#--#-#--#-#--#-#--#-#--#-#--#-#--#-#--#-#--#-#--#-#--#-#--#-#--#-#--#-#--#-#--#-#--#-#--#-#--#-#-
--##---##---##---##---##---##---##---##---##---##---##---##---##---##---##---##---##---##---##---##-
----------------------------------------------------------------------------------------------------
-#----#----#----#----#----#----#----#----#----#----#----#----#----#----#----#----#----#----#----#---
-##---##---##---##---##---##---##---##---##---##---##---##---##---##---##---##---##---##---##---##--
-#-#--#-#--#-#--#-#--#-#--#-#--#-#--#-#--#-#--#-#--#-#--#-#--#-#--#-#--#-#--#-#--#-#--#-#--#-#--#-#-
--##---##---##---##---##---##---##---##---##---##---##---##---##---##---##---##---##---##---##---##-
----------------------------------------------------------------------------------------------------
-#----#----#----#----#----#----#----#----#----#----#----#----#----#----#----#----#----#----#----#---
-##---##---##---##---##---##---##---##---##---##---##---##---##---##---##---##---##---##---##---##--
-#-#--#-#--#-#--#-#--#-#--#-#--#-#--#-#--#-#--#-#--#-#--#-#--#-#--#-#--#-#--#-#--#-#--#-#--#-#--#-#-
--##---##---##---##---##---##---##---##---##---##---##---##---##---##---##---##---##---##---##---##-
----------------------------------------------------------------------------------------------------
-#----#----#----#----#----#----#----#----#----#----#----#----#----#----#----#----#----#----#----#---
-##---##---##---##---##---##---##---##---##---##---##---##---##---##---##---##---##---##---##---##--
-#-#--#-#--#-#--#-#--#-#--#-#--#-#--#-#--#-#--#-#--#-#--#-#--#-#--#-#--#-#--#-#--#-#--#-#--#-#--#-#-
--##---##---##---##---##---##---##---##---##---##---##---##---##---##---##---##---##---##---##---##-
----------------------------------------------------------------------------------------------------
-#----#----#----#----#----#----#----#----#----#----#----#----#----#----#----#----#----#----#----#---
-##---##---##---##---##---##---##---##---##---##---##---##---##---##---##---##---##---##---##---##--
-#-#--#-#--#-#--#-#--#-#--#-#--#-#--#-#--#-#--#-#--#-#--#-#--#-#--#-#--#-#--#-#--#-#--#-#--#-#--#-#-
--##---##---##---##---##---##---##---##---##---##---##---##---##---##---##---##---##---##---##---##-
----------------------------------------------------------------------------------------------------
-#----#----#----#----#----#----#----#----#----#----#----#----#----#----#----#----#----#----#----#---
-##---##---##---##---##---##---##---##---##---##---##---##---##---##---##---##---##---##---##---##--
-#-#--#-#--#-#--#-#--#-#--#-#--#-#--#-#--#-#--#-#--#-#--#-#--#-#--#-#--#-#--#-#--#-#--#-#--#-#--#-#-
--##---##---##---##---##---##---##---##---##---##---##---##---##---##---##---##---##---##---##---##-
----------------------------------------------------------------------------------------------------
-#----#----#----#----#----#----#----#----#----#----#----#----#----#----#----#----#----#----#----#---
-##---##---##---##---##---##---##---##---##---##---##---##---##---##---##---##---##---##---##---##--
-#-#--#-#--#-#--#-#--#-#--#-#--#-#--#-#--#-#--#-#--#-#--#-#--#-#--#-#--#-#--#-#--#-#--#-#--#-#--#-#-
--##---##---##---##---##---##---##---##---##---##---##---##---##---##---##---##---##---##---##---##-
----------------------------------------------------------------------------------------------------
-#----#----#----#----#----#----#----#----#----#----#----#----#----#----#----#----#----#----#----#---
-##---##---##---##---##---##---##---##---##---##---##---##---##---##---##---##---##---##---##---##--
-#-#--#-#--#-#--#-#--#-#--#-#--#-#--#-#--#-#--#-#--#-#--#-#--#-#--#-#--#-#--#-#--#-#--#-#--#-#--#-#-
--##---##---##---##---##---##---##---##---##---##---##---##---##---##---##---##---##---##---##---##-
----------------------------------------------------------------------------------------------------
-#----#----#----#----#----#----#----#----#----#----#----#----#----#----#----#----#----#----#----#---
-##---##---##---##---##---##---##---##---##---##---##---##---##---##---##---##---##---##---##---##--
-#-#--#-#--#-#--#-#--#-#--#-#--#-#--#-#--#-#--#-#--#-#--#-#--#-#--#-#--#-#--#-#--#-#--#-#--#-#--#-#-
--##---##---##---##---##---##---##---##---##---##---##---##---##---##---##---##---##---##---##---##-
----------------------------------------------------------------------------------------------------
-#----#----#----#----#----#----#----#----#----#----#----#----#----#----#----#----#----#----#----#---
-##---##---##---##---##---##---##---##---##---##---##---##---##---##---##---##---##---##---##---##--
-#-#--#-#--#-#--#-#--#-#--#-#--#-#--#-#--#-#--#-#--#-#--#-#--#-#--#-#--#-#--#-#--#-#--#-#--#-#--#-#-
--##---##---##---##---##---##---##---##---##---##---##---##---##---##---##---##---##---##---##---##-
----------------------------------------------------------------------------------------------------
-#----#----#----#----#----#----#----#----#----#----#----#----#----#----#----#----#----#----#----#---
-##---##---##---##---##---##---##---##---##---##---##---##---##---##---##---##---##---##---##---##--
-#-#--#-#--#-#--#-#--#-#--#-#--#-#--#-#--#-#--#-#--#-#--#-#--#-#--#-#--#-#--#-#--#-#--#-#--#-#--#-#-
--##---##---##---##---##---##---##---##---##---##---##---##---##---##---##---##---##---##---##---##-
----------------------------------------------------------------------------------------------------
-#----#----#----#----#----#----#----#----#----#----#----#----#----#----#----#----#----#----#----#---
-##---##---##---##---##---##---##---##---##---##---##---##---##---##---##---##---##---##---##---##--
-#-#--#-#--#-#--#-#--#-#--#-#--#-#--#-#--#-#--#-#--#-#--#-#--#-#--#-#--#-#--#-#--#-#--#-#--#-#--#-#-
--##---##---##---##---##---##---##---##---##---##---##---##---##---##---##---##---##---##---##---##-
----------------------------------------------------------------------------------------------------
-#----#----#----#----#----#----#----#----#----#----#----#----#----#----#----#----#----#----#----#---
-##---##---##---##---##---##---##---##---##---##---##---##---##---##---##---##---##---##---##---##--
-#-#--#-#--#-#--#-#--#-#--#-#--#-#--#-#--#-#--#-#--#-#--#-#--#-#--#-#--#-#--#-#--#-#--#-#--#-#--#-#-
--##---##---##---##---##---##---##---##---##---##---##---##---##---##---##---##---##---##---##---##-
----------------------------------------------------------------------------------------------------
-#----#----#----#----#----#----#----#----#----#----#----#----#----#----#----#----#----#----#----#---
-##---##---##---##---##---##---##---##---##---##---##---##---##---##---##---##---##---##---##---##--
-#-#--#-#--#-#--#-#--#-#--#-#--#-#--#-#--#-#--#-#--#-#--#-#--#-#--#-#--#-#--#-#--#-#--#-#--#-#--#-#-
--##---##---##---##---##---##---##---##---##---##---##---##---##---##---##---##---##---##---##---##-
----------------------------------------------------------------------------------------------------
-#----#----#----#----#----#----#----#----#----#----#----#--S-#----#----#----#----#----#----#----#---
-##---##---##---##---##---##---##---##---##---##---##---##---##---##---##---##---##---##---##---##--
-#-#--#-#--#-#--#-#--#-#--#-#--#-#--#-#--#-#--#-#--#-#--#-#--#-#--#-#--#-#--#-#--#-#--#-#--#-#--#-#-