#--#----------#-#--###------------#--##---#-##-#---#----#---------------##-------##--#----#------#--
--#---#-----#--------------#--###----#-------#---##--#--#---------###---##-----##-#-----#---#---#--#
---#--#-----#----#-#-#-----#-------###--##-------#-----#---#-#--#-#--#-----##----#--####--------#-#-
###-----##-#--##--##-##--##--#--#--#---------E-----#--#-###----------##--------#--##-------------#--
---------#------------#-#---##---#-#----#----#---##---#--##-###-##--#----##---##---------##---#----#
-##-###--#--##-----#---#---#---###----#-#---#-##---#-#--#-------#---###-###--------#-#--#----##-#---
---#-##---------#---##-----------#-----------###-#-----#-##---#---------###--#---###----##-#-#-#----
--#------#-----##-----#-#-#------#------#-------#--#--##---##-##-----##--#-#-#-##--#--#---#-#-------
----#-#--#----##---##---####-#-#---###----##---------##----#----#--#---#--##-----#--#---#-##-------#
##-###--------##----#####------#--#-##--#---#-------#--#-#-----##-----#----##----#--------#-#------#
###------#-##--###-------##-#-###-----#-#-#--#-----#---#--#---#---#--#-#--##---#--#--#-##---------#-
-----#--#----------##----##------------#-#---#-##-----------#--#----##--#-----#--------#-#--#--#--##
------#--##--#--##-#-----#-##---#---#---#-------#-#-#-#-###--#---#--#----#--##--#-----#-#-#--#---#--
-###--#---------#----#----#------##-##-#--##-#---##----##-##----##---#-------###-##--#-#-----#-#---#
---#-##------------#-#-##-#######----#-----#--#-#-#--------------------##-#--#--##--##--#-#----#--#-
#-#--#----#---#-##--------#-#--#-#--#--##-#-------##------#--###---#---##--#--#---#--#-#--#----#---#
--#------##------#-#----------#--#--####---###---#--#-#-----#--#--####------#-#---###--#----#-#-#---
#--#-#---#-###-#---#--#------#--#-##---#-----#---#--#---------------#---#---#----#-#--#-#--#----#-##
----#---#------#---#---#--#---##----#--#-----------#-#-----#----#-#---------#--#-#----#-------##----
---------#-###-#-###-#----###------#-----------#----##-#----#----#-#---#-#-#------#-#-----#-#-#-----
-#-#-#--###---##--#-----##-#--#--#---#--##----##-----#-------------###--#-#-###-#######-##----------
-----------#--------#--#-#----#---#---#--###---#--##-----#--#-#---#-#--#-###-##-#-----#----##---#--#
-#------#-##-----###----##-----#--#----#-##---#-####-#---##----#--#---#--#----#-#-#-#----#--#-#---##
#---#--#--#-#-###----#-----#--#-#----------------#-#---#-#---#----------#---##------#---#-#----#-##-
-#-#---#-#####-#-#--#------------##-------##---#---#---#--#-------#-#--#---##---#-##--#-#-#---------
#----#----###---------#-###-#-#--#-##--#---#-##------#--##-#---#-#---#----#-----#----#-#-#-----#--#-
-#--#----#-----#-#----##---#----#---#----#---#---#---##--#----####------#---------------#--#--##----
##--#----##-#--#---#------##----#----#--##--#--#-----#---------#--#-#----#---#-#----#--#-#--#---#-#-
#-------#-#--------#--#-#-#-##--#--#-----------##--#-#---#----#-#-#-#--------###-##----------###----
-------#----####-#--#--------#-----#------#---##-------#---##----#-##-#--##-##---#--##---#------#---
--#----#--##-#-----##------#-###-------#---#-----#---------####--##--------#-##----#-##-#--##-----##
---#-#--#--#--#-##---##----------##-------#---#-------#-#-#--##--##----#--------##-------------##---
----####-#-#--#-###-###------#--#-##-#----#---#----------##----#------#--##-#--#---##--##-#--#-#-##-
--##------#--##-#--###--#--###--###---#----#---#-#--#-#-#-#####-----------------###-#-###----#----##
#--#----#-----#--#-----#-#-----------##-##-#-------#---##-#--#------#----#----#--#------#-####---#-#
--#---------#--#----##--#-##----##--##-#-----#-#---##-#--#----#-----#---#-#--#-#--##----#----#---###
--#-------------##---##-#-#----#--##-#---#---####--#----##-##-##-------#-#---##----#-----##---#-#-#-
-----#-#--#---#--#--##--------##-#---##----------#--##---#--#---------#----------#--#------#-#----#-
---#-#-#-##-----##--####-#-----#--#----#---#-#-#-------#--#-###--#-#-##--#-#-#--#--#-----#-##-#--##-
---#--#--#----#-#---------###-#-----#---#----#----#-#----##-#-----###---#--##--##---------#-#-##-#--
-#--#---#--##-###-#-##-----##--###-#-------#----###---##---#------##-#---#-##-##----------------#-##
#-##-###--------#---#--#--#--##------#-#-#-##---#----#--#-##----##----#-##-##-----####-##-----#-#-##
#-----#--#-##----#-##----###-----#----###-#---#--###---##--------#-#-##----#---#--###-----#---#----#
--#----######-#----#-#-#---#----##-##-#---##-#--##--##-##--##-#-#--#------#-----#-##--#-#----##---##
-#-#-#-----#-#--#---#-#------#----#--------------#----#--###--#--###--#----------------#-#-##-#--#--
---------#-##---------###--##-#---#--##-----##---------##-#-#-#----#----#--#--#--###---#---####-----
#---#-#-#-#-----#------##-#--#--------#--#----#---#-##-----#--#----##---##------#-------##------#-#-
----#--##---#---##---##----------#--##-#---#--##-##---#------#--##-###---#-#--#-#--#-####----#--#---
-#----##---#-#-#----#-#--#-#------###---#--##-#########------##----##-#-#--#---###-#-#--#-#-#-#-#-#-
-##-#-----#-#-#---###-------#-#---------##----#-----#----#-##-------##----#---##--#---###-------##-#
#-#------#------#-#-#--#-#-----------#--#-##----#-------##----#---##-###------#-#-#--#--#-##--#----#
-##-----#--##--#-----####--#--#--#-#-##-##--#-#--#-#----#---#--##------------------#---##---#-#--#--
---###------##---#-------#---#---##---##-----#-#--##---#---#-##--##---------###--#-#--#-#---#-#-----
----#---------#-###--#---------##---##--#-#-----#-#--##--------#----#---#-------##-----##----##-----
-------------#-----#--##---#-#-----##-#--------#--#-------------#--###---##-----#---##-------#--##--
--#-#----#---#-----#--#--#-##------##----#--###-###-----#---------#--#--#----#-#----#----##----#--##
---##----------#------------#-----------##---#------------#--#-#-------#-------###------#--#-#------
-#---#----####---##--#----###-#-#---#--#-----#--#----#-#-###-#------##-#-#-#---#-------##----#---#--
--#-----###-#-#-------#---###-------##-----#---#-#---#--###---##------#-#-#-#-#-###---#-----#--##---
-#------##----##---#---###---###-#---#-----#-#-----#-----#--#-#----###-----#-----##-#--#---#-#------
#---#------#--#-#---#--#---#---#--#----#-#-----#------#---##-#--#---#-----#-#-----------##-#----#---
--#---##-------#---#-------#----#--#----#-------##-#--#---#------###------#------####--#----#-------
---##---#-------#-###----###-#--------------##---------------###-##-----###--##----##-#---#-----#-##
###-#-##-#----#--#-##---##-#--#-##----#-###-----##--##-#----#-#-#---##--#----#------#--###-------#--
--#---##-#-#-#-#-----#--------#--#--#--------------#---##-#------##--#--#####----##---#--#---#---##-
-----#----#-##---##-----#---####--------#-#-----#-----#-#-#-#--##---#--##-----#-------##----##--###-
###----#------#---#---#-#---#--##-----#-#--#####-#----#--#-------#--#---##-----#-#--#-#-----#-#-----
----#---#---#--##-##-------#---##-----#-------#---##-#-#----###-###-#-#---#-#--###----#---#--------#
#-#--#####-#-##--#---##--#-----#------------#-----#---#---#--##---#-#-------#----##---------#---#-##
##---#---#----##-##----------##--#-#-#-##--#---#---------------##---------#-----#----#---#-###----#-
------##----#-------###---------------#--#--#-#----#--#--##--#-#----#-###---##----##------###--##-##
#-----#-#----#---------------------------------##------------####-#--------------------#-#-##-#-#-#-
-#-##------#---#-####---#---#---##---#-##-##---#--------#----#---#-#--#------#--#----#-----#-#------
#---------#------#----#---#--#######--#------##-#-##-#-##--#-#-----#---#------#---#--------#-####-#-
----##--#-#--#------##---##-##--##-----#----#--#-###-##-----#--##-###---##--#-----#---#--#-###------
----#-##--##-#---##-#-#--#--#--#----#--#-----#-##--#---#----##---###---#----------#-#----##---#---##
-#--##------#-#-#---#---#------#---#-------#--#--###------##--#-----##-#-###--###-#---#--#---##---#-
#----##-#-----#--##--#------------#-----#-----##-##-#-#--------#--#-#----#---#-#---#--###---#-##--##
##--#--#--#---#####--#-#--------#-####---#--------##---------#--###-#-------#---#---------#-----####
------#--------#-#S-#---#-##---#-#-#-#--#--#---------#--#-#--##-####----##--#----#--#--#----#---#---
#-#----#---#--#---#---#-#-------------##---#--#----#---------#---##-----#------#--------#-#---#--#--
--##--#--#--#-------#--#--#--##-----##------####----##-------#-------#--#----##-----#-----##-#-#-#--
-------#--#--#-#----#-----##------#----------###-------#----#-----------##---###-#----#--##---##---#
#--#-##--#--#-##-----#-----##----#-----#-----#------------#---#-------#--#---#----------##-#--#-#---
##-----------###--##--##-------#-#-#--###----#-###------####----------#-#-----------##--#-####-----#
----###--##--------#-#-------##--#------#----##----------#----##---#-#--#---------#--#--#-#--##-----
##---#-####-#--------##-#-###--##---------#--##-##----------#--#--#---#----#-##------#-#--##--#--##-
##------------------------##------#-#----#-----#--#####------------#-----##-##---#------#-#--##--#--
#----------#--#-#----##--##-##-###---###----###-#-----##----#-#---#----#-#----##--##--#-####-##-#---
-------#----#--##------#---##-#--##---##--##-###-#----#--###-#-##--#--##------------#-#--#---#---#-#
----#-------------#--#---##---##---#------#--------#----##---#-#--#-------------#----##-#--#-----#-#
----#---#--##-###----#--#-------#---###-##---#-#---##--#-##--###---#---####--------#------#-#----#--
##-------#-#-##---#-----##---##--#--#--####--#--#--#---#---#----#--#-#-#---#-##------#----#---#-#--#
-------#---------#---#-----#--#####----##-#------###-##---###-#-#-#-#--#--#----#---#------##--#--#--
-#-------#---------#--#-----##--#-##-#------------##-###----##-------#-#-#-#--#-------#----#----#--#
------------#--#-----#---------------#--------#-#-------#-----##-#-----#--#--##-###---#------##-#---
-------#-----##------------------###-#------###---#-----##-----##-#-#-##--------#-----##-#---##-----
----##----#--#---##-#--#-------##---------------##--#---####-#-#----------#-##-----------##-----#---
#----#--#---#-##-#-------##----##---------######-#--#-#-###-#--#---#--##-##-----#--##-----------#---
#-#---#-#-#-#---#--#-#-#-------#-----#---------#------###--#--------###-#--#-#-#-#-#-----#-----#####