-#---#--#---#----#---##---------##----####-##-##---##---#--------##----#-----------###---#-##-------
----##---#--------#----------------####--#---#-#-#----##----#-#-#-###------#-#--##--#-------#------#
-------#-#--#----#-#----#-#-----#------####------#----------#----#-----#-##------#-#------#--#----#-
#-#--#-##-#-#----#-----#------#---#------#---###-###----###---#--##-###--#------#--##---##-##--#--#-
----##--#---#--------#-----##--##-----#---------##---#-----------------#-------#-#---#-#---#-#----##
#---#-#-#-#-#------#----####--------##----#-------###--#---------#----#-#---##---##--#-----##--#-#-#
------#---#--#-----##-#---#--#----##-##-#-------#-----#---#--##-----#-#--###-#-#-#--####--------#---
#-#-#------#-#------#----------##-#-----#---------#---------------#---#-#----##---#-#-#-#--#--------
----##-#-----##--#-#------#--#---------------#----#---#--#---#-----#----###-#-----##---#---#--##-#--
#--#--###---#--#-##-----#--#---#----#--#----#---------#--#-----#----E##-#----#---#---#---##--#-##---
-------#---###-#-#--##----#-----#--####---#---#-------#--#--#------#-#-------#-#---#--###--####----#
--#-##--#-#------##--###----#-#--#-#--#----#-#---##-----#------------#---#-----#---------##--#-##-##
----#---##--#----#--------------#----#-#----#--##-#-#-#-----#----#-#----#-#---#---##------##----#---
-#--#--#-###----#--#----#--##-#-##---#-###--#------#-------#--#---#-##----------#--------##----#----
----#-#---###--#---##----------#---#---#---##----###--##-#-#-#--##-#---##---##--------#----##------#
---####-----#---##---#-#--#----------#-#-------#-##-#---#--#----#-##-----##---#--#-------##-#---#---
--------#-#--#--##--------#---#-#-----##----#---###---#--##----#####---#--#--#-#--------#---#-#-----
###-----#--#---#---------###-----##---####-#--##-#---#--##--#---#----###--------#-#-#---#----#---#--
#-------##------#---#-#---#-----#--###-#------#---##---#----##----#-#-----#--###----#----#--#-###-#-
-#--##----#--------#-#--#--#-----------------#--#------#------#-----#--------#-#------###-#--##-#-##
#--#-----##---#---#-#-#--##---###-#---------#-----#-----#---#-#--#-#----#-------##--------------#---
#-##-#-#----#---##------#-###----##-----#--#-##-#-##------#---#---#-#--###----###-#-#-#-#-------#--#
-#---#-##-#---------#----##-----------#-#--#-#-##-##---#-##-#---##--###--#-##----#---##-##-#--------
--#--------#--#-##----##----##------##-#---#---#---#--#-------#-#---#------#--#-----------#-#---#---
-#------#----##-##--##-#--#-----------##--#---###-----##--#---#-#---##-#---#---#---#-#--------#-##--
--#-###-------#-#--#-#--##----####---#--##----######-#----#-------------#-------#------------------#
--#--#----#----#--#---##------#-#-#-#-------#----#----#--#---###---##-----#-#-#----#-#--####-#----##
--##--#-#--#--##-#-##-#--#-----#-#-##--#--#-###--#-#--#--#-#---------#-----##------##------#-----#--
##----------#-#-##-----------#---#------##------##----#---#--#-#--#-#-####----#-#--##-#-----#--#----
-#-----#-----------#-#---#----##---###--#--##---#--##-----#--##-#-#--------#--------#---------###---
---#--#-#-#-#----##-#-##-------##--#-#-#-#-###-#-#-#--##-#-#--##---#----#----#------#--#--#-#--#--##
##-#----#---#-#-##-#-----##---#--#-#---#-#-###-###-#--#--##---#-#---#----#----#-##-##---#-#-------##
#-#-##--#--##-#--####-----#--#-#------------------##-----#-#--##-------##---#-#-##-##-------#--#--##
##-----#--#----#--------####-##--------####----------###--#----#--##--------#-------##--#--#--#--#--
--#----##----#--#-###-----------------##----#--#----##----#----#-##-----#-#-----#-#--#-------#-#----
-#-#---#--#--#-------#-#---#--#--------##-----##--#-------#------##-##---#-##------#-#--#-#-#--##---
------##-----#-----##--##-------#-------##--#---#-----#--#-##----#--#---###--###-#--#----####-------
----##--#------##-----#--#---##------------#------#------#----#-----#-----#-##-#---##-----------##--
--#-##-----#-#--------------#----#-###-##-##-------------#--###------####--------------#----#---###-
--#--##-##---#--##-----#--#------#--###--##-#-#-------#-#-#---------#-###---#------#-#--#----#----##
---#-#---##-#-----------#-----#--#--#-##---#-##-----#-----#-#-----#------#--#---#---#--#------------
-#----##-#----#----#-----#--#-------#--#-------#-#---#---------#---###---#-#----#-#----#-#-#---#---#
###--##---##----#--##--------#-#--##---###-##--#----##----#----#----#----##--#------####--#--##-----
-----#-------#-###-----#-##----#---##----#----##---#---##---#---#--#--#--------#-#---##----####-#-#-
-#-#---#----#--------#----#---#-#-#-------#----###---##---#---#-#---#----#--------#-#--#-#-#---#-###
-------#-#----#-#-###---------------#---#---#-#----##--------#-###--#--#---#-#------#----#---#-#---#
##---#-#-#--#----#-----##-#-----#-##-#-##-----#-#--#--#---##-#-------#----#-##-#-#----#-###-#-#--#--
#-#-##-----#--#--##-##---##---#-----#-----#--------##------##-##-##-----------#-----#--#-----#-----#
##-##---######-----#-#-----#-----#--#---##--#--###--####-----------#-#-#----#-#--#--#-#------#------
------------#----###---#---#-#--#----##--##------##-##-#-#-##-####----###-------#----###------------
--#-----##-#-#--###---##--#--#-----#####-#-##-----#-#--#-#---------#-#---#-#-##--#-###-##------###-#
-----##--------#---#------#-#----#--#----##---##--##-------#-----#-#--------#----##--##--------#--##
-#----------#--#--#-#-#---##--------#----#---S---#-#-#----###---#-##-#-----------------######----##-
----##-##-#---#-#--------#--###-----#-#------##-------#--#-##------#--------#------#---#--#--#--#-#-
-#-####---#-###--#---##-#----#-----##-----##---------#--#-#-#-##-----#--#-#-#-#---#--#---#--------##
-##----#-##-#-#####----------#------#-#-#----#--#-####-#-#-#-------##-----#---#---#---#-------#--##-
-##-----------#----#-----##--------------#---##------#-#--#--#-#--#-#-##----##----##-##-#-#-##-#-#--
-#-----#-#---##---##------------##-----#-##-#-###----#--####--##-##-##---------#--#--####----------#
-#-#--###-#-#------#----#--#--#-#-----------------#----##--#--#------#----#-#--#----###---##---##-#-
#-#--#---####-#-#-#-#---#--------##-----#--#-###---#----#------#--#-#---#-------#-#-------------#-##
####--#--##------#---------------##-#####-##-#--##-##-#-##--#--#--#---##--#-##-##------#--#----#----
##--##----#-------##-----------#---##--#--#-#-#-##------#-#--#-##---------------#----#-#-#-#---##--#
-#---#-###-###--#-------#----------####--#--#-#--#--#--##-----##--#--#--#-#----#--#---#---#-##-#----
#--##-------#-#-------###-#--#---#--##--------------###----------------#----#---##------##-##---#-##
-#--------#---#-##-----##------###--##-#--##-#-##---#------------#------#--#---##---------#---#--#-#
#--#-------#--##-#--##-----#------##------#--#-#-###-#-#--#-#---#---#-#---#---#-###------#----#-#---
#----#---#---#---#-----###-#-##---#-##----#--#--##--#----#--#-----#--##----#-#--#-----#-#-----#-##--
--#---#--#-----#------##--#----#-----##-##--#-----#--------#--#-----#--#-##--###-##-#---#-#---##----
#---##--####--#---------#---##--##--------------#-----#----##------#-#---#-#---##--#------##-#---#--
--#--#--##-#-#--#-####--#--#---#-#--#####-###-#-##--#------##---#----#------###------#------#--#--##
-#-#-#-#-#--#----##-##---##--##-----##-----#--###---##----------########-#--#---##--##--##---#-#----
--#---#---#---##-----------##--##-#-------#--#-#####-##---#----#-##-#-#-------###-#--------#--#-----
------------#---##--#-#-----#--##--#####-#-##---#--------#----#--------#----#---------#-----######--
#-------#-#--##-###----#--#-----##---##---#--------#---#--##---##--#-#---####-----###-#--#-#-#--##-#
#--#--#-###-#-##------##-------------#-##--##------#--#--##--#-##---#-#----#--#---##--------#--#----
-#-##-------#---##-------#-#--#--#-#---#---#-#-----#----#--#------#----------##-#------##-----#--##-
#--#-#-#------##---#---##--#-------#-#---#-####--#--#-#-#---#--#---##--#-#--#-###---#-------#-#----#
----##----#----#-------#--#--##--#----#-#---------#--#----####-#-----#-#-#---------####--#----#-#-##
-#---#--#-#-#---#-#---#-------##----#---#--#---#--------##------#--#--------------##------#--##-----
-------#--#-#-##-####-#-#--#-###-#-#----------#-##----##-------#----------#-#--------##--#--#-------
---#---------##-#-----#------#-------#-###----#--##---#--###-#-----##--#--#-##----##----##-#-#--#-#-
-----##---#--#--##--#---##-#-----#----------###-#--#---#-----#-#------#--##--##----###-#-##--#--#---
#-------##-#-------####--#--#------------#-----#-##-##-#--#-##------##-#-------#-------###--#----#--
----###--#-------#----#-#-#-##-------#-------------#--#-#-##-##--#----------#-------#---#------##---
#-----#--------------#--##-----##-------#-#---##-#-##-#-#------#------#--#-#---#---#-#-------#----#-
#-----##-##-----#---#------#---#-----------------#----#-#-------#-#--#--#-#------##---#-#-----#-#--#
---##-----#--#---##---#-------#-#--#-------#------#--##-##------###------#--#--------#-------##--#--
-##--##-#---#-##------#--#----##----###------#-----------#----------##-#-####--##--------##----#---#
-------##-##---#-#------#---#----#-------#-#--#--#------#-#---------#----#--#----#--#####----#----##
####------#-##----#-##----#-###-----#--##--#----##-----#----------#----###-#---##-----#-#----------#
###--#-#--###-###------#--##---#----#------#-#----#-##--#-----#-#-#-#-####--##---#--##--------##----
--####--------##---##-----###-#-##-#-#-#-#--#-#---------##---####---###-#-#--###--####----------#-#-
--#--#-##-#-##-#--#----#---##-----###-------#-#--##-----##--##-----##-#----#----#-----#-----##---###
#-##--#----#--#-#-#-#---#-----#-###-#-#-#---##--##--#--#----##-#---##----#----#-#----#-------#------
------##--###-###---#------------#--###---#--------#-----#-----------#-----#-----#------#-------#---
#--#-#-----#--##---#------#-----------------#-#------#--#--#------###--#--#-#--#--##------#----###--
-#--##--#------#-##--#-#--##----#----#-#---#-------#--#----#---#-#-------#------##-#----#----####-#-
-#-#----#-#--------#---------#--#-#--#-#---#-----##----#---##----#####-#---#--##-#-#-----#--#-#----#
-----#-##--##----#--#----##-#--------###---##------####---##-##--##-#-----#-#---#--#-#--#--###---#--
-----#--#--#--------###--#----#------#-----#--#---#--#----#-------###-###-----------#-----#--#----#-