----------------------------------------------------------------------------------------------------
#-####-####-####-####-####-####-####-####-####-####-####-####-####-####-####-####-####-####-####-###
---##---##---##---##---##---##---##---##---##---##---##---##---##---##---##---##---##---##---##---##
#----#----#----#----#----#----#----#----#----#----#----#----#----#----#----#----#----#----#----#----
---#----#----#----#----#----#----#----#----#----#----#----#----#----#----#----#----#----#----#----#-
----------------------------------------------------------------------------------------------------
#-####-####-####-####-####-####-####-####-####-####-####-####-####-####-####-####-####-####-####-###
---##---##---##---##---##---##---##---##---##---##---##---##---##---##---##---##---##---##---##---##
#----#----#----#----#----#----#----#----#----#----#----#----#----#----#----#----#----#----#----#----
---#----#----#----#----#----#----#----#----#----#----#----#----#----#----#----#----#----#----#----#-
----------------------------------------------------------------------------------------------------
#-####-####-####-####-####-####-####-####-####-####-####-####-####-####-####-####-####-####-####-###
---##---##---##---##---##---##---##---##---##---##---##---##---##---##---##---##---##---##---##---##
#----#----#----#----#----#----#----#----#----#----#----#----#----#----#----#----#----#----#----#----
---#----#----#----#----#----#----#----#----#----#----#----#----#----#----#----#----#----#----#----#-
----------------------------------------------------------------------------------------------------
#-####-####-####-####-####-####-####-####-####-####-####-####-####-####-####-####-####-####-####-###
---##---##---##---##---##---##---##---##---##---##---##---##---##---##---##---##---##---##---##---##
#----#----#----#----#E---#----#----#----#----#----#----#----#----#----#----#----#----#----#----#----
---#----#----#----#----#----#----#----#----#----#----#----#----#----#----#----#----#----#----#----#-
----------------------------------------------------------------------------------------------------
#-####-####-####-####-####-####-####-####-####-####-####-####-####-####-####-####-####-####-####-###
---##---##---##---##---##---##---##---##---##---##---##---##---##---##---##---##---##---##---##---##
#----#----#----#----#----#----#----#----#----#----#----#----#----#----#----#----#----#----#----#----
---#----#----#----#----#----#----#----#----#----#----#----#----#----#----#----#----#----#----#----#-
----------------------------------------------------------------------------------------------------
#-####-####-####-####-####-####-####-####-####-####-####-####-####-####-####-####-####-####-####-###
---##---##---##---##---##---##---##---##---##---##---##---##---##---##---##---##---##---##---##---##
#----#----#----#----#----#----#----#----#----#----#----#----#----#----#----#----#----#----#----#----
---#----#----#----#----#----#----#----#----#----#----#----#----#----#----#----#----#----#----#----#-
----------------------------------------------------------------------------------------------------
#-####-####-####-####-####-####-####-####-####-####-####-####-####-####-####-####-####-####-####-###
---##---##---##---##---##---##---##---##---##---##---##---##---##---##---##---##---##---##---##---##
#----#----#----#----#----#----#----#----#----#----#----#----#----#----#----#----#----#----#----#----
---#----#----#----#----#----#----#----#----#----#----#----#----#----#----#----#----#----#----#----#-
----------------------------------------------------------------------------------------------------
#-####-####-####-####-####-####-####-####-####-####-####-####-####-####-####-####-####-####-####-###
---##---##---##---##---##---##---##---##---##---##---##---##---##---##---##---##---##---##---##---##
#----#----#----#----#----#----#----#----#----#----#----#----#----#----#----#----#----#----#----#----
---#----#----#----#----#----#----#----#----#----#----#----#----#----#----#----#----#----#----#----#-
----------------------------------------------------------------------------------------------------
#-####-####-####-####-####-####-####-####-####-####-####-####-####-####-####-####-####-####-####-###
---##---##---##---##---##---##---##---##---##---##---##---##---##---##---##---##---##---##---##---##
#----#----#----#----#----#----#----#----#----#----#----#----#----#----#----#----#----#----#--S-#----
---#----#----#----#----#----#----#----#----#----#----#----#----#----#----#----#----#----#----#----#-
----------------------------------------------------------------------------------------------------
#-####-####-####-####-####-####-####-####-####-####-####-####-####-####-####-####-####-####-####-###
---##---##---##---##---##---##---##---##---##---##---##---##---##---##---##---##---##---##---##---##
#----#----#----#----#----#----#----#----#----#----#----#----#----#----#----#----#----#----#----#----
---#----#----#----#----#----#----#----#----#----#----#----#----#----#----#----#----#----#----#----#-
----------------------------------------------------------------------------------------------------
#-####-####-####-####-####-####-####-####-####-####-####-####-####-####-####-####-####-####-####-###
---##---##---##---##---##---##---##---##---##---##---##---##---##---##---##---##---##---##---##---##
#----#----#----#----#----#----#----#----#----#----#----#----#----#----#----#----#----#----#----#----
---#----#----#----#----#----#----#----#----#----#----#----#----#----#----#----#----#----#----#----#-
----------------------------------------------------------------------------------------------------
#-####-####-####-####-####-####-####-####-####-####-####-####-####-####-####-####-####-####-####-###
---##---##---##---##---##---##---##---##---##---##---##---##---##---##---##---##---##---##---##---##
#----#----#----#----#----#----#----#----#----#----#----#----#----#----#----#----#----#----#----#----
---#----#----#----#----#----#----#----#----#----#----#----#----#----#----#----#----#----#----#----#-
----------------------------------------------------------------------------------------------------
#-####-####-####-####-####-####-####-####-####-####-####-####-####-####-####-####-####-####-####-###
---##---##---##---##---##---##---##---##---##---##---##---##---##---##---##---##---##---##---##---##
#----#----#----#----#----#----#----#----#----#----#----#----#----#----#----#----#----#----#----#----
---#----#----#----#----#----#----#----#----#----#----#----#----#----#----#----#----#----#----#----#-
----------------------------------------------------------------------------------------------------
#-####-####-####-####-####-####-####-####-####-####-####-####-####-####-####-####-####-####-####-###
---##---##---##---##---##---##---##---##---##---##---##---##---##---##---##---##---##---##---##---##
#----#----#----#----#----#----#----#----#----#----#----#----#----#----#----#----#----#----#----#----
---#----#----#----#----#----#----#----#----#----#----#----#----#----#----#----#----#----#----#----#-
----------------------------------------------------------------------------------------------------
#-####-####-####-####-####-####-####-####-####-####-####-####-####-####-####-####-####-####-####-###
---##---##---##---##---##---##---##---##---##---##---##---##---##---##---##---##---##---##---##---##
#----#----#----#----#----#----#----#----#----#----#----#----#----#----#----#----#----#----#----#----
---#----#----#----#----#----#----#----#----#----#----#----#----#----#----#----#----#----#----#----#-
----------------------------------------------------------------------------------------------------
#-####-####-####-####-####-####-####-####-####-####-####-####-####-####-####-####-####-####-####-###
---##---##---##---##---##---##---##---##---##---##---##---##---##---##---##---##---##---##---##---##
#----#----#----#----#----#----#----#----#----#----#----#----#----#----#----#----#----#----#----#----
---#----#----#----#----#----#----#----#----#----#----#----#----#----#----#----#----#----#----#----#-
----------------------------------------------------------------------------------------------------
#-####-####-####-####-####-####-####-####-####-####-####-####-####-####-####-####-####-####-####-###
---##---##---##---##---##---##---##---##---##---##---##---##---##---##---##---##---##---##---##---##
#----#----#----#----#----#----#----#----#----#----#----#----#----#----#----#----#----#----#----#----
---#----#----#----#----#----#----#----#----#----#----#----#----#----#----#----#----#----#----#----#-
----------------------------------------------------------------------------------------------------
#-####-####-####-####-####-####-####-####-####-####-####-####-####-####-####-####-####-####-####-###
---##---##---##---##---##---##---##---##---##---##---##---##---##---##---##---##---##---##---##---##
#----#----#----#----#----#----#----#----#----#----#----#----#----#----#----#----#----#----#----#----
---#----#----#----#----#----#----#----#----#----#----#----#----#----#----#----#----#----#----#----#-
----------------------------------------------------------------------------------------------------
#-####-####-####-####-####-####-####-####-####-####-####-####-####-####-####-####-####-####-####-###
---##---##---##---##---##---##---##---##---##---##---##---##---##---##---##---##---##---##---##---##
#----#----#----#----#----#----#----#----#----#----#----#----#----#----#----#----#----#----#----#----
---#----#----#----#----#----#----#----#----#----#----#----#----#----#----#----#----#----#----#----#-
----------------------------------------------------------------------------------------------------
#-####-####-####-####-####-####-####-####-####-####-####-####-####-####-####-####-####-####-####-###
---##---##---##---##---##---##---##---##---##---##---##---##---##---##---##---##---##---##---##---##
#----#----#----#----#----#----#----#----#----#----#----#----#----#----#----#----#----#----#----#----
---#----#----#----#----#----#----#----#----#----#----#----#----#----#----#----#----#----#----#----#-