---#----#----#----#----#----#----#----#----#----#----#----#----#----#----#----#----#----#----#----#-
###--###--###--###--###--###--###--###--###--###--###--###--###--###--###--###--###--###--###--###--
#----#----#----#----#----#----#----#----#----#----#----#----#----#----#----#----#----#----#----#----
#----#----#----#----#----#----#----#----#----#----#----#----#----#----#----#----#----#----#----#----
#----#----#----#----#----#----#----#----#----#----#----#----#----#----#----#----#----#----#----#----
---#----#----#----#----#----#----#----#----#----#----#----#----#----#----#----#----#----#----#----#-
###--###--###--###--###--###--###--###--###--###--###--###--###--###--###--###--###--###--###--###--
#----#----#----#----#----#----#----#----#----#----#----#----#----#----#----#----#----#----#----#----
#----#----#----#----#----#----#----#----#----#----#----#----#----#----#----#----#----#----#----#----
#----#----#----#----#----#----#----#----#----#----#----#----#----#----#----#----#----#----#----#----
---#----#----#----#----#----#----#----#----#----#----#----#----#----#----#----#----#----#----#----#-
###--###--###--###--###--###--###--###--###--###--###--###--###--###--###--###--###--###--###--###--
#----#----#----#----#----#----#----#----#----#----#----#----#----#----#----#----#----#----#----#----
#----#----#----#----#----#----#----#----#----#----#----#----#----#----#----#----#----#----#----#----
#----#----#----#----#----#----#----#----#----#----#----#----#----#----#----#----#----#----#----#----
---#----#----#----#----#----#----#----#----#----#----#----#----#----#----#----#----#----#----#----#-
###--###--###--###--###--###--###--###--###--###--###--###--###--###--###--###--###--###--###--###--
#----#----#----#----#----#----#----#----#----#----#----#----#----#----#----#----#----#----#----#----
#----#----#----#----#----#----#----#----#----#----#----#----#----#----#----#----#----#----#----#----
#----#----#----#----#----#----#----#----#----#----#----#----#----#----#----#----#----#----#----#----
---#----#----#----#----#----#----#----#----#----#----#----#----#----#----#----#----#----#----#----#-
###--###--###--###--###--###--###--###--###--###--###--###--###--###--###--###--###--###--###--###S-
#----#----#----#----#----#----#----#----#----#----#----#----#----#----#----#----#----#----#----#----
#----#----#----#----#----#----#----#----#----#----#----#----#----#----#----#----#----#----#----#----
#----#----#----#----#----#----#----#----#----#----#----#----#----#----#----#----#----#----#----#----
---#----#----#----#----#----#----#----#----#----#----#----#----#----#----#----#----#----#----#----#-
###--###--###--###--###--###--###--###--###--###--###--###--###--###--###--###--###--###--###--###--
#----#----#----#----#----#----#----#----#----#----#----#----#----#----#----#----#----#----#----#----
#----#----#----#----#----#----#----#----#----#----#----#----#----#----#----#----#----#----#----#----
#----#----#----#----#----#----#----#----#----#----#----#----#----#----#----#----#----#----#----#----
---#----#----#----#----#----#----#----#----#----#----#----#----#----#----#----#----#----#----#----#-
###--###--###--###--###--###--###--###--###--###--###--###--###--###--###--###--###--###--###--###--
#----#----#----#----#----#----#----#----#----#----#----#----#----#----#----#----#----#----#----#----
#----#----#----#----#----#----#----#----#----#----#----#----#----#----#----#----#----#----#----#----
#----#----#----#----#----#----#----#----#----#----#----#----#----#----#----#----#----#----#----#----
---#----#----#----#----#----#----#----#----#----#----#----#----#----#----#----#----#----#----#----#-
###--###--###--###--###--###--###--###--###--###--###--###--###--###--###--###--###--###--###--###--
#----#----#----#----#----#----#----#----#----#----#----#----#----#----#----#----#----#----#----#----
#----#----#----#----#----#----#----#----#----#----#----#----#----#----#----#----#----#----#----#----
#----#----#----#----#----#----#----#----#----#----#----#----#----#----#----#----#----#----#----#----
---#----#----#----#----#----#----#----#----#----#----#----#----#----#----#----#----#----#----#----#-
###--###--###--###--###--###--###--###--###--###--###--###--###--###--###--###--###--###--###--###--
#----#----#----#----#----#----#----#----#----#----#----#----#----#----#----#----#----#----#----#----
#----#----#----#----#----#----#----#----#----#----#----#----#----#----#----#----#----#----#----#----
#----#----#----#----#----#----#----#----#----#----#----#----#----#----#----#----#----#----#----#----
---#----#----#----#----#----#----#----#----#----#----#----#----#----#----#----#----#----#----#----#-
###--###--###--###--###--###--###--###--###--###--###--###--###--###--###--###--###--###--###--###--
#----#----#----#----#----#----#----#----#----#----#----#----#----#----#----#----#----#----#----#----
#----#----#----#----#----#----#----#----#----#----#----#----#----#----#----#----#----#----#----#----
#----#----#----#----#----#----#----#----#----#----#----#----#----#----#----#----#----#----#----#----
---#----#----#----#----#----#----#----#----#----#----#----#----#----#----#----#----#----#----#----#-
###--###--###--###--###--###--###--###--###--###--###--###--###--###--###--###--###--###--###--###--
#----#----#----#----#----#----#----#----#----#----#----#----#----#----#----#----#----#----#----#----
#----#----#----#----#----#----#----#----#----#----#----#----#----#----#----#----#----#----#----#----
#----#----#----#----#----#----#----#----#----#----#----#----#----#----#----#----#----#----#----#----
---#----#----#----#----#----#----#----#----#----#----#----#----#----#----#----#----#----#----#----#-
###--###--###--###--###--###--###--###--###--###--###--###--###--###--###--###--###--###--###--###--
#----#----#----#----#----#----#----#----#----#----#----#----#----#----#----#----#----#----#----#----
#----#----#----#----#----#----#----#----#----#----#----#----#----#----#----#----#----#----#----#----
#----#----#----#----#----#----#----#----#----#----#----#----#----#----#----#----#----#----#----#----
---#----#----#----#----#----#----#----#----#----#----#----#----#----#----#----#----#----#----#----#-
###--###--###--###--###--###--###--###--###--###--###--###--###--###--###--###--###--###--###--###--
#----#----#----#----#----#----#----#----#----#----#----#----#----#----#----#----#----#----#----#----
#----#----#----#----#----#----#----#----#----#----#----#----#----#----#----#----#----#----#----#----
#----#----#----#----#----#----#----#----#----#----#----#----#----#----#----#----#----#----#----#----
---#----#----#----#----#----#----#----#----#----#----#----#----#----#----#----#----#----#----#----#-
###--###--###--###--###--###--###--###--###--###--###--###--###--###--###--###--###--###--###--###--
#----#----#----#----#----#----#----#----#----#----#----#----#----#----#----#----#----#----#----#----
#----#----#----#----#----#----#----#----#----#----#----#----#----#----#----#----#----#----#----#----
#----#----#----#----#----#----#----#----#----#----#----#----#----#----#----#----#----#----#----#----
---#----#----#----#----#----#----#----#----#----#----#----#----#----#----#----#----#----#----#----#-
###--###--###--###--###--###--###--###--###--###--###--###--###--###--###--###--###--###--###--###--
#----#----#----#----#----#----#----#----#----#----#----#----#----#----#----#----#----#----#----#----
#----#----#----#----#----#----#----#----#----#----#----#----#----#----#----#----#----#----#----#----
#----#----#----#----#----#----#----#----#----#----#----#----#----#----#----#----#----#----#----#----
---#----#----#----#----#----#----#----#----#----#----#----#----#----#----#----#----#----#----#----#-
###--###--###--###--###--###--###--###--###--###--###--###--###--###--###--###--###--###--###--###--
#----#----#----#----#----#----#----#----#----#----#----#----#----#----#----#----#----#----#----#----
#----#----#----#----#----#----#----#----#----#----#----#----#----#----#----#----#----#----#----#----
#----#----#----#----#----#----#----#----#----#----#----#----#----#----#----#----#----#----#----#----
---#----#----#----#----#----#----#----#----#----#----#----#----#----#----#----#----#----#----#----#-
###--###--###--###--###--###--###--###--###--###--###--###--###--###--###--###--###--###--###--###--
#----#----#----#----#----#----#----#----#----#----#----#----#----#----#----#----#----#----#----#----
#----#----#----#----#----#----#----#----#----#----#----#----#----#----#----#----#----#----#----#----
#----#----#----#----#----#----#----#----#----#----#----#----#----#----#----#----#----#----#----#----
---#----#----#----#----#----#----#----#----#----#----#----#----#----#----#----#----#----#----#----#-
###--###--###--###--###--###--###--###--###--###--###--###--###--###--###--###--###--###--###--###--
#----#----#----#----#----#----#----#----#----#----#----#----#----#----#----#----#----#----#----#----
#----#----#----#----#----#----#----#----#----#----#----#----#----#----#----#----#----#----#----#----
#----#----#----#----#----#----#----#----#----#----#----#----#----#----#----#----#----#----#----#----
---#----#----#----#----#----#----#----#----#----#----#----#----#----#----#----#----#----#----#----#-
###--###--###--###--###--###--###--###--###--###--###--###--###--###--###--###--###--###--###--###--
#----#----#----#----#----#----#----#----#----#----#----#----#----#----#----#----#----#----#----#----
#----#----#----#----#----#----#----#----#----#----#----#----#----#----#----#----#----#---E#----#----
#----#----#----#----#----#----#----#----#----#----#----#----#----#----#----#----#----#----#----#----
---#----#----#----#----#----#----#----#----#----#----#----#----#----#----#----#----#----#----#----#-
###--###--###--###--###--###--###--###--###--###--###--###--###--###--###--###--###--###--###--###--
#----#----#----#----#----#----#----#----#----#----#----#----#----#----#----#----#----#----#----#----
#----#----#----#----#----#----#----#----#----#----#----#----#----#----#----#----#----#----#----#----
#----#----#----#----#----#----#----#----#----#----#----#----#----#----#----#----#----#----#----#----