#----#--------#-#####--#---#--#---#----#-----#-##--#---#-----#---#----###--#-#---##-------##--------
##--#-------#--#--##--#---#--#-##-----#----#---#----#-#-----#--#--#-##------##-#-----#-#-#---#-##--#
--#-#-------####-#-###----#---#---#----#-------#-----##-----#-#------#------##---##--###---###------
#---#--##--#-#---##-----###------#---#---#-#-------------#---------#-#-#-#-##----#-----##-#-##-#-##-
-#--#--#----------###------#---#-####-------#--#----#----#--#----------#----------#-##------#----#--
--#---#---#-###------------##--##-#-#---#---##----##-#--#--#---#----##---#--#-#----##---#------##-#-
-----#------#--##-#####---#-#-#--------#---#-##----##-----#---#-#--#----####--#----#--###-----------
-##-##----------##--#-----#----#--#-----##----#--##--#-----#-##-----#-##--##---#####--###--#-#------
#---###-#----#-#-##--#----#-#---#----#-###----#---#---------#---#-----#-----#-#--#---#-#------#-----
--##-#---#---#-#---#---##-------#------#-------###--#-----##----#--------#---#-##-#-#--#----##--###-
#--#--#--###--##-------#----------##-----#--#--#------#--#---##-#---#---#-##-##---#-##--------------
#--#-##-#----#-##-##---#-#---##---#--###-#--#-#------#---------##-#--#-----####-#--###----##---###--
--#-#-#------#-#---#---##-###-#-----#-----#------#-----##----#-----------##-----#---#-----#------##-
#---#----##---#-#-##---#--#-##-#-------#-#--#---#-#-#-----#--------###------#-##---#--#-#----------#
------#-------##-#-----#----#--#--##--#-------#-------#---#--------##-#----------#---#####-#-#------
-#--#-#--#------#---#-----#---##---#--##----##-###-----###----#-##-#----#--#---#-------##--###-##---
##-##-------##--#--------##-------#---#---#-#--------#----##------------#---#---#-#------#---------#
#-----#---##------##-----#-#-##---#--#--#---#-----#-----#-----#--##-----#-#-#-#####-#-#-------------
#-#-###---#----##----#-----#---#----------#------##-----###----#----#-----------###------##-##------
#--#----#-###-##--##-------#---#---#----#-----##----#-##---------#--#-#--------#----#---#--#------#-
----#---#-#------#---###----#---#--#--##--##-#--#--#---##-#---------#----#-#-----------#-#---#--#-#-
---#----##---###--##---#-#--#-----#--#----------#----#-#-#-#-##---#----##-#--#--##--###------###-#--
---#-#----#--##--#-#---------#-#-#------#-#---##-#-#-##---#---#-------------#--#--##----------------
---#-#--#-##--##-##---------##-----#-----#--##--##---------##--#-#----##-#-#-#----#--#-------##-#---
--##-----##-##-#-#---#-#----#-#-##-----#----#-##---#-#---#---------##-#------#-#-#-----#----#-#---#-
#-#-#-#------#-#####--------------#####----#----#--##-##-#-#-##--##--#---#---#------#-----#---#-----
----#---##--#--#--###----#---#-#----#--#-------#---#--#-#-##-#-------#--##--#-#-#-#-##-#----##-#-#--
--##--#--#-#-##----##---##--#---------------#-#---##---#---------#--#-#---#---#--#-#-#----#-##-#-###
---------###----#-------#---#-##--#--#-##--##--#--##-##--#---#-----#---###---#--#-#---#-#--##-----##
---##-#---------#-------#--##---------#----###-###----##---#-#-----#--#---##----------#--#-#--------
#-#-#--##--#---#--##----#-----##--#--------#--#-#--###-##-#---#-#--#--#------#---#--------#---------
-#----------#-#-#---------#-------#----#---##-----------#-----##----------#---#------####----#---#--
--#---#---#---##-#-#---#-------#-----#----#-####-#-----#--###-----------#-#-#--##-#--#--#--#-#--#--#
---#--#--##-#----#--#-#--#-#--#---#---#----#-#-----#-#-##------#--#---#-#--##--#-###--#---##------#-
-#--#-#-#-#---#----------S-#----###---#--##-#####-###----##---#--------#---#----#----------------#-#
------##-----#-----####-#---##--#-----#----#---#--#--#---#--------#---#--#-----#-------#--##----#--#
#-##-#-#-#-#---###-----#-#----#----####---#--##--#--#---#--#-#---###----#---##-------#-#-#-#------#-
-#------------#------##-#--#----#-#--#-----###-#--#-#---------#---------##--##---#-#--#-#-#-#-#--#--
----------###-----###---#---#---#---#-#--#---#-----#---#---##-------------------###---#--#----#----#
---#-------------#-#-#-#-----#----#----#-----##--#-#-#-###---#-#-#-##-####--##---#---#-##----#-----#
-######----#----#--#--#----#---#-#-##---#--#-#--#--#-----##-------#------#-#------#--#--#---#--#----
----#----#---#------##--------#--#------#---#-##--------------##-##--#-##------#----#-##--#--####-#-
-##--------------#--#--#--#----#-#--#---#--#-#-----###--------------###-----#----#-#-###-##--#---#--
----##--#-#-##--#---##-#-------------##-----#----##--#-#---##-##------##-------#-----#-#-#------#-##
---#-------#-#-----##--#--#-#-####------###-#-###----##--##---#----#---#--#------#--##--#-#--##-----
-##-##----#----#--------##------#-##-#-#-##--#---####-#---------#--------#----##-###--#---#-##---##-
##-------#-----------------#-#-###-#----###-------#-#--###-----#---------------#---#------##--------
###-#-#-#------##-------##---#-#--#-##-----###---#----#--#--------#--###-----#-#--#-###------##---#-
##--##----##-##-##---#----##----------######---#----#######---#--#---#--#-#----#---##--#--------#---
###--#--#------#--###------#--##-----###-##-###-#---#-##------#---#-##--#-------#------##---#-#--##-
--#--#-#-------#-------#-#--#----#-----#----##--##-##---#-#---###--#--------###-##----##-----#------
-#-#-----###-#--#---#----------#--####------------#--------#-##-#--##--#-------------#-##--#-##---##
-----####----#--#-#-##-#---#-#--##----##--#--#-----###------#----#-#------#--#####--#-#----#####-#-#
-------#-#---##----###-##--------#-#----#-----#--#--##-#-----#---#-##--#-----#---------##---##--#---
---#-##---#---#------#--#####-----##-------#--#-#---#-----##-----#-#-#--#-##-----#-------#-#---#--#-
--------#-##-#--###---#----#--##-#--#----###----------##-#--------------#-##--#-----#----#----##--##
--#----###------#--#----####-#--###---##--#---#--#--#-##-#-#---##----#-#-#-----#--##-##---#--#------
####--#-#--#------#--#---##------##------##--##--#--#-#-#-#-##-#-#-##--------#---#--------##-#--####
#-----#----##----###------#-#--#-#-#---#---#--#----###--------#-#---#-#--#------#----##--#---------#
--#--##------------------##-###---##----#--#---#---------------#-#--#----#-#-----#-----##--#---#-#--
#----------##-###--##-#-##--##--------#--#-------#-#---#-#--#---------#---#-#-#-#-----#-#-----------
---#-##-#--#---------#--#-#-#-#---#-#----#--##-------#--#-#-#-----###--##-##--###--------------#---#
--#----#--#-####-------#-------#-#---#-------#-#--#------#-#---#-#-##--------##-##------#--#--##---#
#--##-----##---#-##-----------#-##-#----##-----####-#--#-#-#-#-----##--#------#--#-##--#-#-#-#--#-##
#-#--#-#---#-###---##----#-##-##-----------#-#---------#-#-##--#--#-------#-----#-#-#-#---##-------#
---##-----#--#-#--#---#-----------##----------#--#--##---#-#-#-##------###-#---##----------#----#--#
-##--#------#--##--#-#---#---#------------#-#--#--#-##-##----------#-#------#--#-#--------#-------#-
---#---#----#-#--##-#---#-----#--#-#-#------#-###------#---#----#---#-###-#--#---#-#-------#-#-#-#--
---#-#---#----#-#-#---#--####-#---#--#------#-#----#----##----#-----#--#--#-###---------##-#------#-
--------#--#-####-####------------#------------###--###--#--#-------#-#-##-#-#--#-----##--#-##---##-
--#---##--#---#----------------#--#------#--#--#-#------####--#--###--##-####--#-#----###-#-----#--#
-----#-##--##--#-----#--#----###---##---#--#-#---#-----#--#----------#---#------------#-#--#-#---#--
-------##-#-----#---###--##---##-###-#----------#-#-----#---#----#----#---#-----#----#---#-#--------
#-#---#---#---#-#---##--#--#-----#-#--#---#---#-##---#------#-###-#---#-#--#---#-#----###-#-#-------
#-#-#--#--#-------##-#--##-#---#--#-----#-#-###-----#---------#-#-#####--##---#-------#-#-#-----#-##
#-----###-#-----#--#---#--#-------#--#-#--###-#----#----------#----##----#---#--------#-#--##-#--###
--#-#-----------####--##-#-##--#--------#--#-------#--------#-#-##----#-###--#-##-----#-------#--#-#
----#--##-------------------#--#-##---###-##-#---#-#--#---#---#-#-#---#-#-##-#---###-#-#--#--#-#-#--
--#-##-#-#---#-#--#----#----###---##-#------#---------#--#-####-#--#--#--#-#------#-----#--###------
--##---------##---##------#--#---#---#--#-##--##---#-------#---#-#---####--#-----------##-#---##--#-
------##--#--#-------#-----------#--#--#-#----##-###--#----#-#-------#---------#-#---#------##--#-#-
--###----##-----##--##--#----##--#---#-###---##-#-----#--#---------#-------#-----#-#--#-------#--#--
-#---#--#-##-----#--#----#-------#--#-#-----###-#-##---------#-#----------###-#------###-----#-----#
----##-#-#--##---------#----##---#-----###-#-------#--------#---#--#----##-#---#--------------------
-----#--#-#----#-##-#-----#------#---#------##-----#-----##--#--#-----------#------#-#-##-------#---
--##---#---#--##-#-#---#-#-#------#----#--#-----------#--------------##-#----#-#-###-#----#-#-##-#-#
--#----##-----##-------#-##-##-#-#--#--#-#--##-#-#-#-##---####-#--#-#-----#-#--#--#--#---------#----
#----###---#-#---#---#-##-###-------------------------#--#-#-#--#---##-----#-#-------------##--##---
--##----###--#---##E-##----#----#---#-##--#----#-#--##------#----#-#--#-####--#--##--##--#-#----#--#
---#-##-##------#--#----#-----------------#-----###--#-----#---#-##----#----##--#---#--#-#----####--
--###---#-#-----#-----#--#--#--------###----##--------#--##--##---#-####----#------#-#----#----#----
--##-----#------------#----#-##-##---###-----##-----#--#--------------#------##--#######--#--###--#-
-#---#-##---#-##---#---####---#---###-##---##-##----##--#---###-------#-#-#--#---#----##------###---
#----#-#---#-#--------#-#--------#---#---#-#----------#-##--#-#---#-#---#---#---#-####--#----#----##
#-##---------##------------------#--#-#--#-#----------#--#-----#---#-#-##------#-###------##---#----
-#---#---#--------#---#--###-##--#-###--####--#-#------#---------#------#####----#--#--##-----##--#-
-------------##--###--#--#-#----#--#---#--#-----#--#-#--#---#-#--#-#--#-#-#-#-##-##------------##---
#--#----#----#--##---------#-----#---#--#--#-##---#-#----##---########--##--#-#---#---#--#----------
#---##---#---##----#---#----#-#-#--#--#--#-----##----###-#----#-#--#-#------#---------------#-#--#--
--#-#-#--##--##-----##--#---#--#-##-#----#-#-------##-----##-#----###-------------------#--#--#--##-