----------------------------------------------------------------------------------------------------
-#-##-#-##-#-##-#-##-#-##-#-##-#-##-#-##-#-##-#-##-#-##-#-##-#-##-#-##-#-##-#-##-#-##-#-##-#-##-#-##
##-#-##-#-##-#-##-#-##-#-##-#-##-#-##-#-##-#-##-#-##-#-##-#-##-#-##-#-##-#-##-#-##-#-##-#-##-#-##-#-
----------------------------------------------------------------------------------------------------
---#----#----#----#----#----#----#----#----#----#-E--#----#----#----#----#----#----#----#----#----#-
----------------------------------------------------------------------------------------------------
-#-##-#-##-#-##-#-##-#-##-#-##-#-##-#-##-#-##-#-##-#-##-#-##-#-##-#-##-#-##-#-##-#-##-#-##-#-##-#-##
##-#-##-#-##-#-##-#-##-#-##-#-##-#-##-#-##-#-##-#-##-#-##-#-##-#-##-#-##-#-##-#-##-#-##-#-##-#-##-#-
----------------------------------------------------------------------------------------------------
---#----#----#----#----#----#----#----#----#----#----#----#----#----#----#----#----#----#----#----#-
----------------------------------------------------------------------------------------------------
-#-##-#-##-#-##-#-##-#-##-#-##-#-##-#-##-#-##-#-##-#-##-#-##-#-##-#-##-#-##-#-##-#-##-#-##-#-##-#-##
##-#-##-#-##-#-##-#-##-#-##-#-##-#-##-#-##-#-##-#-##-#-##-#-##-#-##-#-##-#-##-#-##-#-##-#-##-#-##-#-
----------------------------------------------------------------------------------------------------
---#----#----#----#----#----#----#----#----#----#----#----#----#----#----#----#----#----#----#----#-
----------------------------------------------------------------------------------------------------
-#-##-#-##-#-##-#-##-#-##-#-##-#-##-#-##-#-##-#-##-#-##-#-##-#-##-#-##-#-##-#-##-#-##-#-##-#-##-#-##
##-#-##-#-##-#-##-#-##-#-##-#-##-#-##-#-##-#-##-#-##-#-##-#-##-#-##-#-##-#-##-#-##-#-##-#-##-#-##-#-
----------------------------------------------------------------------------------------------------
---#----#----#----#----#----#----#----#----#----#----#----#----#----#----#----#----#----#----#----#-
----------------------------------------------------------------------------------------------------
-#-##-#-##-#-##-#-##-#-##-#-##-#-##-#-##-#-##-#-##-#-##-#-##-#-##-#-##-#-##-#-##-#-##-#-##-#-##-#-##
##-#-##-#-##-#-##-#-##-#-##-#-##-#-##-#-##-#-##-#-##-#-##-#-##-#-##-#-##-#-##-#-##-#-##-#-##-#-##-#-
----------------------------------------------------------------------------------------------------
---#----#----#----#----#----#----#----#----#----#----#----#----#----#----#----#----#----#----#----#-
----------------------------------------------------------------------------------------------------
-#-##-#-##-#-##-#-##-#-##-#-##-#-##-#-##-#-##-#-##-#-##-#-##-#-##-#-##-#-##-#-##-#-##-#-##-#-##-#-##
##-#-##-#-##-#-##-#-##-#-##-#-##-#-##-#-##-#-##-#-##-#-##-#-##-#-##-#-##-#-##-#-##-#-##-#-##-#-##-#-
----------------------------------------------------------------------------------------------------
---#----#----#----#----#----#----#----#----#----#----#----#----#----#----#----#----#----#----#----#-
----------------------------------------------------------------------------------------------------
-#-##-#-##-#-##-#-##-#-##-#-##-#-##-#-##-#-##-#-##-#-##-#-##-#-##-#-##-#-##-#-##-#-##-#-##-#-##-#-##
##-#-##-#-##-#-##-#-##-#-##-#-##-#-##-#-##-#-##-#-##-#-##-#-##-#-##-#-##-#-##-#-##-#-##-#-##-#-##-#-
----------------------------------------------------------------------------------------------------
---#----#----#----#----#----#----#----#----#----#----#----#----#----#----#----#----#----#----#----#-
----------------------------------------------------------------------------------------------------
-#-##-#-##-#-##-#-##-#-##-#-##-#-##-#-##-#-##-#-##-#-##-#-##-#-##-#-##-#-##-#-##-#-##-#-##-#-##-#-##
##-#-##-#-##-#-##-#-##-#-##-#-##-#-##-#-##-#-##-#-##-#-##-#-##-#-##-#-##-#-##-#-##-#-##-#-##-#-##-#-
----------------------------------------------------------------------------------------------------
---#----#----#----#----#----#----#----#----#----#----#----#----#----#----#----#----#----#----#----#-
----------------------------------------------------------------------------------------------------
-#-##-#-##-#-##-#-##-#-##-#-##-#-##-#-##-#-##-#-##-#-##-#-##-#-##-#-##-#-##-#-##-#-##-#-##-#-##-#-##
##-#-##-#-##-#-##-#-##-#-##-#-##-#-##-#-##-#-##-#-##-#-##-#-##-#-##-#-##-#-##-#-##-#-##-#-##-#-##-#-
----------------------------------------------------------------------------------------------------
---#----#----#----#----#----#----#----#----#----#----#----#----#----#----#----#----#----#----#----#-
----------------------------------------------------------------------------------------------------
-#-##-#-##-#-##-#-##-#-##-#-##-#-##-#-##-#-##-#-##-#-##-#-##-#-##-#-##-#-##-#-##-#-##-#-##-#-##-#-##
##-#-##-#-##-#-##-#-##-#-##-#-##-#-##-#-##-#-##-#-##-#-##-#-##-#-##-#-##-#-##-#-##-#-##-#-##-#-##-#-
----------------------------------------------------------------------------------------------------
---#----#----#----#----#----#----#----#----#----#----#----#----#----#----#----#----#----#----#----#-
----------------------------------------------------------------------------------------------------
-#-##-#-##-#-##-#-##-#-##-#-##-#-##-#-##-#-##-#-##-#-##-#-##-#-##-#-##-#-##-#-##-#-##-#-##-#-##-#-##
##-#-##-#-##-#-##-#-##-#-##-#-##-#-##-#-##-#-##-#-##-#-##-#-##-#-##-#-##-#-##-#-##-#-##-#-##-#-##-#-
----------------------------------------------------------------------------------------------------
---#----#----#----#----#----#----#----#----#----#----#----#----#----#----#----#----#----#----#----#-
----------------------------------------------------------------------------------------------------
-#-##-#-##-#-##-#-##-#-##-#-##-#-##-#-##-#-##-#-##-#-##-#-##-#-##-#-##-#-##-#-##-#-##-#-##-#-##-#-##
##-#-##-#-##-#-##-#-##-#-##-#-##-#-##-#-##-#-##-#-##-#-##-#-##-#-##-#-##-#-##-#-##-#-##-#-##-#-##-#-
----------------------------------------------------------------------------------------------------
---#----#----#----#----#----#----#----#----#----#----#----#----#----#----#----#----#----#----#----#-
----------------------------------------------------------------------------------------------------
-#-##-#-##-#-##-#-##-#-##-#-##-#-##-#-##-#-##-#-##-#-##-#-##-#-##-#-##-#-##-#-##-#-##-#-##-#-##-#-##
##-#-##-#-##-#-##-#-##-#-##-#-##-#-##-#-##-#-##-#-##-#-##-#-##-#-##-#-##-#-##-#-##-#-##-#-##-#-##-#-
----------------------------------------------------------------------------------------------------
---#----#----#----#----#----#----#----#----#----#----#----#----#----#----#----#----#----#----#----#-
----------------------------------------------------------------------------------------------------
-#-##-#-##-#-##-#-##-#-##-#-##-#-##-#-##-#-##-#-##-#-##-#-##-#-##-#-##-#-##-#-##-#-##-#-##-#-##-#-##
##-#-##-#-##-#-##-#-##-#-##-#-##-#-##-#-##-#-##-#-##-#-##-#-##-#-##-#-##-#-##-#-##-#-##-#-##-#-##-#-
----------------------------------------------------------------------------------------------------
---#----#----#----#----#----#----#----#----#----#----#----#----#----#----#----#----#----#----#----#-
----------------------------------------------------------------------------------------------------
-#-##-#-##-#-##-#-##-#-##-#-##-#-##-#-##-#-##-#-##-#-##-#-##-#-##-#-##-#-##-#-##-#-##-#-##-#-##-#-##
##-#-##-#-##-#-##-#-##-#-##-#-##-#-##-#-##-#-##-#-##-#-##-#-##-#-##-#-##-#-##-#-##-#-##-#-##-#-##-#-
----------------------------------------------------------------------------------------------------
---#----#----#----#----#----#----#----#----#----#----#----#----#----#----#----#----#----#----#----#-
----------------------------------------------------------------------------------------------------
-#-##-#-##-#-##-#-##-#-##-#-##-#-##-#-##-#-##-#-##-#-##-#-##-#-##-#-##-#-##-#-##-#-##-#-##-#-##-#-##
##-#-##-#-##-#-##-#-##-#-##-#-##-#-##-#-##-#-##-#-##-#-##-#-##-#-##-#-##-#-##-#-##-#-##-#-##-#-##-#-
----------------------------------------------------------------------------------------------------
---#----#----#----#----#----#----#----#----#----#----#----#----#----#----#----#----#----#----#----#-
----------------------------------------------------------------------------------------------------
-#-##-#-##-#-##-#-##-#-##-#-##-#-##-#-##-#-##-#-##-#-##-#-##-#-##-#-##-#-##-#-##-#-##-#-##-#-##-#-##
##-#-##-#-##-#-##-#-##-#-##-#-##-#-##-#-##-#-##-#-##-#-##-#-##-#-##-#-##-#-##-#-##-#-##-#-##-#-##-#-
----------------------------------------------------------------------------------------------------
---#----#----#----#----#----#----#----#----#----#----#----#----#----#----#----#----#----#----#----#-
----------------------------------------------------------------------------------------------------
-#-##-#-##-#-##-#-##-#-##-#-##-#-##-#-##-#-##-#-##-#-##-#-##-#-##-#-##-#-##-#-##-#-##-#-##-#-##-#-##
##-#-##-#-##-#-##-#-##-#-##-#-##-#-##-#-##-#-##-#-##-#-##-#-##-#-##-#-##-#-##-#-##-#-##-#-##-#-##-#-
----------------------------------------------------------------------------------------------------
---#----#----#----#----#----#----#----#----#----#----#----#----#----#----#----#----#----#----#----#-
----------------------------------------------------------------------------------------------------
-#-##-#-##-#-##-#-##-#-##-#-##-#-##-#-##-#-##-#-##-#-##-#-##-#-##-#-##-#-##-#-##-#-##-#-##-#-##-#-##
##-#-##-#-##-#-##-#-##-#-##-#-##-#-##-#-##-#-##-#-##-#-##-#-##-#-##-#-##-#-##-#-##-#-##-#-##-#-##-#-
--------------------------------------------------------S-------------------------------------------
---#----#----#----#----#----#----#----#----#----#----#----#----#----#----#----#----#----#----#----#-
----------------------------------------------------------------------------------------------------
-#-##-#-##-#-##-#-##-#-##-#-##-#-##-#-##-#-##-#-##-#-##-#-##-#-##-#-##-#-##-#-##-#-##-#-##-#-##-#-##
##-#-##-#-##-#-##-#-##-#-##-#-##-#-##-#-##-#-##-#-##-#-##-#-##-#-##-#-##-#-##-#-##-#-##-#-##-#-##-#-
----------------------------------------------------------------------------------------------------
---#----#----#----#----#----#----#----#----#----#----#----#----#----#----#----#----#----#----#----#-