---#---##-###-#----#---#-------#-#----##---------#--#-#-#---##--###------#---###-#----###---------#-
#---#-----#--#-#-#-####-#-#--##-##--#-#----###--#-###------#------------#---###--#-##-#----#---#----
#---#-#---#-#------#------##----###--------------##-----#----#-#---#-###--#--##-##-#-###----##-##--#
#--#--#--#------##--------#-------#-----##------#-#-#--#-------------#-##-----#-#-#--##-###---#--#-#
##------#------##-#--#--------#---##-#--##------####---#-#-#---------#---#----#-#--##--#-----##--#--
##-----#---#-----##---#--#-------###--#---##-#-#---#-##--#---#-#----#-#--###-----##-##---#--##------
-#-#----###-----#######------#---------#--#----------------#--#--#-----------------------#-#--#----#
----------##-#-----#--#--#-#-#-#-##-#--#-#-##-#-#--#--#-#-------------##---#--#---#---#------#--#---
----#-#--#-------#--#-#---#-####----#---##-------#---#--#-----#-----##-#-------#-##-###--------#--#-
-#---#--#---#-#----------#--##-#--------#--##--####----#--#--#---#-------####--#---#---###-##--###--
-##---#--#--##------#----###---#-#----#---##---#--#-----#-------##--#-----#---#----#---#-#-------###
##--#-#--#--#-##-#--#-##--------#--###-#-------#--#---#---##-#--###---#--#-##-##--#-###-#--#---#----
#--------#-----#-#--#-#-----#----###--##------#----#-#---#-----------#---#-##---#-#---#-#---#--###-#
--#-#---#-#-#----#-#--#---#----#--#--###-#--#-------##-#-##----#--#--#-------#-#---###-#--#-#-------
---##---#-#-----#-#-#---#----#####--##---------#--##-##-#------------#--#---#--------#----#---#-----
--##-#--#---#--------------#--#---#-###-#-#-#-----#---#------#---##----####-#----#--#--#---#--------
--------#--#-#----#---##--#-#-#---#---#---##----------##-##----##-#-##-#-#--#---##------#-------###-
---------#--------------#---#---------##------##---#------##-#------------##----#----#-###----------
##-----##--###-------#-#--#---#----##-#----#--##--#-----#----##--##-##---#-##--#---##----#---#------
##-##----#---#####-#-#--#----##--#-#--------#--###-##----#-##----------#--#--##-#------###-#-##--#--
---------#--#-#-------#-#----#-###---------###-#-###-#--#----#-#--#-#--##------------#---#---#------
----#-#---#----------#--###---#-###--#-#---####-##------##-#----#-###--------#-------#-##-----#----#
-----#------##--------#--#--#--###-----#---------#---##-----##---#--#-#-#-#---##-###-#--#-###---#---
----#----#----#--#-#--#---#---####--##-#-#--##--#-#---#--#-#-----------------#----###-#------------#
#--##---------#-###-#--#--------##---#--------###--#--#----##------#---#---#-#-#--##----##-#--#-#---
#----#-#-##-#----#---#---#-#-----#-#--#----#----#--------#----#-#----#-#-#-#---#----##-#--##--------
---###--#------##--##--#-##-##---###---#--#-----#------#---#-------#----------##-###---#------###---
#-#-##-#------#----------#--#---#-#-#---###-#-#----##-#-##----#--#------#---#-#---##--#---#-#-----#-
#-----##-------##--#-##--##-#---#-------------##--#--------#-##----#----##--###---------#---------#-
##--------#-----###----------#-###-#--#---#--#--#--#--#---#-------#---#-------##----#--S##-#---#-#-#
-####--###---#----#-----#------####--#---------#-----#-#------#---#------#--------##----------------
##-##-#----##-#------#--#--#----#-#-#-#--##-#-##---##-#--#---#-----#-#------------#--------#---#-#--
-#-##---#---------#----####-##---------##-#--------#-#---##------#---#-#-#-#-#------#-####--#---##-#
#---#-##-#---#-#--#--#-----##---##----------#-----##-----#--#-#-----#--#--##-#----#--##--###-----#-#
#---------##---#-#---#---#-#-#--------##---#####-#------#-#----###----#-------#-#-#----#------##---#
##----E---#---#--##-------#----#-##--##---#-----#-##--###---#-#---#---------#-#------#----##--#-----
#-#--------------##-#-##---#-###-###----##--------#--###-----------#--#-#----#--#---#-#-#---##--#-#-
#----#-------#--###--##-#---##----#-#------------------#-#-------#--###-#-#-----#-#-----#------##---
#-#-#-#--#-##-----#-----##--#--#---#--##----#-#--#---#-#--#-------##----------#-##----#--#----#--##-
----##-----#---------##-#------#-#----#---#---#----#-#---------#--#-##-######-##-#----#-##-------#--
---#-#--#-####-------##-#-----###-#-#--------##-##------#----#-#---#-------#--#-##---#--#-------#--#
######------##--##--#------###----#--#---#--------------#------##---#-#-#-#---#----#-##-#--###-#---#
-#-------##--#----#----#-----#---#--#-###-###----#-#-##----#--#------#-####-#----##-#---------#-#-#-
#--#####-------#----#---#-#-----#--#-#------#-#---#-#--##-##--#-#-#--##-#--#----##--##-----#--#-----
#-#-##---####---#----#----##-###-##-#-##--#---###-----##-----##-#-#----##----------#-----#-#####--#-
----#-#-----#----#-##---------------###------------------#--#-#-------#####-----------#-#-----#-##--
----------#---#------#----#------#-------#---#-------##----#--###----------##---#------#-#-##-###--#
#-#----------------#---#-#---#--#-------------####-##-#-##-#---##------------#-------#-#-----##-#---
-#----##-#-------#---#-#--------#--#----#-----#-----#-#-#--#------#----#-#---------#--###-#---#-----
#---#-----#---#------#------#-----------#-#----#---##-----------#-#-#---#-#----#-#-----------#-#----
##--#---#--#-#--#------#-----##---#------#--#-#-#--#-#--#-#-#---#---#-#--#----#-#---##--#------####-
--##-----###--#--#----#-#-----#-----##----#-##--#--#---##-----#------#-#------#####-----##------#---
--##--#---#---#-#-###---#-#--##-##-----##----#---#----####----#-#-#-------------#-#--#-#-#-#--##----
---#---#----#-#---------#-###-#-#---##--##--#-#---#----#-##-#--#---#-#---##-######--#-#---#--#-#---#
#---#------#--##------#--###----#-#-----#----------#-##-####--#-###--#--#-#---#-#-#------#-----#-###
------------##-###--#---#-#-----#-#--#--##---#-#-------#----##--#-#--#-##--##----###--#--#####--##--
--#---###--#-#----#----#-#-##-#-#----------#--#-------#-#--##----###-#-------#------#--##----#-#----
#-#---#---##-------#-----##-#-#-----#------##-#--#-#--#-#-##-##-#----##-#-------#--##--#---------##-
#-##--------#-#-----#-##--#----#---#----------#----#----###-------#------------#-------#--##----#---
--#-#-#--#--#--#-#-#----##--##--##------------#---------------#----#--#-##--#--#-----#---#---#-#-#--
#-#----##--#--------------#-#----#####--#-#-----#---##--#---------###----#-#-#--------#-#-#---#-##--
#-------#--#---##----##-##-----#-##--------###-#---##----#--------###--##-#-#-------#--#---#-----#--
--##-#------##-------#-##--------#---#-----#-#-----------#--#------------#--#--##----#-#---#-#------
----------##--#--#---------#---###----------#-###-#----#-#-##--#---##--#-#---#--#---------------#---
---#----#--#---#----#------#-------#-------#--#------#----------#--#---#-------#-----##-####-#-#----
#--###-#---###-#-----##-#-#-#----------##-#-#---#-#-#-#---#-#----##-#---#-#####-#--##---##---####---
-#-#-#-----#-#-------##-##---------#-###--##--#---------#---#--#--##-#---#-#--#-----#-#--#-#--------
--#---#-##-#-#------#-----#-#-#------#--#-----#---#----###-------#---#----#--##-----#-#-----#-----#-
#-#----#----#-----------##-#----#--##-#----##-----##---####---------###--#####-#--###--##--####-#---
-#---###-----#--#-#-#--#---#------##--#-##---#--#--#-------#----##-#-----------#--####--##---#-#-###
-#----#--###-#####-#--#-#-------####-#-----#----------##--#--#----#-#-#-##-#-#---------##-##-#------
#-#-#-#--#-----#--#----#-----#-#------#--#--#----#-##---#-#-##---#-#-#---#---##-----##------------##
--#--#---##------#--#--#-##----------#--------##--#-#-#--#--###-##----#---###-------##-----#------#-
--#-------###-#----##------#--#-------#-###--#----##-#---------#-#---#-##----------#---#---#--------
---#--#--------------#-----#--#---#-####--###----#-###---##--#---#------####---#------#--#-##----##-
#----#---#--##-#-----##-#--##--------#---#--#-#-#--#--#-----#----------#---#--##----#------##-#----#
-#--#---#-#-#-#--#----#-#--#--#-----##--#-##-#-#-####--#--------#----#-##-#----##-#--#--#-#--#-##---
#-#-#--#------------#-------##---#####--##----##--#-----#-#--#-#-##-#-------------#-----#-#---------
----#---------#-#--#--#------#--#--##----##-#-###------#-------####--#--###--#----##-#-----##-----##
#----##-#-##-----------#-----#--###----##-----####-##--#--#######-------#--##--#-#----##--#------##-
---#----##---##--#--#-------###--#--##--#----#-----#---#-###---#-##----#---#-#-#----###-##--#-##----
##---------##-#-#---#----#---#--------#--#-------##-#-----#------#-----#--------------#-#--#--------
-------#-#--#-------#-#---##--#--##------##----#---------##----#-##--#----------#-----#---#------#--
--#----#-#---##--##-----#-#--#--#-##---#--#-----#----------#--------#-#--#---##-----------#---####--
----######--#----#---------------#--#-#-#--#-####--##------###----#-#---#--------#----##--##-----#--
--------#--------#-##---#---#-------#--######--#-#-----#--#--#----##--------#--#----#-#-###---------
#-##-#--------#-#---#-----------#--#---#---##---##--#---#--#-#--#-###--#-#---#--#-##-------#------#-
--###--#----##--##--------#-#--#--------#--#-#-----------##--#--#-----#-##-#----##---#-###-#--#-##-#
##-----#--#--######--#----#-#----------#-#--#-#----------#-------#-###-##--#-#-----#---#------#-----
-#-#----##--#-#--#------------###-----##---#--#-#--------#--##----#-#--------#-#-----#----------#-#-
##--##-##--##----#---##---#------#--#-------#--#---#-#-----#-----#-#---#-----#-#--#---##--##--------
---#-##--#---#-----------#--#------#-#--#------#-#---##----#-#--#----##----##-#------#-#-#-#----##--
----#--##-------------##--##-#---###---#-#-#-##--#-#------##-##-------#--#-#-#--###-#--#--#---#---#-
-----#-#----#------#---#--#----#-----##-#---#----#---#-------#---#-#---##--###-#-----#-#-#-##--#---#
--------##--#-------##---#--#---##--#------###-#---##-#---#-----------#-#-#---#-##-#--#-#---#----##-
----##-##-##---#--------#------#--#--##-#####--#----#-###-#---#---##-##---##---#-#-#---#--###---#-##
-#--##-----#---##-#-----------##---------#--#-##-##------##----#-#-##-##-----####-#-##-----#---##-#-
###---###-#--#-#--#---###-#-#-------#-----#-#----#----##--#--#-------#-----#------------#---#-##----
##-#---#------#--#---#--------#-##-------#-##-------#--#-------#-##----#--#---#-##---------#----#---
----#--#-#-#-#--#---##--##-----#----######-----#--------##----------------###--#---#-#---------#-#--