---###----#--#--------#--#--#-##-#----##---#-#------##-----#-------#-----#----###--#-#---#-##---#-#-
-#----#--#-###---##--##-#---#-##--------#--##-----###-#--#---###---#---------#------###-----#--#-#--
---------#---------##--#-#------#--#-----------##-----#--------------#----#---###-#---#-------------
-#---#----#-#----##--#-#--#-------#--##-----#-#--#---##-----#-------##-----#---#------------#--#----
--#----###--#-#-##--##--##---#--#-#--------##--#----#-#--#----#----#----#-------##-#---------#-##---
-----##-###--#--#--#-###---#---##-#----#-#-#----#--#---###-----##---#----##--#-##----###----#-#-##--
----#---#-------#--#####----#-#-------#-----#-#------####--##--#-#------##----#-----##---#-----##---
-----#---##--#-##-#--##-#--##----#------#------###-------#------#--#--#----#----###--#-#---#--#--#--
-##--#-----#----#------------#----#-##-##----#--#---###---#---##--##--#-#----#-#--###-##-#----#-#-#-
----##------#------------#---#-#---------#---#---#---###---------#-#-#--#-#----#-------------#---##-
-----#---#--#-------##-#-##-##-----#-##-##-#----#----#-#-##--#---#---#-----#####---#--#---##--###-#-
##----#-#-#------#----#-#--##-#--#-----#-##----#-------#--#-#---#-#------------##--#--#---####---#--
#-#-##-###--#-###--##--#-#-#-##-#--#---------####-#---#--#----------#---#----#---#--------####------
------#---------###--#-#----#-#-----##-#-##-##--#----#---##--#--------#--##-------#---##-------#-#--
---##--#-###---#--#-#----#-#-##-----------#----#--#---##--#-#-#---#---#--#----##-------#--####------
----#-##-##--------#-#-#-###--###----##-#-##--#-----#-----##-##--#--#--#-#####-#-#-#-##----##---#-#-
--###------------####---------##-#-------#-#---#-#-##---#---#--#-##---#-#---#-#---#--##----#--------
-#-----#---###----#--#-#-#-----#--#--------#----#--#---##---#####-----####-#--#-#-##----######-##-#-
----##---#--------#--#-#----#-#-#-#-#---##-##-#-#-----#---#--#-#--#--------#--#-#-#-#---#-----#--#--
-#--#-----#---#--##-##---##-#---##----------#-#-----#----#------##--###--#-----#-----#-#---##---##--
----#-#-#---#--------##------#--##--#-##---###------#---###---#----#-#--#--#-##--#--#--#----##-#--#-
#--#-#-##------#----------#---------#-----#------#-#--#-----------##-------------------#-#--#----###
#----#--##----#--#--##---##-##--#---#------#---#----##---#--###--##------#-#--------#-#------##---##
##-------------------------#-----##----#---#-#------#--#-#-----#-#---##-----#---#---##------#--#----
----#-##----#----#-#----#---#---------###----#-##--##-#-##--------##-#-##-#-#-##------#--#----####-#
###----##---#---##-#----#-##-#---#--###------##-##---#------#-#--#--##--##-#-----##-#----###-##----#
##-#####----------#---#----------#--#-#---#---#--#----------#--#-#--#-#-#------##----###----####----
---#---###-#--#-##----------------------#---#--###------#--###---##---#---#------#-###--------#-----
---##------####---#-#----##-##--##-##--#-#-###-##------#-------###-------#-#--#--#---------#--------
#---#-----##---#--#-#-----#-##---#-----##---#--------#--------------#---------#-##-#--#---##--------
-#---##----#--##---#-------###----#-##-##-#-##---#---##-#------#-----####-#-#---#------#------#---#-
-#--#---###--------#-###--------------##----#---##-##-#-----#----#------#--#--------##--##-##--#----
---#----#----------##-----#-##--##--#--##-#-----#-----#-#----#--#---#-----###-#--------#----#---##-#
-#---#----##------#------#--#-####-#--------------#---#------##-###-#----#-#------##--#--------#----
#-#---#------##----#---------#-#--#--#--##-##----#--#--#--------##-#---#--#----##-##-#---#-----##--#
##--#----#---#-----#-##-#------#-------###--#--#---##----##-##--#-----#-----------#-#----#--####---#
##----------#--#-----#--#-#-####-#----##---#-------#-#-#----###-----#---###-----------#--#---#------
-#------#-#----##------#--#####------------####------##-#----#---#-#---#-------#-#-#-#-----#-----#--
-#--#----#---#-----#--#---#-#-##----#---##------#--##--#--##--S--------#----#----------##---#-##--#-
###-##-#-#--#-#-#------#---#----#--#--##---##-#-------#-##-#---##----#-#-#-##-#---####---------#-#-#
##--##-#-#--#-###-#-######-------##-###--##-------------------#-##----------------#---#--#-##---##-#
-------------#---------##-###-##------------###-------#---#--####---#--------#####-##---#---#-#-----
-----#-####-------#---------#--#-##-#--#-----##----##--#--#--##--#-#--#------##---##---------------#
-#--------##--#-#---##--#####--#-----------#--##-#-----#--#----######---#---#----#-#-#-----#--#---#-
----##-#--###------##---------#-##---##--#--#-------------------##-#---#------#------##-------------
----#---###-------#----#-##-----##--#-#--#-#--##--#--#-#--##--#---#--#--#-##-----#---------#--------
-------#---##----#-----#------#-#--#-#------#------#-#-------------###----##------#-#---##---#--#---
-#-#---#-#-#-#--#-----#----#--##----------------#--#---#--#---#---#-#-###--#---#--###--#------#--##-
-#------###-#-##-#--##---#--###-#-------##---#-#-#--#------#-##---------#----#-#----#-#-###-------#-
#--------------#----#-#-###-#--#---##----#---#----#-##--#-#--#--##--#-#-###-#----###-#-#-#-#-##-----
---#--#--#-#--#-#-###-----#--#-##-#-#-#----#----#---###-#-#--#--####----###--#---##----#-#----#E--#-
-------#-------##-##-#--#--#---##-#---#-##-#-#-###---#-#------##-#---##-----##-----#--#-------------
--------#--------#--#---##---#--#-------#----#--#--#---#--##--#-#--#-#-------#---##------#--#--###--
-##-------#---------#--##----###---#---#-#---#----------#-------#---#--------#---##------#--#----#--
#--#-#--#--#-###---##-------------##-#-###---#-------------#-------#--###-#------#----#---#----#--##
##-------#-----------#-#--#---##----#-#-----#--#---##---------#-#--###----#---##---#---#-###---##---
-##--###------#---#--###------#-##--#-#-----#---#----##---##-----------#---#----------###-#--#---#--
-----##---#-##-#-----#-#----------##-#-###----###------#--#----#-#-#---##----#-##---#---------------
#------#--#-----#--#------###------#-#-----###-----#----##-##--#-#--##-##---------#----------#--#---
----##-----------###-#----#---##-----#--#-#-##-##-##-#-#---#-##-#-#---#--#-#---#-#--#------------#--
---###-#-#--------##-#----#-#---#---#--#------###-#-#--#-#---##--###-#--#--#----##---#----------#-#-
-#--#-####----##--------#-#---##-#-----#-#-##-----#--#--##--#-------#-###-###--------##-----#-##---#
------#-----#---------------#-##-#-#-#----#-----###-##-###-----#-#-----#--#---#------------#---#---#
##-#-#-###-----##----##--#--###---#------#---#--#---##----#--##-##-----#--##--##----#-#-##----#-----
##-#-####--#-#-----##-#----##--#--##--##----##----#----#-#--#--#--#--###--##---##--#-----##-----#---
----##-#----###-#-------#----#-#-----------##-#-#-----###--##-----##-##--##-#-------#-###-------####
---#----#--#--#-#--#---##-###----####--##-##-#--#----##-##----#-#-##----#----#-#------###-#---##-#--
-------#-#----##-----#-----#-#-----###------#------##-#------#-#-----#------#-####--#------#--------
---#-#-#-----#----###-##--#-#-#----#-----##----#--#--#------#---#------#--#--#-#----#-#---#-------#-
#---#--#---#---#-#-#-------------###--##-#-#--#-----#-----#-##---------##-#---#-#---##-----##-------
----##--##-----#--#-----#----##---##--#-#-------#-#---##--#-#-#---##-#--#-#------#-#------#--#------
---##----#-#--#-#---#-#--##-#-##--#-------------#----#----#--#--------#----#--#--##-#---##--#----#-#
--###---##----#-#--#--#-#-----##------#--#-#----#--#---##-#-------------#---#-#---#----###-----#-#-#
----#-#-#---#---#-------#------#-----#----#---#####-#--#-----#--#------#--###--##-----#-----##--#--#
----#----#-#---#------------##-#-#----#---------#---------#---#--------#---#-------#-----#-----#---#
-#-#-------#------##---###-------##-#-#--#--##--#----------------#------#-#----#------#-#---#-#-----
---#--#--##-#--##-##--#---------------#---#-----#----#-#--##-#----#-###-##--#--#-##----------#--#-#-
-#-#--##--------#---#-#####-----#-##-#------##--#-#-##--#--#---------#-#----#-------------#-------##
-#----##----##-----#-------#---#----#---#-#--##-#-----#--#---------#-----------###----#--#-----#----
----#---------#--#---##----##--#-#--#---#-----#-----####-#--------##---#---------#---#-------#-#----
-###---#-#---#---#-#-#--#-------#-----#-##--#------##--##-#-------##-#-##-#--#-----#-##--------#---#
##-##---####--##--#--#-#--#-#---#--#-#------#---#--------#-#--#-##------#--------------#-#--##-#----
#-#-----#----#---#---####-####------#------#-#----#---#----#------------#-#-#--#-#-----#-------##-#-
###------#-##----#---##---#--#-------#--##--#-----##-----#-#--#--##-#--#-#--------#-##-##-#-##--#---
-----#----#--#-#--#----#-----#----##-------###--#---###--#-#---#-#--------#-#---#------#-###---#----
-#----#-----##---##-----#---##--#----------###-##--#-------------#-#----#--#-#------##---#---#------
#-------#--#-#----#------##------#--#-#----------#-------#-#--------#-#---#---#-------------#-#-----
--##----##-#-----------#--------#---##--###----##-#----#--#----##-#----#-###-#--#--#---#--#-#-------
-#-##---#-#----#-##-#-######--#-------#---##----#---#--#---#------##--##--#-#------#-#---#--#----#-#
##-#-#-#-###---##-#----#-#------#----###-#-------#-#--#-#--#------#-#---#--##-##-###-----------##---
--#--#--##-----##--##--#--##----###---#----#---------#--##--#------##-#----###-#----#-###-#---#-#--#
--#--##-#-------------#-#--#--####----#-#--#-#-##--#-#----#---##--###-#--#-#---##-#---#--##--#------
#--#-#--------##-###---##-----#------####-##--#----------###-------##-###--#-#--##---####-#----#---#
##------#-###----------#---#---##--##-#--#-##-------#-#--#--#--#-#-#-#----##---------##--#---#----##
#-##--#-#-#-----#--##-----#-##-#-#--##-#---#---#--#----##-###--#--#--------##-##----#--#--#----##--#
--##-#--#----#-#-----#-#######-------##--####-----#----#-#----#-----#-----#-#--#-#---#----#---##----
-####---------#--#-#----##-#####-#----#---##----#--#---##---#--------#----###---#----#----#-----#--#
-#-#---##------#-###--#-#-###-#-----##--##----#----------#----#-##--------------------##-------#---#
-----#------------#-#--#---#------#-#-#-#----#-#-------##-#---------#----#-------#--#-#--###-##--##-
##---#-------##-----------##--------##-##---##--#-#----#--#-----#--##--#--#-#-#--##-#---------##---#