-----#-------#--------#-----###---##-#-------#--------#-#--##-#-#--##----#-----##--#--##--#--#------
----###--###-----#-##---#-##-----#---###-#---#----##---#-----#----####----###---##-------#---##----#
----#-#-##-#-#--#--#--##---##-#---##---#-#-----#--------#--#-------#--###----#----##-##---------#-#-
----##--#-------#----#-#---#---##-------##-###--#-#-##-##---##----###-------##--#-##-----##----#-##-
--#--#-#-##--------#---#--#---#--#--#-----####--#-###--#------#-#-----#---------##----#---##---#----
-##-#----------###-##-----#-##--#-------#--##--#------#----#--####------##----#-#------##-----------
---#-##-#-#-#-#S---------#--#----##---#--#-#--------#----###----------##------#------#-#-#-#---#----
#--#--#----#--------------##----#----#--#----##---------#---#--#---#-----#-#-#---#-----####---#-----
-#-----##--#--#------#------------#---###--#-#-#--#-#-###---#---#---#-#-##-##-#--#-###--##-###--#E--
#-#--##----#-#--#------#---#-----#-----#--#---#------#----##--#---##-#-#--------------#-------#--###
---##-#-------------####-#--##-#-#------#--#-#-#-#----##-----#-#---------#---#-#----#--------##-----
###---#####--------##--#-#----##-----#-#-#--------##---##----##--------##--#----#-#---#-##-#-----#-#
----##----#--##------#----###-#--------#--#-#----#---#-------#-#----------#------#-----#----##-#--#-
#---------#-------------#-##-------#-----##-------#-#--#---#-#-##---##----##---#-#-####----#---##---
---#-##--#-#-#---#----------###------#----#----###--#---#-#------#-------#--#-------#----#-#-##-##--
###-#-#----#---#-#-####-----#----#--#----#-#---##--#---#----#-#---#-#----###--#---###--#------------
#-#-#---#---#-#-##-#-----#-----#-#-#--#-#-----##-#---#-------#----#-----#---#-------#--##-----#-##--
##-#---#---#-#------##----##----#-------#---#------#--#--##-----------#--#--#---#--#-#-##-----#-----
#-------##--------#--#---#------#-----------#--##--#--##-##-#------------##--#--#-#-###-----#---###-
--##------#---#----##-#----##---#--------#---#-#--###--#-----#####------##--------------#---#-###-#-
###---#-----#--#-#-##-#-#----#----#-##--#-----#-##-#-#-------#------#-------#--#--------------#----#
--------#--#--####---------#-#------#----#--#----#--#-#--######----#--#----#-##-#--#-##-#---#------#
-----###---#-##------#--#--#--------#--#-#--#-----#-##-----------#--#-##-#-#----###-#---#-###---##-#
-#-###-#------#-#-##-##-#--#--#----###-###---#--#---#----##---##--#-####--###-----#--#-#--#------#--
--#-#####--##-#---#--#-#----#---#--#----#--#------#-#----##--#-----##-##-##-##-------###---###-----#
---#--##-#-#--------------------##----#----------#-#-#---------------##--#-#---##-#-----------------
--#----------#-----------#------#-##--#-#-###-##--#-----#----##-##-#-#-###--#-##---#-#-##-----#---##
######-#--#----###-------#--##--#-#-#----#-----#------#----#--#--------------#-#--###--#-#---#--#-#-
---##--##----#----#-#-#--#---#-#-####-#---#----###-#---##-##--#--#--------#---##------##---###--##--
-#-##-#----##--#-----##--#--#--#-#-#-#-----#---#------#-#-#-#-#-#---##-#-#-#--##--##---##-----------
------##-#----#--####--#-#---#----###-----#-##-##--#-----##-#-#-----------#---#--#----------#--#----
---#-##-#--##-#-##---##--#---#-#--#--#-#---#--#---#-##-#------#----#--#-----------#----#----###-#--#
-#---#--##---------#---#--#------#---##-#---###-#----#---#------#----#-#-----#-#---##--#---#--###-#-
---#--##-#--#----##-#--##-#---------#--------#---#-#-#--#-#-#-#-#-#-------#----##--#-#---#--#--#--#-
------#----#---#-#--------#----##----#--------###--#-------------#-#-------#-###--##-#--#-----#----#
-#---#------#-###---#---#--#--##-------#-##-#---#--##--####-----#-##-#--####--##----#-------##--#-#-
----##-#-#---#--#---##-------#-#-#-##---###---#----------##---##-----#--###-##--#--#-------------#-#
--------#----#--#-----#----##--#-----#--#---#---#-##--#--#-----#--#-#-#---#--#--#--#-#------#-----#-
---#--##-----------##------#-#-#-##--#-#-#-#-###---#----#--#--#---#--#----#--#----#----##-#-##--#---
--##-#--#--#-#--#-#-#---#-----#-#---##-----##---##-##-#-#-------##---#-----##---#-----##----#------#
##----##--#--#--#----#--#----##-------#-##----#---#-#-#--#------#---###---#-#--#-#--##--------------
#------###----####------#----#------#----#-----##-------------#------#----#--#-###-#--##-#####---#--
----#-#-------#-#-#----------#----#-----#--------#--##------##---#----#--#-#---#-#-------#---##--##-
--#-#----#-##-----#-#--##-------#---#-##---------#------##-##-----#--#--#------#---#-##-#--####-##-#
-#-----#-------#--#---#--#--##--###-------#-#-#-#--#-#----##---#--#-##----#--#--------#---#---------
---#--#-##-----#----#---##---#-#---#--#---###------#-----#-###---------#-#-#--###-#---#----#----#-#-
---#----#------#------#---#--#---##-------------------#----#-##----###-#--#-#--#-#------#-##-##---#-
-#-----#---------#----#-#---#-##---##-##--#----##-###-####---#-----------##-###----#--##---##---#---
------#-##-#--#-#-#---#---#-#---#----##----######-#-#--#-#-------#--##--#----#-##---#-#-------------
###-#-#---#--#-----------#----###----#-#--#---#----##----#---##--##-#--#----##------#------#----##-#
##--#-#----#---###----#-#-#--#-----#--#--###---#----#--##----#--##---#-#-##-----#------##-#-#----#--
--#--##---#-###-#--------#--#----#-#---##--#----####---##-------#-###---##--#-------------------#--#
--#----#---#-#-#--##---###-#-##-##------------#-------#--#--#-#---#--#---#----#--#-#-#----#--#---#-#
-#----#-#----##-#------#---------------#-#-#-#-##-#----#--###-#---##-#--#-###-----##-----##---###---
--#--------#-######-####--#-###----##----#-##-#-#--#----#---##-----#-#-#----#---------#----#-#--###-
#--#--------##-#--##----##--#--#-#----#---###--------------##----#--##-####---#-------------#-#-##--
--#--------#-#-----------##--##-----##---------#---#---------------------#------#---#---------------
##---#--#-#-##----#--##---------#-----#-#---#-###-##--##--#------#---------------##-##-#-----##-----
--#---#-#-----#-#---------------#-#--------#--#######------#-----##---##--###---------##------------
##-#-#--------##--------#---##----#------#-##-##----##----##--#------#-#--#--#-#-##---##--#--#-#--#-
-------##--##--#----##--------##---#---#----#-#----#---#-#-#----------#--#-#---##-#-#---#---#-----##
--###-#####-------#---#----------#---####-----#--#---#----#-------###---###--##------##--------#---#
##-##-----#---#-----#-#####-#---#---------##-###--#-#-----#-##-----#---#-----#--#-#--#--##-#--##-##-
-------#---#-#---------#-------##--##---#-##-##--#-----#-----------##---#--------------#--#---#-----
-##-----#--------#--##-#-------#--#---###-----#-##--#-##--#--#--#-----#------#--#----#-----#-#----##
#--##-#---------#--#---#-#-#-#--#-#-#----#--#-----#---##--#--##------##-#---#---##-#--#--##-----#---
----------#-#--#-------##-#-##----#---#--------#-##-##----##----##--##-------##-------#-#--##--###--
#--#--##-##-------##-#----##-#---##-#------##-##--#-#--#-#---#------#---#---#-#------######-----#--#
##-#--##-#--#-#-###-##--#-###--##-#--##-------###-###-----###---#-##--#----##-##-#--##-----#-#-#----
#----#-###-#--##-#-----#-##---------##------#---#-#-#------#-#-#-------#---#-------##--#--##-----#--
-----#-##-##-#--##----##---------------###--------#-#--####--##-#--#-#-#-##-#---#--#-------#------#-
#----#--##--#-#----#----#--##-#----##----#-----#-#----#--##-#-----#--#----##-##----#-##-#--#-##-----
---#-----#---#-------#-##--#--#-----#-##------#--##------###--#---#--#---#---#-----#------#--------#
#-------##------#---#----------#---##-#---##--#-#-----#--#-------###-#--####----#---#-#-##-#------#-
#-#----##-#-##----#------##--###-#-#----------------#--##-#--------#-#------#---#------##-##---#----
-------------###--#----#--#-##--#--#-#-##-#--#-----##-#----#----#-----#-----#---#----##--#-##-##--#-
-----#------#--##-#--#---------##--####--------#-#----#--------#---------#-##----#--#----####-------
------#--#-------##---------#-#---#-##--#-----------#--#----------#----#-#--#---#--#----#----#---##-
--#-#--#---------#-#-#-----#-----#-#----####--#-#-#---#-----#--#---------#--#----###-------#---#----
-----#-------#####-#-##---##---###-#-#----------#---#-##-----####--#-------#--#----#----##--#--#-###
#--##--#-#-#--#----##---------##-#-----#-----#-----##-----#-------------#-#---#---#-#--##--##---#---
##---#-##---#-#----#-#####--#------#---#---##-#---###---#-----#------#-##--------#-----------#-#----
#----#-------#----#-###----#-#---#----#-----#---##---#----#--##---#-###-----##---------##---#---#---
--##-#--##-------#-------------------#----#-#-##----#------------#--#-#-#-#--##--###---#--#-#-------
-------#-#---#-###-----------#------#--#--#-#---###-###---#--#-#-----------#--------#-#---##--##--#-
##--#-----#----#---##--#---###--#---#-##--#-#-#-#------------#-#-##---#-------#----#----#--###------
------##------#----##-#-----####---##----##--###----#---#-#-#-#--#------------#-#-#--##-----###-----
--#--#----------##---#------#-#-#--#---#-#----###-#-#------#--#-----#-#--------#----#-#-#-#---#---##
------##--#----#----#-----#-----#--#--#--#-#--#---######---#--#----##------###---#-##-#--##------##-
-----##-###-#------#-#---##--##--##--#---#---------#-----#--#-#----#-#-------#-----#--#--------#-#--
--------##--#--#-#--#####------#--##-#--##------#--#--#--------##----#--#---#--#-#-##-##-##--#----#-
#-##--#-#----#-#---#------###-##---#---#--#---#---------#--#-#---#-#-------#--#--#-#-----#--#---#--#
#-----#-#-#---#----#-------#--#---##--------##--##-------#--#-#---#--#----#-##----##-#-----#---#####
-------#-#--#-##-##-#---#-#-#-------#--#-##-#-----#-#---#----#--#-------#---#-----##-#--##-##--#----
----#-##--##----#-------#-##-##-#---###---#-##-#-----#-----#---#---#---##-#-#-#-----#--#-#---#--#--#
---------##-------#-####---##------#--#-#--##----#--------#----------#--#-#---##-#--#---#----##-#---
-#---#--#-##--#--#-------#-#----#---#-#--#---#-----------#---#-----#-#-####--------------###--------
#-#---#---#-------#--##-#-#-------#----####---#-----#-#-------#-#-#-#--##-##---#-####---#----#--#-##
-----#---##-#------#----#-----#---#-----##---#---#----#-#-------#---#-#----#-------#---##--###------
#------#-##-##----#-##------##-#-#------#----##-------#-#---#-----#-#-----------###-##-#-----#---#-#