-#----#----#----#----#----#----#----#----#----#----#----#----#----#----#----#----#----#----#----#---
----#----#----#----#----#----#----#----#----#----#----#----#----#----#----#----#----#----#----#----#
##---##---##---##---##---##---##---##---##---##---##---##---##---##---##---##---##---##---##---##---
-#--#-#--#-#--#-#--#-#--#-#--#-#--#-#--#-#--#-#--#-#--#-#--#-#--#-#--#-#--#-#--#-#--#-#--#-#--#-#--#
----#----#----#----#----#----#----#----#----#----#----#----#----#----#----#----#----#----#----#----#
-#----#----#----#----#----#----#----#----#----#----#----#----#----#----#----#----#----#----#----#---
----#----#----#----#----#----#----#----#----#----#----#----#----#----#----#----#----#----#----#----#
##---##---##---##---##---##---##---##---##---##---##---##---##---##---##---##---##---##---##---##---
-#--#-#--#-#--#-#--#-#--#-#--#-#--#-#--#-#--#-#--#-#--#-#--#-#--#-#--#-#--#-#--#-#--#-#--#-#--#-#--#
----#----#----#----#----#----#----#----#----#----#----#----#----#----#----#----#----#----#----#----#
-#----#----#----#----#----#----#----#----#----#----#----#----#----#----#----#----#----#----#----#---
----#----#----#----#----#----#----#----#----#----#----#----#----#----#----#----#----#----#----#----#
##---##---##---##---##---##---##---##---##---##---##---##---##---##---##---##---##---##---##---##---
-#--#-#--#-#--#-#--#-#--#-#--#-#--#-#--#-#--#-#--#-#--#-#--#-#--#-#--#-#--#-#--#-#--#-#--#-#--#-#--#
----#----#----#----#----#----#----#----#----#----#----#----#----#----#----#----#----#----#----#----#
-#----#----#----#----#----#----#----#----#----#----#----#----#----#----#----#----#----#----#----#---
----#----#----#----#----#----#----#----#----#----#----#----#----#----#----#----#----#----#----#----#
##---##---##---##---##---##---##---##---##---##---##---##---##---##---##---##---##---##---##---##---
-#--#-#--#-#--#-#--#-#--#-#--#-#--#-#--#-#--#-#--#-#--#-#--#-#--#-#--#-#--#-#--#-#--#-#--#-#--#-#--#
----#----#----#----#----#----#----#----#----#----#----#----#----#----#----#----#----#----#----#----#
-#----#----#----#----#----#----#----#----#----#----#----#----#----#----#----#----#----#----#----#---
----#----#----#----#----#----#----#----#----#----#----#----#----#----#----#----#----#----#----#----#
##---##---##---##---##---##---##---##---##---##---##---##---##---##---##---##---##---##---##---##---
-#--#-#--#-#--#-#--#-#--#-#--#-#--#-#--#-#--#-#--#-#--#-#--#-#--#-#--#-#--#-#--#-#--#-#--#-#--#-#--#
----#----#----#----#----#----#----#----#----#----#----#----#----#----#----#----#----#----#----#----#
-#----#----#----#----#----#----#----#----#----#----#----#----#----#----#----#----#----#----#----#---
----#----#----#----#----#----#----#----#----#----#----#----#----#----#----#----#----#----#----#----#
##---##---##---##---##---##---##---##---##---##---##---##---##---##---##---##---##---##---##---##---
-#--#-#--#-#--#-#--#-#--#-#--#-#--#-#--#-#--#-#--#-#--#-#--#-#--#-#--#-#--#-#--#-#--#-#--#-#--#-#--#
----#----#----#----#----#----#----#----#----#----#----#----#----#----#----#----#----#----#----#----#
-#----#----#----#----#----#----#----#----#----#----#----#----#----#----#----#----#----#----#----#---
----#----#----#----#----#----#----#----#----#----#----#----#----#----#----#----#----#----#----#----#
##---##---##---##---##---##---##---##---##---##---##---##---##---##---##---##---##---##---##---##---
-#--#-#--#-#--#-#--#-#--#-#--#-#--#-#--#-#--#-#--#-#--#-#--#-#--#-#--#-#--#-#--#-#--#-#--#-#--#-#--#
----#----#----#----#----#----#----#----#----#----#----#----#----#----#----#----#----#----#----#----#
-#----#----#----#----#----#----#----#----#----#----#----#----#----#----#----#----#----#----#----#---
----#----#----#----#----#----#----#----#----#----#----#----#----#----#----#----#----#----#----#----#
##---##---##---##---##---##---##---##---##---##---##---##---##---##---##---##---##---##---##---##---
-#--#-#--#-#--#-#--#-#--#-#--#-#--#-#--#-#--#-#--#-#--#-#--#-#--#-#--#-#--#-#--#-#--#-#--#-#--#-#--#
----#----#----#----#----#----#----#----#----#----#----#----#----#----#----#----#----#----#----#----#
-#----#----#----#----#----#----#----#----#----#----#----#----#----#----#----#----#----#----#----#---
----#----#----#----#----#----#----#----#----#----#----#----#----#----#----#----#----#----#----#----#
##---##---##---##---##---##---##---##---##---##---##---##---##---##---##---##---##---##---##---##---
-#--#-#--#-#--#-#--#-#--#-#--#-#--#-#--#-#--#-#--#-#--#-#--#-#--#-#--#-#--#-#--#-#--#-#--#-#--#-#--#
----#----#----#----#----#----#----#----#----#----#----#----#----#----#----#----#----#----#----#----#
-#----#----#----#----#----#----#----#----#----#----#----#----#----#----#----#----#----#----#----#---
----#----#----#----#----#----#----#----#----#----#----#----#----#----#----#----#----#----#----#----#
##---##---##---##---##---##---##---##---##---##---##---##---##---##---##---##---##---##---##---##---
-#--#-#--#-#--#-#--#-#--#-#--#-#--#-#--#-#--#-#--#-#--#-#--#-#--#-#--#-#--#-#--#-#--#-#--#-#--#-#--#
----#----#----#----#----#----#----#----#----#----#----#----#----#----#----#----#----#----#----#----#
-#----#----#----#----#----#----#----#----#----#----#----#----#----#----#----#----#----#----#----#---
----#----#----#----#----#----#----#----#----#----#----#----#----#----#----#----#----#----#----#----#
##---##---##---##---##---##---##---##---##---##---##---##---##---##---##---##---##---##---##---##---
-#--#-#--#-#--#-#--#-#--#-#--#-#--#-#--#-#--#-#--#-#--#-#--#-#--#-#--#-#--#-#--#-#--#-#--#-#--#-#--#
----#----#----#----#----#----#----#----#----#----#----#----#----#----#----#----#----#----#----#----#
-#----#----#----#----#----#----#----#----#----#----#----#----#----#----#----#----#----#----#----#---
----#----#----#----#----#----#----#----#----#----#----#----#----#----#----#----#----#----#----#----#
##---##---##---##---##---##---##---##---##---##---##---##---##---##---##---##---##---##---##---##---
-#--#-#--#-#--#-#--#-#--#-#--#-#--#-#--#-#--#-#--#-#--#-#--#-#--#-#--#-#--#-#--#-#--#-#--#-#--#-#--#
----#----#----#----#----#----#----#----#----#----#----#----#----#----#----#----#----#----#----#----#
-#----#----#----#----#----#----#----#----#----#----#----#----#----#----#----#----#----#----#----#---
----#----#----#----#----#----#----#----#----#----#----#----#----#----#----#----#----#----#----#----#
##---##---##---##---##---##---##---##---##---##---##---##---##---##---##---##---##---##---##---##---
-#--#-#--#-#--#-#--#-#--#-#--#-#--#-#--#-#--#-#--#-#--#-#--#-#--#-#--#-#--#-#--#-#--#-#--#-#--#-#--#
----#----#----#----#----#----#----#----#----#----#----#----#----#----#----#----#----#----#----#----#
-#----#----#----#----#----#----#----#----#----#----#----#----#----#----#----#----#----#----#----#---
----#----#----#----#----#----#----#----#----#----#----#----#----#----#----#----#----#----#----#----#
##---##---##---##---##---##---##---##---##---##---##---##---##---##---##---##---##---##---##---##---
-#--#-#--#-#--#-#--#-#--#-#--#-#--#-#--#-#--#-#--#-#--#-#--#-#--#-#--#-#--#-#--#-#--#-#--#-#--#-#--#
----#----#----#----#----#----#----#----#----#----#----#----#----#----#----#----#----#----#----#----#
-#----#----#----#----#----#----#----#----#----#----#----#----#----#----#----#----#----#----#----#---
----#----#----#----#----#----#----#----#----#----#----#----#----#----#----#----#----#----#----#----#
##---##---##---##---##---##---##---##---##---##---##---##---##---##---##---##---##---##---##---##---
-#--#-#--#-#--#-#--#-#--#-#--#-#--#-#--#-#--#-#--#-#--#-#--#-#--#-#--#-#--#-#--#-#--#-#--#-#--#-#--#
----#----#----#----#----#----#----#----#----#----#----#----#----#----#----#----#----#----#----#----#
-#----#----#----#----#----#----#----#----#----#----#----#----#----#----#----#----#----#----#----#---
----#----#----#----#----#----#----#----#----#----#----#----#----#----#----#----#----#----#----#----#
##---##---##---##---##---##---##---##---##---##---##---##---##---##---##---##---##---##---##---##---
-#--#-#--#-#--#-#--#-#--#-#--#-#--#-#--#-#--#-#--#-#--#-#--#-#--#-#--#-#--#-#--#-#--#-#--#-#--#-#--#
----#----#----#----#----#----#----#----#----#----#----#----#----#----#----#----#----#----#----#----#
-#----#----#----#----#----#----#----#----#----#----#----#----#----#----#----#----#----#----#----#---
----#----#----#----#----#----#----#----#----#----#----#----#----#----#----#----#----#----#----#----#
##---##---##---##---##---##---##---##---##---##---##---##---##---##---##---##---##---##---##---##---
-#--#-#--#-#--#-#--#-#--#-#--#-#--#-#--#-#--#-#--#-#--#-#--#-#--#-#--#-#--#-#--#-#--#-#--#-#--#-#--#
----#----#----#----#----#----#----#----#----#----#----#----#----#----#----#----#----#----#----#----#
-#----#----#----#----#----#----#----#----#----#----#----#----#----#----#----#----#----#----#----#---
----#----#----#----#----#----#----#----#----#----#----#----#----#----#----#----#----#----#----#----#
##---##---##---##---##---##-E-##---##---##---##---##---##---##---##---##---##---##---##---##---##---
-#--#-#--#-#--#-#--#-#--#-#--#-#--#-#--#-#--#-#--#-#--#-#--#-#--#-#--#-#--#-#--#-#--#-#--#-#--#-#--#
----#----#----#----#----#----#----#----#----#----#----#----#----#----#----#----#----#----#----#----#
-#----#----#----#----#----#----#----#----#----#----#----#----#----#----#----#----#----#----#----#---
----#----#----#----#----#----#----#----#----#----#----#----#----#----#----#----#----#----#----#----#
##---##---##---##---##---##---##---##---##---##---##---##---##---##---##---##---##---##---##---##---
-#--#-#--#-#--#-#--#-#--#-#--#-#--#-#--#-#--#-#--#-#--#-#--#-#--#-#--#-#--#-#--#-#--#-#--#-#--#-#--#
----#----#----#----#----#----#----#----#----#----#----#----#----#----#----#----#----#----#----#----#
-#----#----#----#----#----#----#----#----#----#----#----#----#----#----#----#----#----#----#----#---
----#----#----#----#----#----#----#----#----#----#----#----#----#----#----#----#----#----#----#----#
##-S-##---##---##---##---##---##---##---##---##---##---##---##---##---##---##---##---##---##---##---
-#--#-#--#-#--#-#--#-#--#-#--#-#--#-#--#-#--#-#--#-#--#-#--#-#--#-#--#-#--#-#--#-#--#-#--#-#--#-#--#
----#----#----#----#----#----#----#----#----#----#----#----#----#----#----#----#----#----#----#----#