#-#--#-#--#-#--#-#--#-#--#-#--#-#--#-#--#-#--#-#--#-#--#-#--#-#--#-#--#-#--#-#--#-#--#-#--#-#--#-#--
----#----#----#----#----#----#----#----#----#----#----#----#----#----#----#----#----#----#----#----#
--#----#----#----#----#----#----#----#----#----#----#----#----#----#----#----#----#----#----#----#--
-##---##---##---##---##---##---##---##---##---##---##---##---##---##---##---##---##---##---##---##--
-#----#----#----#----#----#----#----#----#----#----#----#----#----#----#----#----#----#----#----#---
#-#--#-#--#-#--#-#--#-#--#-#--#-#--#-#--#-#--#-#--#-#--#-#--#-#--#-#--#-#--#-#--#-#--#-#--#-#--#-#--
----#----#----#----#----#----#----#----#----#----#----#----#----#----#----#----#----#----#----#----#
--#----#----#----#----#----#----#----#----#----#----#----#----#----#----#----#----#----#----#----#--
-##---##---##---##---##---##---##---##---##---##---##---##---##---##---##---##---##---##-S-##---##--
-#----#----#----#----#----#----#----#----#----#----#----#----#----#----#----#----#----#----#----#---
#-#--#-#--#-#--#-#--#-#--#-#--#-#--#-#--#-#--#-#--#-#--#-#--#-#--#-#--#-#--#-#--#-#--#-#--#-#--#-#--
----#----#----#----#----#----#----#----#----#----#----#----#----#----#----#----#----#----#----#----#
--#----#----#----#----#----#----#----#----#----#----#----#----#----#----#----#----#----#----#----#--
-##---##---##---##---##---##---##---##---##---##---##---##---##---##---##---##---##---##---##---##--
-#----#----#----#----#----#----#----#----#----#----#----#----#----#----#----#----#----#----#----#---
#-#--#-#--#-#--#-#--#-#--#-#--#-#--#-#--#-#--#-#--#-#--#-#--#-#--#-#--#-#--#-#--#-#--#-#--#-#--#-#--
----#----#----#----#----#----#----#----#----#----#----#----#----#----#----#----#----#----#----#----#
--#----#----#----#----#----#----#----#----#----#----#----#----#----#----#----#----#----#----#----#--
-##---##---##---##---##---##---##---##---##---##---##---##---##---##---##---##---##---##---##---##--
-#----#----#----#----#----#----#----#----#----#----#----#----#----#----#----#----#----#----#----#---
#-#--#-#--#-#--#-#--#-#--#-#--#-#--#-#--#-#--#-#--#-#--#-#--#-#--#-#--#-#--#-#--#-#--#-#--#-#--#-#--
----#----#----#----#----#----#----#----#----#----#----#----#----#----#----#----#----#----#----#----#
--#----#----#----#----#----#----#----#----#----#----#----#----#----#----#----#----#----#----#----#--
-##---##---##---##---##---##---##---##---##---##---##---##---##---##---##---##---##---##---##---##--
-#----#----#----#----#----#----#----#----#----#----#----#----#----#----#----#----#----#----#----#---
#-#--#-#--#-#--#-#--#-#--#-#--#-#--#-#--#-#--#-#--#-#--#-#--#-#--#-#--#-#--#-#--#-#--#-#--#-#--#-#--
----#----#----#----#----#----#----#----#----#----#----#----#----#----#----#----#----#----#----#----#
--#----#----#----#----#----#----#----#----#----#----#----#----#----#----#----#----#----#----#----#--
-##---##---##---##---##---##---##---##---##---##---##---##---##---##---##---##---##---##---##---##--
-#----#----#----#----#----#----#----#----#----#----#----#----#----#----#----#----#----#----#----#---
#-#--#-#--#-#--#-#--#-#--#-#--#-#--#-#--#-#--#-#--#-#--#-#--#-#--#-#--#-#--#-#--#-#--#-#--#-#--#-#--
----#----#----#----#----#----#----#----#----#----#----#----#----#----#----#----#----#----#----#----#
--#----#----#----#----#----#----#----#----#----#----#----#----#----#----#----#----#----#----#----#--
-##---##---##---##---##---##---##---##---##---##---##---##---##---##---##---##---##---##---##---##--
-#----#----#----#----#----#----#----#----#----#----#----#----#----#----#----#----#----#----#----#---
#-#--#-#--#-#--#-#--#-#--#-#--#-#--#-#--#-#--#-#--#-#--#-#--#-#--#-#--#-#--#-#--#-#--#-#--#-#--#-#--
----#----#----#----#----#----#----#----#----#----#----#----#----#----#----#----#----#----#----#----#
--#----#----#----#----#----#----#----#----#----#----#----#----#----#----#----#----#----#----#----#--
-##---##---##---##---##---##---##---##---##---##---##---##---##---##---##---##---##---##---##---##--
-#----#----#----#----#----#----#----#----#----#----#----#----#----#----#----#----#----#----#----#---
#-#--#-#--#-#--#-#--#-#--#-#--#-#--#-#--#-#--#-#--#-#--#-#--#-#--#-#--#-#--#-#--#-#--#-#--#-#--#-#--
----#----#----#----#----#----#----#----#----#----#----#----#----#----#----#----#----#----#----#----#
--#----#----#----#----#----#----#----#----#----#----#----#----#----#----#----#----#----#----#----#--
-##---##---##---##---##---##---##---##---##---##---##---##---##---##---##---##---##---##---##---##--
-#----#----#----#----#----#----#----#----#----#----#----#----#----#----#----#----#----#----#----#---
#-#--#-#--#-#--#-#--#-#--#-#--#-#--#-#--#-#--#-#--#-#--#-#--#-#--#-#--#-#--#-#--#-#--#-#--#-#--#-#--
----#----#----#----#----#----#----#----#----#----#----#----#----#----#----#----#----#----#----#----#
--#----#----#----#----#----#----#----#----#----#----#----#----#----#----#----#----#----#----#----#--
-##---##---##---##---##---##---##---##---##---##---##---##---##---##---##---##---##---##---##---##--
-#----#----#----#----#----#----#----#----#----#----#----#----#----#----#----#----#----#----#----#---
#-#--#-#--#-#--#-#--#-#--#-#--#-#--#-#--#-#--#-#--#-#--#-#--#-#--#-#--#-#--#-#--#-#--#-#--#-#--#-#--
----#----#----#----#----#----#----#----#----#----#----#----#----#----#----#----#----#----#----#----#
--#----#----#----#----#----#----#----#----#----#----#----#----#----#----#----#----#----#----#----#--
-##---##---##---##---##---##---##---##---##---##---##---##---##---##---##---##---##---##---##---##--
-#----#----#----#----#----#----#----#----#----#----#----#----#----#----#----#----#----#----#----#---
#-#--#-#--#-#--#-#--#-#--#-#--#-#--#-#--#-#--#-#--#-#--#-#--#-#--#-#--#-#--#-#--#-#--#-#--#-#--#-#--
----#----#----#----#----#----#----#----#----#----#----#----#----#----#----#----#----#----#----#----#
--#----#----#----#----#----#----#----#----#----#----#----#----#----#----#----#----#----#----#----#--
-##---##---##---##---##---##---##---##---##---##---##---##---##---##---##---##---##---##---##---##--
-#----#----#----#----#----#----#----#----#----#----#----#----#----#----#----#----#----#----#--E-#---
#-#--#-#--#-#--#-#--#-#--#-#--#-#--#-#--#-#--#-#--#-#--#-#--#-#--#-#--#-#--#-#--#-#--#-#--#-#--#-#--
----#----#----#----#----#----#----#----#----#----#----#----#----#----#----#----#----#----#----#----#
--#----#----#----#----#----#----#----#----#----#----#----#----#----#----#----#----#----#----#----#--
-##---##---##---##---##---##---##---##---##---##---##---##---##---##---##---##---##---##---##---##--
-#----#----#----#----#----#----#----#----#----#----#----#----#----#----#----#----#----#----#----#---
#-#--#-#--#-#--#-#--#-#--#-#--#-#--#-#--#-#--#-#--#-#--#-#--#-#--#-#--#-#--#-#--#-#--#-#--#-#--#-#--
----#----#----#----#----#----#----#----#----#----#----#----#----#----#----#----#----#----#----#----#
--#----#----#----#----#----#----#----#----#----#----#----#----#----#----#----#----#----#----#----#--
-##---##---##---##---##---##---##---##---##---##---##---##---##---##---##---##---##---##---##---##--
-#----#----#----#----#----#----#----#----#----#----#----#----#----#----#----#----#----#----#----#---
#-#--#-#--#-#--#-#--#-#--#-#--#-#--#-#--#-#--#-#--#-#--#-#--#-#--#-#--#-#--#-#--#-#--#-#--#-#--#-#--
----#----#----#----#----#----#----#----#----#----#----#----#----#----#----#----#----#----#----#----#
--#----#----#----#----#----#----#----#----#----#----#----#----#----#----#----#----#----#----#----#--
-##---##---##---##---##---##---##---##---##---##---##---##---##---##---##---##---##---##---##---##--
-#----#----#----#----#----#----#----#----#----#----#----#----#----#----#----#----#----#----#----#---
#-#--#-#--#-#--#-#--#-#--#-#--#-#--#-#--#-#--#-#--#-#--#-#--#-#--#-#--#-#--#-#--#-#--#-#--#-#--#-#--
----#----#----#----#----#----#----#----#----#----#----#----#----#----#----#----#----#----#----#----#
--#----#----#----#----#----#----#----#----#----#----#----#----#----#----#----#----#----#----#----#--
-##---##---##---##---##---##---##---##---##---##---##---##---##---##---##---##---##---##---##---##--
-#----#----#----#----#----#----#----#----#----#----#----#----#----#----#----#----#----#----#----#---
#-#--#-#--#-#--#-#--#-#--#-#--#-#--#-#--#-#--#-#--#-#--#-#--#-#--#-#--#-#--#-#--#-#--#-#--#-#--#-#--
----#----#----#----#----#----#----#----#----#----#----#----#----#----#----#----#----#----#----#----#
--#----#----#----#----#----#----#----#----#----#----#----#----#----#----#----#----#----#----#----#--
-##---##---##---##---##---##---##---##---##---##---##---##---##---##---##---##---##---##---##---##--
-#----#----#----#----#----#----#----#----#----#----#----#----#----#----#----#----#----#----#----#---
#-#--#-#--#-#--#-#--#-#--#-#--#-#--#-#--#-#--#-#--#-#--#-#--#-#--#-#--#-#--#-#--#-#--#-#--#-#--#-#--
----#----#----#----#----#----#----#----#----#----#----#----#----#----#----#----#----#----#----#----#
--#----#----#----#----#----#----#----#----#----#----#----#----#----#----#----#----#----#----#----#--
-##---##---##---##---##---##---##---##---##---##---##---##---##---##---##---##---##---##---##---##--
-#----#----#----#----#----#----#----#----#----#----#----#----#----#----#----#----#----#----#----#---
#-#--#-#--#-#--#-#--#-#--#-#--#-#--#-#--#-#--#-#--#-#--#-#--#-#--#-#--#-#--#-#--#-#--#-#--#-#--#-#--
----#----#----#----#----#----#----#----#----#----#----#----#----#----#----#----#----#----#----#----#
--#----#----#----#----#----#----#----#----#----#----#----#----#----#----#----#----#----#----#----#--
-##---##---##---##---##---##---##---##---##---##---##---##---##---##---##---##---##---##---##---##--
-#----#----#----#----#----#----#----#----#----#----#----#----#----#----#----#----#----#----#----#---
#-#--#-#--#-#--#-#--#-#--#-#--#-#--#-#--#-#--#-#--#-#--#-#--#-#--#-#--#-#--#-#--#-#--#-#--#-#--#-#--
----#----#----#----#----#----#----#----#----#----#----#----#----#----#----#----#----#----#----#----#
--#----#----#----#----#----#----#----#----#----#----#----#----#----#----#----#----#----#----#----#--
-##---##---##---##---##---##---##---##---##---##---##---##---##---##---##---##---##---##---##---##--
-#----#----#----#----#----#----#----#----#----#----#----#----#----#----#----#----#----#----#----#---