#-#--###-----##--##------#-#----#----#--##-#------#----##-----##----##---#---##-#-#-##-#-----###-#--
--#---#------#-##-#-#--#--#-#------###-------#----##-##--##-------#--#--#----#-#--#----------#----##
##----#-#----#-----#-----#-##--##--#-#----#--#-----##------#----------###-##------#----#---#--##----
#--##----#----##---#--##--#------#----#---#-#--##--##----#---#---#--#--#--#--#---------#----#--#----
------###-#----#--#-----#-#-#--##--#---#-#-----#----#---------#-#------####--#--#---------##---#-#-#
-----#-------------##---##-##--#--##--------#-#-#------##--#-------#---#-----#--#---#--#--------#-#-
----------#-#-#---#-----###---##---##------#---#-###---#---#--##-#------#--#-#----#--##-------#---##
--#-#--------##-----------#---#-----##--##--##------#-#-##--#---#-#E--#-#-##---------#---------#----
--------#-------##--#--#-#--#---#---#--####---#-#-##--------#---#-#---------##----##-###----------##
-------#----#---#-###----#-----#-----#-----####-----#---#--#---#---##-#--------##-#-#----#------####
-----#-##------##-#-##---##--#------#-----#--#---##----#-#--#-#----##-#------#----##--#-------#-#-#-
#--##----##----#-#----##-----#-------####-#--------#-#-#------###--#---------#-#-#-##-----#---------
-----##--##-#-###--########-#-------#----#-------##---#--#-#-#-##----------#---###-----#--##---#----
---##----#--##--#-#---#-###----#-##---------##--#----#-####----##-#--##------#-###--#----#-------#--
---#--------#-----##-#-#---#-#-#------##-#-#--###-------#-----##-#----#------#-#-#----#--#-----#---#
--#-----####---###--#####--#-#--##-###--#---#----#-#--#--##--#--#--##----#--##----#-#-------#-#-#---
---#---#--#----#------#-#------#--####----###---#----###---##------#-#---##---------#---#--#--------
-#-##----#-#----------#----#---#---#----#-----#--#------##----##--###-#-----------#--#-#------------
--#-------#-#---##-##--#---#--#-#---#--#------###-#-###-#---#-#---##-#--#------##-#--#-#---##-------
#-#------#--#------#-#--#-##------#----#-#------#-#----#-#--#-#-----#--#-#-#-#----##---#--#---#----#
-##-------###---------#-#--#-#--#--####--#-----#--#---#####-#---##--##--#-#--##-#--##-----#----#--#-
##---##----#---####-----#-#-----#-------#-#----#-------#--#--#--------#-----#####--#--#---#---##--#-
##--###-##-##---######----#--#-##-##S----##-#----#-#--------##-#-##-#--#-#-##---##---#----#--#-#-###
---------------#---#-------#----##--#----#-#-----------####-----#-----#--#-----#--#-#-----#-#------#
----#-#-#--###-------##--#--------------####-##-----###----#----#----##---###-------#---------#--#--
---#--#---###--##-##---##--##-#---#-#-#-#--------#--##----#-#--#--#---###-----#---#--#--##-#-#--#---
-###---#--#--#-##--##--##-#--#--#----#-------#-##----##--#--#----#-#-------#---#---#--##---------#--
-#-#---#---##-#---##-#---#----#-##-##-#--#--#--##-#---#----#--#---#-#-##-----#----#----#----------##
#--#--------#----------####-----#--#-----#---#---#--#---##----#-###-------#-#-#--#---#------#--#--#-
##-----#------#-----###----------#-#-##-##--#-----#-----#--#----------------------#---#-#---#-------
#----#---#--#--#-###--###--#--#---#--#------#----#---##-#---#--#--#-#-#---#-##----#-#---#-##-###-#--
##-----#--#-#--#----#--##--#-------#----##---#-------###-----------##-##-----#-------##----##-##-##-
------#-#-##-##-#------#-------##-#-#---#----#---##------##-----##---#-#-##-#---#####--#-------##---
------###-##--#--#---#-##-#----#----####-#---#-##---#--#------###-#--##--#-----------###-------#----
---------##------------#--##-----#-------#-#---#--#---#-----#------#-----#--##-#-#--##----##----#---
-----#---##-##--#--#--#-----##------##-#---------###-#-#--##--------#-#--#-----###---#-------#-----#
##--#------#----#-##-----##---#------#-##-#---##---##----##--#---#---#-##--##-#-#---##-----#--##----
#--#---#-#--##-#---##----------#---#--##--------##----##-#-#----#--#-#---#---#----#---####-##---#-#-
--#-#---#------##-#----#---#---#-------#-#-##-#-##-####-##-#--#-------#---#----####-#---#----##--#--
-##--#-#----##-#-##--#--#-#---#--#---###-----------##------#--###--#---##-##----#-##----##--#---#-#-
----#---#----#--#---#-#------##-##--##----##--#------#--#----#--#-#-#---#--##-#----###------------##
-----##-#-------#--###---##----#-#-##--##-#-#----#-#-#--#-#-#--#----###----#--#---#-----#----##----#
#-###---#-#--#---#--##-------##--##---#-------###------#-------------#-#---#-------#-#---#-#---##---
##----####-##-#------##-#---###-#-------#-####-##-#----##----##------#-----#-#-----#--#--#---##-----
-#----###--#-------##------##-#-#-#--#--#----##----#-----------#--#----#----#-#----#-----###--#-----
------#---##--##----##-#-----###--#-#--#--------------#-#----##-#-#-##---------#--#-#------##---#-#-
--#--#-#-#----####-#-------##-#-#----#--##-#---#-##---#--#--##---------###-#-##--###-##-#-------#---
----#-#--#-------###--##--##---##-##--##---##---#-#####---####--#-------#---##----#-#------#--####--
-------###-#------#---#---#--------#---#-----##------##-#--#-#-##------####---####--------#--##--###
-#-#--#---#-##-#-------###--------------#-#---#--##---#--#--#-----#---#---------#--#--#-#-#---------
--#--#----#-#----#-----------#---###--#----###--#--##--#----#-#-----##------##-#---##-#--------#-#--
------####---###--------##-#---#-#----#---------##-----#-#-------##-###---#--#-----#--#-#---###-#---
-#---#--#--##---##-----#----#--##--#-------#-#-#-------#--#-----##---#----#-##----###-----#-#-#-#---
#------#-##-##--##---#-----#-------#----#-----#-----#-#--#----#------#--#-#-----##-#-##-#--#-##-----
##--#-#----#-#-##-###-#------##----#-#-##-#-###-------#----#---#-#--#-#---#-----------#--#-----#----
-#-#---##--#-----#--#----------#--#------#----#--------##---#--#--#--#---------##-------#----#--####
---#-#--##--------#-#----#--#-----#----#----#--#-------#----#----#-#---##-##--#-#---#----#---#------
--#--#--#--#-----#-----##--##-##---###----##----#-#-----##-#-#-------##-#-#---#-#--##----#-----###--
#--#---#------#--#---#---------#-----###---#------------#-#--##---#--#----#-----#----#--#--------#--
#---#-----------#--##------##---#------------#-#####---#-#--#-#####-#-----------#-----#--#---------#
-#-#--#---##---------#----#----##------#---#---#--#---#-#--###----##-----##---##---#--##------##-#--
#-#--#-----###---##------------###--#--##-##-#----##--#--#-----#-#-##----#-#---###---#-##-----###---
--#-----#-##--##-#----#--####-#-------------#-####-#---##---#---#-#-----------------#----##---#-##--
#--###--------##--------##--#------#--#--------------#-#-------#-#--#-#--#-#-#----#---#--------#----
#--######-----#-#--#-##--#-##----#---##---------#--#-#--#----------#------#---#---#-##----##-#------
--#----#-#-##---#-##-#--#-----####-#-#---------#--------#--#-----#-#-#-----------#---#-#-##-#-----#-
---------##------------#-#-#-#-#-##-------#--#-#---##----#--##--------###--##-#----#--##--#-#---#--#
--###-------#-#----------##-#--------##---##---#--#-----###---#-#-----##-#-----##----##-----#--##---
----#----------#----###------#--------#-#--#-#-------##--#-###---#--#-##--#----#-##---#-####--#-#---
-#-#-####----##---#---#-##---##----#---#--##-----##---#----##-#----#--#--##--#------#----#-#--#---##
-#-------#-#------#-----###--#--------#-#---------#------#-#----##-###-#--#---------##---#-##--#---#
#---####---#------#-#----##--------#-#-#------##--##--#---#-#-#---#-#---------##--#--------#------##
--------##-#-------#---#-----#--#-#-------#---##---##-##---#-#--#--------#---#-----#---#----##---#--
--#-#-###-----#-##-----#---#------#-------#-##-----#-####-#---#-#----------#------##---#----#-#-#---
---------#--#--#----#-#-----###-----##-----#----#------#-##----#--#----#---##--####-#--##--##---#--#
##----#---#-#-#-----##--------##-----#----###-#-------#---------##----------#-#-##--#----#----------
--#---#-#--#-------#--#-----#-#-#----#---###-#------#--#---##-#-#--#--#---##--#-#--#-#-#----##----#-
--------###-#--##-----##---#----#----#-#-------##-##--#-------#-----------------#---#---#--------#--
-#-##----#-##----#-#------#-#----###----#---#----#---#-#-----#----#-#-------#--###--#---#-#-##--##-#
#-#-----##----#-------------#---##--###--#---#####----#-###------#-#--#-----#-#-#--#----##-#-----#--
--#--#---###--##--#---#-----##---------#--##-#-------##--#--#----##-#---#--------##-----------##----
#-----#--##-----#--------###----------#--#---#-----#---#-----#-##-#-------#---#---###--##--#--#-----
-------------#---###------#----#-#-------------##---#-####-------------#--#------#----###---#----##-
------#--#--#-###--#--#------##-#-#-#----#-----#----##-#-##----#--#-##-#--------###------#-##----##-
--------------#--###-#---------#-####----#----#------#----#-#-#---#---------#####---------##-#------
--#--#--#---#-##-#-----#-------#-##--#--#-----#---##----##---#-------#----##--#---#------------##---
-#--#----#----#----#--#-#---###-##--#--##----#--##-----#------#--#-----#----##--###---#---#---------
-#----#--#-##--#----#-##------------#-------#--#----#--------##--------#----##-##-----#-#---##--#--#
-#---##--#---###---###----#-#-#-#-#-#--#####-----#---#--#-------#--#----#---------#-------####----#-
--#--#--#----##------#----#-#---#----------#---#-#---#-##-#---#--#-#-##---#---#-----#--------------#
##--##-####--#----------##-#---#----##-#------------###------#---#------#---------#--#------##---#-#
-----##----#------#----#---#-##---##-#-#--#---#--#--#-#####--###-######---#---#---###-##-#-#-------#
--#-#--#----#-###-###--#---------#---#--#---###---#-#-#----##-----------##---#---------#---#----###-
#--#-----#-##--#####--#-###---#--###----##-#-#----------#--##-------#--##-###-#--#--#---####--------
---------#------#-#-----#-----#--##-#-----####--#--#-#-----#-#----#-#----#-#----#######----------##-
#----------##---##-##------##---#-----#--#----#----#----#---##------#-##-#--###-###--#------#-----#-
#-#---------#------#-#-#-#---#---###-----#--##--------#-###----#---#---#-##-------#----------####---
-#--#-#-#-##-#---#--#-#-------#-##-##---##---###-----#--###-----#----#--#-#--#--#-------------#-###-
-#--------#--#-##---------------#-----#-#-#-#--#-##-#-#----------###---#----------##---#---#---#----
-----------#-#---#----#--#-###-----#-#-#---###--##-#####--------#--##-#-----#-##---#------#------#--