----------------------------------------------------------------------------------------------------
--###--###--###--###--###--###--###--###--###--###--###--###--###--###--###--###--###--###--###--###
--##---##---##---##---##---##---##---##---##---##---##---##---##---##---##---##---##---##---##---##-
---#----#----#----#----#----#----#----#----#----#----#----#----#----#----#----#----#----#----#----#-
----#----#----#----#----#----#----#----#----#----#----#----#----#----#----#----#----#----#----#----#
----------------------------------------------------------------------------------------------------
--###--###--###--###--###--###--###--###--###--###--###--###--###--###--###--###--###--###--###--###
--##---##---##---##---##---##---##---##---##---##---##---##---##---##---##---##---##---##---##---##-
---#----#----#----#----#----#----#----#----#----#----#----#----#----#----#----#----#----#----#----#-
----#----#----#----#----#----#----#----#----#----#----#----#----#----#----#----#----#----#----#----#
----------------------------------------------------------------------------------------------------
--###--###--###--###--###--###--###--###--###--###--###--###--###--###--###--###--###--###--###--###
--##---##---##---##---##---##---##---##---##---##---##---##---##---##---##---##---##---##---##---##-
---#----#----#----#----#----#----#----#----#----#----#----#----#----#----#----#----#----#----#----#-
----#----#----#----#----#----#----#----#----#----#----#----#----#----#----#----#----#----#----#----#
----------------------------------------------------------------------------------------------------
--###--###--###--###--###--###--###--###--###--###--###--###--###--###--###--###--###--###--###--###
--##---##---##---##---##---##---##---##---##---##---##---##---##---##---##---##---##---##---##---##-
---#----#----#----#----#----#----#----#----#----#----#----#----#----#----#----#----#----#----#----#-
----#----#----#----#----#----#----#----#----#----#----#----#----#----#----#----#----#----#----#----#
----------------------------------------------------------------------------------------------------
--###--###--###--###--###--###--###--###--###--###--###--###--###--###--###--###--###--###--###--###
--##---##---##---##---##---##---##---##---##---##---##---##---##---##---##---##---##---##---##---##-
---#----#----#----#----#----#----#----#----#----#----#----#----#----#----#----#----#----#----#----#-
----#----#----#----#----#----#----#----#----#----#----#----#----#----#----#----#----#----#----#----#
----------------------------------------------------------------------------------------------------
--###--###--###--###--###--###--###--###--###--###--###--###--###--###--###--###--###--###--###--###
--##---##---##---##---##---##---##---##---##---##---##---##---##---##---##---##---##---##---##---##-
---#----#----#----#----#----#----#----#----#----#----#----#----#----#----#----#----#----#----#----#-
----#----#----#----#----#----#----#----#----#----#----#----#----#----#----#----#----#----#----#----#
----------------------------------------------------------------------------------------------------
--###--###--###--###--###--###--###--###--###--###--###--###--###--###--###--###--###--###--###--###
--##---##---##---##---##---##---##---##---##---##---##---##---##---##---##---##---##---##---##---##-
---#----#----#----#----#----#----#----#----#----#----#----#----#----#----#----#----#----#----#----#-
----#----#----#----#----#----#----#----#----#----#----#----#----#----#----#----#----#----#----#----#
----------------------------------------------------------------------------------------------------
--###--###--###--###--###--###--###--###--###--###--###--###--###--###--###--###--###--###--###--###
--##---##---##---##---##---##---##---##---##---##---##---##---##---##---##---##---##---##---##---##-
---#----#----#----#----#----#----#----#----#----#----#----#----#----#----#----#----#----#----#----#-
----#----#----#----#----#----#----#----#----#----#----#----#----#----#----#----#----#----#----#----#
----------------------------------------------------------------------------------------------------
--###--###--###--###--###--###--###--###--###--###--###--###--###--###--###--###--###--###--###--###
--##---##---##---##---##---##---##---##---##---##---##---##---##---##---##---##---##---##---##---##-
---#----#----#----#----#----#----#----#----#----#----#----#----#----#----#----#----#----#----#----#-
----#----#----#----#----#----#----#----#----#----#----#----#----#----#----#----#----#----#----#----#
----------------------------------------------------------------------------------------------------
--###--###--###--###--###--###--###--###--###--###--###--###--###--###--###--###--###--###--###--###
--##---##---##---##---##---##---##---##---##---##---##---##---##---##---##---##---##---##---##---##-
---#----#----#----#----#----#----#----#----#----#----#----#----#----#----#----#----#----#----#----#-
----#----#----#----#----#----#----#----#----#----#----#----#----#----#----#----#----#----#----#----#
----------------------------------------------------------------------------------------------------
--###--###--###--###--###--###--###--###--###--###--###--###--###--###--###--###--###--###--###--###
--##---##---##---##---##---##---##---##---##---##---##---##---##---##---##---##---##---##---##---##-
---#----#----#----#----#----#----#----#----#----#----#----#----#----#----#----#----#----#----#----#-
----#----#----#----#----#----#----#----#----#----#----#----#----#----#----#----#----#----#----#----#
----------------------------------------------------------------------------------------------------
--###--###--###--###--###--###--###--###--###--###--###--###--###--###--###--###--###--###--###--###
--##---##---##---##---##---##---##---##---##---##---##---##---##---##---##---##---##---##---##---##-
---#----#----#----#----#----#----#----#----#----#----#----#----#----#----#----#----#----#----#----#-
----#----#----#----#----#----#----#----#----#----#----#----#----#----#----#----#----#----#----#----#
----------------------------------------------------------------------------------------------------
--###--###--###--###--###--###--###--###--###--###--###--###--###--###--###--###--###--###--###--###
--##---##---##---##---##---##---##---##---##---##---##---##---##---##---##---##---##---##---##---##-
---#----#----#----#----#----#----#----#----#----#----#----#----#----#----#----#----#----#----#----#-
----#----#----#----#----#----#----#----#----#----#----#----#----#----#----#----#----#----#----#----#
----------------------------------------------------------------------------------------------------
--###--###--###--###--###--###--###--###--###--###--###--###--###--###--###--###--###--###--###--###
--##---##---##---##---##---##---##---##---##---##---##---##---##---##---##---##---##---##---##---##-
---#----#----#----#----#----#----#--S-#----#----#----#----#----#----#----#----#----#----#----#----#-
----#----#----#----#----#----#----#----#----#----#----#----#----#----#----#----#----#----#----#----#
----------------------------------------------------------------------------------------------------
--###--###--###--###--###--###--###--###--###--###--###--###--###--###--###--###--###--###--###--###
--##---##---##---##---##---##---##---##---##---##---##---##---##---##---##---##---##---##---##---##-
---#----#----#----#----#----#----#----#----#----#----#----#----#----#----#----#----#----#----#----#-
----#----#----#----#----#----#----#----#----#----#----#----#----#----#----#----#----#----#----#----#
----------------------------------------------------------------------------------------------------
--###--###--###--###--###--###--###--###--###--###--###--###--###--###--###--###--###--###--###--###
--##---##---##---##---##---##---##---##---##---##---##---##---##---##---##---##---##---##---##---##-
---#----#----#----#----#----#----#----#----#----#----#----#----#----#----#----#----#----#----#----#-
----#----#----#----#----#----#----#----#----#----#----#----#----#----#----#----#----#----#----#----#
----------------------------------------------------------------------------------------------------
--###--###--###--###--###--###--###--###--###--###--###--###--###--###--###--###--###--###--###--###
--##---##---##---##---##---##---##---##---##---##---##---##---##---##---##---##---##---##---##---##-
---#----#----#----#----#----#----#----#----#----#----#----#----#----#----#----#----#----#----#----#-
----#----#----#----#----#----#----#----#----#----#----#----#----#----#----#----#----#----#----#----#
----------------------------------------------------------------------------------------------------
--###--###--###--###--###--###--###--###--###--###--###--###--###--###--###--###--###--###--###--###
--##---##---##---##---##---##---##---##---##---##---##---##---##---##---##---##---##---##---##---##-
---#----#----#----#----#----#----#----#----#----#----#----#----#----#----#----#----#----#----#----#-
----#----#----#----#----#----#----#----#----#----#----#----#----#----#----#----#----#----#----#----#
-------------------------E--------------------------------------------------------------------------
--###--###--###--###--###--###--###--###--###--###--###--###--###--###--###--###--###--###--###--###
--##---##---##---##---##---##---##---##---##---##---##---##---##---##---##---##---##---##---##---##-
---#----#----#----#----#----#----#----#----#----#----#----#----#----#----#----#----#----#----#----#-
----#----#----#----#----#----#----#----#----#----#----#----#----#----#----#----#----#----#----#----#
----------------------------------------------------------------------------------------------------
--###--###--###--###--###--###--###--###--###--###--###--###--###--###--###--###--###--###--###--###
--##---##---##---##---##---##---##---##---##---##---##---##---##---##---##---##---##---##---##---##-
---#----#----#----#----#----#----#----#----#----#----#----#----#----#----#----#----#----#----#----#-
----#----#----#----#----#----#----#----#----#----#----#----#----#----#----#----#----#----#----#----#