--##---##---##---##---##---##---##---##---##---##---##---##---##---##---##---##---##---##---##---##-
-#----#----#----#----#----#----#----#----#----#----#----#----#----#----#----#----#----#----#----#---
--#----#----#----#----#----#----#----#----#----#S---#----#----#----#----#----#----#----#----#----#--
---#----#----#----#----#----#----#----#----#----#----#----#----#----#----#----#----#----#----#----#-
-#----#----#----#----#----#----#----#----#----#----#----#----#----#----#----#----#----#----#----#---
--##---##---##---##---##---##---##---##---##---##---##---##---##---##---##---##---##---##---##---##-
-#----#----#----#----#----#----#----#----#----#----#----#----#----#----#----#----#----#----#----#---
--#----#----#----#----#----#----#----#----#----#----#----#----#----#----#----#----#----#----#----#--
---#----#----#----#----#----#----#----#----#----#----#----#----#----#----#----#----#----#----#----#-
-#----#----#----#----#----#----#----#----#----#----#----#----#----#----#----#----#----#----#----#---
--##---##---##---##---##---##---##---##---##---##---##---##---##---##---##---##---##---##---##---##-
-#----#----#----#----#----#----#----#----#----#----#----#----#----#----#----#----#----#----#----#---
--#----#----#----#----#----#----#----#----#----#----#----#----#----#----#----#----#----#----#----#--
---#----#----#----#----#----#----#----#----#----#----#----#----#----#----#----#----#----#----#----#-
-#----#----#----#----#----#----#----#----#----#----#----#----#----#----#----#----#----#----#----#---
--##---##---##---##---##---##---##---##---##---##---##---##---##---##---##---##---##---##---##---##-
-#----#----#----#----#----#----#----#----#----#----#----#----#----#----#----#----#----#----#----#---
--#----#----#----#----#----#----#----#----#----#----#----#----#----#----#----#----#----#----#----#--
---#----#----#----#----#----#----#----#----#----#----#----#----#----#----#----#----#----#----#----#-
-#----#----#----#----#----#----#----#----#----#----#----#----#----#----#----#----#----#----#----#---
--##---##---##---##---##---##---##---##---##---##---##---##---##---##---##---##---##---##---##---##-
-#----#----#----#----#----#----#----#----#----#----#----#----#----#----#----#----#----#----#----#---
--#----#----#----#----#----#----#----#----#----#----#----#----#----#----#----#----#----#----#----#--
---#----#----#----#----#----#----#----#----#----#----#----#----#----#----#----#----#----#----#----#-
-#----#----#----#----#----#----#----#----#----#----#----#----#----#----#----#----#----#----#----#---
--##---##---##---##---##---##---##---##---##---##---##---##---##---##---##---##---##---##---##---##-
-#----#----#----#----#----#----#----#----#----#----#----#----#----#----#----#----#----#----#----#---
--#----#----#----#----#----#----#----#----#----#----#----#----#----#----#----#----#----#----#----#--
---#----#----#----#----#----#----#----#----#----#----#----#----#----#----#----#----#----#----#----#-
-#----#----#----#----#----#----#----#----#----#----#----#----#----#----#----#----#----#----#----#---
--##---##---##---##---##---##---##---##---##---##---##---##---##---##---##---##---##---##---##---##-
-#----#----#----#----#----#----#----#----#----#----#----#----#----#----#----#----#----#----#----#---
--#----#----#----#----#----#----#----#----#----#----#----#----#----#----#----#----#----#----#----#--
---#----#----#----#----#----#----#----#----#----#----#----#----#----#----#----#----#----#----#----#-
-#----#----#----#----#----#----#----#----#----#----#----#----#----#----#----#----#----#----#----#---
--##---##---##---##---##---##---##---##---##---##---##---##---##---##---##---##---##---##---##---##-
-#----#----#----#----#----#----#----#----#----#----#----#----#----#----#----#----#----#----#----#---
--#----#----#----#----#----#----#----#----#----#----#----#----#----#----#----#----#----#----#----#--
---#----#----#----#----#----#----#----#----#----#----#----#----#----#----#----#----#----#----#----#-
-#----#----#----#----#----#----#----#----#----#----#----#----#----#----#----#----#----#----#----#---
--##---##---##---##---##---##---##---##---##---##---##---##---##---##---##---##---##---##---##---##-
-#----#----#----#----#----#----#----#----#----#----#----#----#----#----#----#----#----#----#----#---
--#----#----#----#----#----#----#----#----#----#----#----#----#----#----#----#----#----#----#----#--
---#----#----#----#----#----#----#----#----#----#----#----#----#----#----#----#----#----#----#----#-
-#----#----#----#----#----#----#----#----#----#----#----#----#----#----#----#----#----#----#----#---
--##---##---##---##---##---##---##---##---##---##---##---##---##---##---##---##---##---##---##---##-
-#----#----#----#----#----#----#----#----#----#----#----#----#----#----#----#----#----#----#----#---
--#----#----#----#----#----#----#----#----#----#----#----#----#----#----#----#----#----#----#----#--
---#----#----#----#----#----#----#----#----#----#----#----#----#----#----#----#----#----#----#----#-
-#----#----#----#----#----#----#----#----#----#----#----#----#----#----#----#----#----#----#----#---
--##---##---##---##---##---##---##---##---##---##---##---##---##---##---##---##---##---##---##---##-
-#----#----#----#----#----#----#----#----#----#----#----#----#----#----#----#----#----#----#----#---
--#----#----#----#----#----#----#----#----#----#----#----#----#----#----#----#----#----#----#----#--
---#----#----#----#----#----#----#----#----#----#----#----#----#----#----#----#----#----#----#----#-
-#----#----#----#----#----#----#----#----#----#----#----#----#----#----#----#----#----#----#----#---
--##---##---##---##---##---##---##---##---##---##---##---##---##---##---##---##---##---##---##---##-
-#----#----#----#----#----#----#----#----#----#----#----#----#----#----#----#----#----#----#----#---
--#----#----#----#----#----#----#----#----#---E#----#----#----#----#----#----#----#----#----#----#--
---#----#----#----#----#----#----#----#----#----#----#----#----#----#----#----#----#----#----#----#-
-#----#----#----#----#----#----#----#----#----#----#----#----#----#----#----#----#----#----#----#---
--##---##---##---##---##---##---##---##---##---##---##---##---##---##---##---##---##---##---##---##-
-#----#----#----#----#----#----#----#----#----#----#----#----#----#----#----#----#----#----#----#---
--#----#----#----#----#----#----#----#----#----#----#----#----#----#----#----#----#----#----#----#--
---#----#----#----#----#----#----#----#----#----#----#----#----#----#----#----#----#----#----#----#-
-#----#----#----#----#----#----#----#----#----#----#----#----#----#----#----#----#----#----#----#---
--##---##---##---##---##---##---##---##---##---##---##---##---##---##---##---##---##---##---##---##-
-#----#----#----#----#----#----#----#----#----#----#----#----#----#----#----#----#----#----#----#---
--#----#----#----#----#----#----#----#----#----#----#----#----#----#----#----#----#----#----#----#--
---#----#----#----#----#----#----#----#----#----#----#----#----#----#----#----#----#----#----#----#-
-#----#----#----#----#----#----#----#----#----#----#----#----#----#----#----#----#----#----#----#---
--##---##---##---##---##---##---##---##---##---##---##---##---##---##---##---##---##---##---##---##-
-#----#----#----#----#----#----#----#----#----#----#----#----#----#----#----#----#----#----#----#---
--#----#----#----#----#----#----#----#----#----#----#----#----#----#----#----#----#----#----#----#--
---#----#----#----#----#----#----#----#----#----#----#----#----#----#----#----#----#----#----#----#-
-#----#----#----#----#----#----#----#----#----#----#----#----#----#----#----#----#----#----#----#---
--##---##---##---##---##---##---##---##---##---##---##---##---##---##---##---##---##---##---##---##-
-#----#----#----#----#----#----#----#----#----#----#----#----#----#----#----#----#----#----#----#---
--#----#----#----#----#----#----#----#----#----#----#----#----#----#----#----#----#----#----#----#--
---#----#----#----#----#----#----#----#----#----#----#----#----#----#----#----#----#----#----#----#-
-#----#----#----#----#----#----#----#----#----#----#----#----#----#----#----#----#----#----#----#---
--##---##---##---##---##---##---##---##---##---##---##---##---##---##---##---##---##---##---##---##-
-#----#----#----#----#----#----#----#----#----#----#----#----#----#----#----#----#----#----#----#---
--#----#----#----#----#----#----#----#----#----#----#----#----#----#----#----#----#----#----#----#--
---#----#----#----#----#----#----#----#----#----#----#----#----#----#----#----#----#----#----#----#-
-#----#----#----#----#----#----#----#----#----#----#----#----#----#----#----#----#----#----#----#---
--##---##---##---##---##---##---##---##---##---##---##---##---##---##---##---##---##---##---##---##-
-#----#----#----#----#----#----#----#----#----#----#----#----#----#----#----#----#----#----#----#---
--#----#----#----#----#----#----#----#----#----#----#----#----#----#----#----#----#----#----#----#--
---#----#----#----#----#----#----#----#----#----#----#----#----#----#----#----#----#----#----#----#-
-#----#----#----#----#----#----#----#----#----#----#----#----#----#----#----#----#----#----#----#---
--##---##---##---##---##---##---##---##---##---##---##---##---##---##---##---##---##---##---##---##-
-#----#----#----#----#----#----#----#----#----#----#----#----#----#----#----#----#----#----#----#---
--#----#----#----#----#----#----#----#----#----#----#----#----#----#----#----#----#----#----#----#--
---#----#----#----#----#----#----#----#----#----#----#----#----#----#----#----#----#----#----#----#-
-#----#----#----#----#----#----#----#----#----#----#----#----#----#----#----#----#----#----#----#---
--##---##---##---##---##---##---##---##---##---##---##---##---##---##---##---##---##---##---##---##-
-#----#----#----#----#----#----#----#----#----#----#----#----#----#----#----#----#----#----#----#---
--#----#----#----#----#----#----#----#----#----#----#----#----#----#----#----#----#----#----#----#--
---#----#----#----#----#----#----#----#----#----#----#----#----#----#----#----#----#----#----#----#-
-#----#----#----#----#----#----#----#----#----#----#----#----#----#----#----#----#----#----#----#---