-#-#-#####--#--#-#-#----#--#---##----###--#----#--##--#-#--#---#-------##---##-#--##---#--#-------#-
#--------#-#-###-------##---##-##--#---#----#---#--#-#---#-#---------#--#-----#-#-#-----#-#--##----#
----#-#-#-#-#-##-##--##-----------###--#---#-----------#--#----##---#---#------##-#---#-#-#----#----
---##-#----------#-------#------#---#-#------#----#-#----###-##-#--#---##----#-------#----#----#----
--###-#-#--------##---#--------##--------#--#--##--##--#-#-----#------#----------------#--#--##--#-#
-#----#-----------------#-##-----##----###------#----##-###-###-------#------#---#----####--#-#-----
---#-#---##-#---#-#---####-----##--#--##-###-----#-#-------#---#---#-----#--#--#-#-------#------#---
#--#----------#---#---#-####-#--------#####-------#----------#-#----#-----#---##--####---#---------#
##-##---------#-----##----------#--------##-###-#-#-#--#----###---#-----#--#-----#--S######--#-#----
-----##-##---#--#-------##--##--#--#----#-#------#--#--#---#-#-----#-##-#-##-----##-------#--#--#-##
##---#--#---##------#-----####-##-#-#----#--##-#---###-------#-------#--#-----#-------#-#---###---#-
#---------#-#-#-#--------##--#--##--#-#---##--#-#----#-##-##-#-##---#-----##---##------##-#--#---##-
#-------##-#----#-----------##------------#---#---##--#---#-------##--#-----------#---##-----#---###
#--#-----#---------####---#--###-----###----#-##----##--##--#----##-#-###-##-----##------#-----#----
--#-----###---#----#-#---#-#----------##--###-----#---##------#-#-#---------#---#-#---##--#--#-#----
#-#-##---------#--#####----#-------#--#------#-#------##---###-##-#-#-------#----#--#-#-#--#----#-##
---###--#--#--##------#--##--#-#---#-#-#--##--##-#---#--------------#----#---##-#-#-##--------------
--##--------#-#--###-#-##--------##--##----#--##-######-----#--#-#--#--##--##-##----#-----#-#-----#-
#---#----------#-###---#---#------#-#-#--------##----------#--##--#-##-----#-------#----#---#--#---#
--###-###-#--#--#--##-#--#-#---------------##---#-##---##-----#--#-----#---#----#---#------##---##--
-#-#---#-#-------#---#-#----#------#----#-##-----#---##--#------#-#-#--##---#-#-----------##-#---#--
--#------#--###-------#--##---#--------#-##---#---#---##----#-#---#----#--#-#-----##----#-#-###-----
----#-#-#-#-----#-#----------#----#----------#---#--##--#-#--#---###-####-----#--#-#---------#-#----
----##--#----------#--------#-##-#------#--#-----#-#---###-#---------##----#------#--#----##--##-#-#
-----#--#----##---#---#-----##-#--------#-#---##--#-------#----#-#----##------###--#-#----###-------
---#--#-#--#---#-#---###---------------##--###-#-###-------##-----#-#-##-#-#----#--###-##------#--##
-###-----#--#-#-##--#-----#----##--###-----#-#-#-------#--##---#-#-#----#-###----#----#----#---#----
#--#-#-#---#---#----#-##----#----#---##------#--#-----##-#-#-----------###--#-#---#---##-#-#--#---#-
-##--##----##------##----##---##----#--------#-----------#-#---##---##-#----#--#-###--#-#--#---#----
---#--#-#-#-##-#-##-#-##-#---------#---#---###------------##--##---##---#----#----#-##--#---#-#----#
---#-#-#-#---##-#--#--###-#---------#--#-##-#-#---##---#--#-#------####-#-----#-#-#-#--#--##--##-#--
#-#---##--#-#------##----#--#-#---#--#----------#------###----#--#---#-#--#-------#----#--#--####---
-#-----------#-#-##------#----#--#--#----#----##---#-##---#------#------##------#--###---#--##-----#
-----#-#--#-----####--#-####------#----------#--##-#-----##-#--##----#-----#-#-#-#-#-#--#-----#---#-
###--#-####-#--#--#--#-#----###-#-----#-------------#----#----#--------#--#---#------#----#--####--#
--#------#-----------------#-#----##--#--##------#----#----#--#-#---#-#----#-----##-----#--#####-##-
##-#-#--------##--##-#-----#--###------#-###-##-#--##--#-------------###----#----##---##-#####---##-
-#--##----###----###--#----------#--##-##----#--##----#--#-------#--#-#-#-#---#---#----#-#----#----#
------#--####---#--#--#-#--#-#--------##--#---##-----###--#-##--##-##-----#--##--#-##---###-#-------
------#--#---#-###-#---#--#---##----##--#---#--#---##-------------#----------#--#----##-##------#---
--#-----#--##-----##---#---##----##----#-------#-#--------#----------#---#-----#--#-#-#-####-##-#---
-------------##-#-#--##---#--#-#---##--####------#-----#---#-------------###--#--#--##------#---##--
---------#--##-#--#--#-#--#---#--#-#---#---##--------#--#####--#-----#--------##-##-##----##-##-----
#--#-##---###---------#-#-#-#-------##-#--#--#----#-#-----#-----#--##-----#---#------#-----#-----##-
####---#-##-##---#----#-#-#----##-#---#-##--------#--------##--#-----#----#--------##----#-#------#-
-#------##--#-#---#---#-#--------##------#--###---#---###-----------##-------#----#--#-#-#-----#--#-
-------#--###-##-#-#----#---#-#------#-#-#-##-----###--##--#----##--#----#---####---------#-#-#---#-
---#--#----------#-##-#--------#------####-#---------------#--#---#--#---##-------###-##-----#----##
---#-#---#--#------#---##-#-#--##-------#--##-##-#---#---#---#----##-##--#------------#-------#-#-#-
---#--#-##--#-----------#----##-----------#-----##-#####--###---#-#----#-#---####-#-#----#---#-#-#--
--###------#-#------#-#--##-----##-------#-##---#----#-#####-#-#-------#---###----###-------#-####--
----##-##--##----#------#-##-------#--#---#--#--#---------##----#------#--#--------#---------#-#-#--
###---##--------------#-#-------#--##-##--#----#--#----#----#---#---#---#----#------##-##-----######
#-#-#----#----##----#--------------######-##-#--#-#--##---#-#-###--------#####-##-##---#-----#------
---#-##-##---#----#-#--#-#-#-##---#--#-----###--#--#----#---#---#------#-----------###--##----#----#
##-#-##--#--------#---#-----#-----##--#-##-#--------#--#---#-------#-###-###-##----#----#------##---
--#----#-#--#--#-#--#-#---##--###--#--#---#--------------###-####-#-###---#--##----#----#-#-#--#----
-----#--#-----#--#---#---#----#---##-#---------#-#-##---#--#--------#-----#--#-##-###----------#----
-##--#---##----#----#------------###--###--#--#--#--#----#-#---#-#-#-#----------##--------##--#----#
-##----#-----------##-#--#-#---#------------#----###-----#---#-#---#--##--#--#--#---#-#--##--#-#----
-------#-#-----#----#-##----#-#-#-#--#-#--#---#--------#--##----#--#---#-#---#-------#---##-#-#-#--#
---#-#---###----------#---------#--#--#---#---###-#------###--#---#------------#-###-#-#-#------#-#-
--##---#---#----##-##-###---#-###---#-#-----#-#-##----##-#---------#-----------#---#---#---##-------
-----##----#-####--#--#--#--###-#----------#----#-#--##-----#-#--##----------#----##--------##---#--
--#---#-#-#--#------##------#---#--#----#----#----##--#-##---E--##---#--#-##-##-#---##--##-----#-#--
--#-#---#----------###--#------------#-#---#-#--#----#-----#-----#--#--#---###------###---#-#----###
-----#---#-----------#-----#---##-#-#-----------#---------------#-#-#--------#--#--#-##--#-##---#-#-
#----#-----------##-#-#--#---#--##---#-##-#--#---#---#--#----####-###-##--#----#--#####-#-#--------#
##----#-------#--#-#--#---------##-###--#---#--#--------##-#--#-##-----#-#--#---#-####--#-----#----#
##--#----#------#------#-#-#-#------##--#------------###--#----#--####--##--###-##-##-#------#-----#
----#---###----#---##----###----------##---#-#-#-#-##-#----------###------##-----#---#-#-##--#-##---
------##-#---#---#--#---#--------#-##-#---#-#-#-----#--#-----#-#-##----##--#---#-----#-#------##----
#-----#---#----#------##------#-#---#-----------#-#-#----##-###---------#----#-#-#-----------#--####
--#--#-#--#-----#----#----------#----##-----------------#-----##-#----#--#-##-#--#----#---#-#-----#-
--#------#-----#--#----#-----#---##-----#--------#-----##--##--------#--##-------#-#----#-----#-----
##-###-----#----------------##------#--#-----#----------#####-##--#-####-#-----##-#-------###---#--#
---#--##---#-##-#-#-------#---#------##--#--------#-------###-#-----------###-###----#----#------##-
#-------#-##---#--##-#-------##------#----#----#----###--#-#----#-#-#--#---##---#----##-#-#--#------
--##-####-------##-#---##---###------##--#--#----------#----#-#--##-----#-#----##-#-#-#-#----#---###
-#-----##-#-#-#----##----#----#---##-------#------#--#-##---#--#-#--##-#-------#-#--##--#-#-----#---
-##------------##--##---------#-#--------#-####-###-##-----#-##---#--#-#-###---#-###------#-#-#-----
-##--#--------#-#-#-#----#-#-##-#-#------#-----##--#-#----#--###-#----#-#---#------##-##--#---#-----
-###------#-##------##----#-#-----##-----#--###---#----#-##----#-#---#-#-##--#--#--###----#-###-----
#--#-#---#-##--##-#------#---##--#-#-#-#--#-##------##-##---##-------#-#---#-###-##---##----------#-
----##-#-------##-#---------#----##-#------#----#-#------#-##-###--##-##-#-------##-#-#-##--#-##-#--
-------##-----#--#---#-#---#-#-#--#---#-###-------#----------#--##---------####--######----#----#---
------#----#--#---#-#----#----#-------#---------###---###-#--#-#-#--#----#-------#---#--#-#------#--
---#--#------#---#-#-##-#-##-----#--#-----#-----##---#------#-#-----#-#-----#--#---#-----###---#----
-##-#-----#-----#-#---#-----------#-----#---#------##-##---#--##------###-##------#-----#------###-#
##----#-##----#####-##-----#-------#-------------#-#-#-#---#-#---#-#-#---------#--#-#--##--#-----#--
-#----#----#-###-----#-#----------##-#-#-#----#-------#---#------------#---#--#-#--###-#--#--##---##
---#---#--#-------#-###---------#--#--#---#--#-##----###----------#--#---#-------#---#-###-###-#----
--#----##-##--#--##--#----#--------#-###--#------###----#----#--#---#-####-##-------#----#--##----#-
------------#----#----#-----#-#-##-#--------###----#---##--#-#---#-##-##-----------------##-#--##-#-
#----#-#-#-##--###--#-#---#--##----------------##-#---#---#-#--##--##----#-----##---#-#--#-----##---
----------#----#----#------------#---#---------#-------###----#-------##--#-##-------#----#-#-##--#-
------##--#-------##---#-#--#-------#-####--##-#--#-----#--------#------##-#-#--#-##---##--####-#---
--#--###------#--#---------#--------##--#------#-#--#-#--##-#-#-#---#----#-#--#------#--####------#-
##---------##--#-----#----##--##--------#----####-----##-#--##------#------##--#-#----##--#---------
---##----#--#----#--#-----###----##--#-----#---#-----#--##-----##-#--#------#-#-#------###---#------