--#--#---#-#-------#------#---#--------####--------#-----#------#-###-#----------#--#---#---##-##-#-
---#----##-#-----##-----#--#---------#--#-#-#---#-#----##---##----------#----------#-#---#--#---#---
-#-##-#--#-#----#------#---------##----------#---#-##----##-#--#--#--#--##-#----###-#--#--##--#----#
#-----#--##-#-##-----#----#--#-------#------------#--#-#--#--#--#-#--#-##---#-##-#---#---#---#------
-----#-#-----###-#-------##--#-----###--#--#---------#--##--###-###---#--#--#-#-#--#-----#-#-#-#--#-
-####-#-----#-----##--#--#----------###---#-#---------#-------##-------#------#---##-#---#-####---#-
-----#-##-#------#--#--#-------#-------#-----##----###----#---#-----##--#-----#-----#-#---#--##--##-
#---#-##------##------------------##---#--------#-----#---#--#------------#-##-----##--------##----#
--#---#--###-##-------#--##----##---####-----###---#----------------------#------------##--#------##
---#--###-----###----###-#-#-##-----##--#--##---##---#---####-#-#-------##-#----#--#-#-#----##--#---
#-##--###---#----#--------#-#---#-#----#----#--##---#-#--------#----#--#--#-#---#-#-#--#------#-#--#
--#-----#-#-#-----#--------#-#----##------##---#---#-#---#---#-#-#-#-#--##----###------##----##---#-
-#-----#-##--#---###---###-----##----------#---#--#-#--#-----#-#-#--##--#--#---------#-#---###-----#
--#--#--#--#-#-#----###----#----###-#-------#---#-#---#------#-#--------------##-----#----#--#--##--
----#----#-#-###--#--#-##----#-##---##-####----------#------#---##----#-----#--#---#-----#--#-#--##-
#---##-------------------#----#-##--###----------#-#----#-#-#---#-----##------#--##------##----##---
-#-###---#--#------#--#--#-----#--#---#-###-#-#---##----#-#--#-#----------------#--#-----#-----#-#--
#--#-----#-#------------#-#-----#--#--#-----------#---------#-###--##-------#---##-#--#------#####--
---#-----#------###---#-----##-##---#-###-#----#-#-#------#--#-------#-###-----#-----#--#--#--------
#-#-#----#-####--------#---#-#-##-#---##---#--------##-#---#--#--#-----#--#-#-#-#----#-#-----#--#--#
------###-----##-#-------#---#-------#-#-###--#---##-----#--#--#-#---------#---------##---##---#----
-#----#-----#-#--#----#---#-#------#----##-##------##---#-#--#-###--#--------##-#-------##--##------
--##------##-#-----##----#-----##-#-#------#--##----#------##--##---#---##---#--------------#----#--
##-------------------###-----#-----#-##------#-------###--#--#---##-----#----#---#----#-#-------#---
--#-#--#--####-----#---#-#-#-#----##--##---#-----------#--#--####-----###---##----##--#-#-#-#---##--
-##----##------#-------##--#---------###-#----#---#-----#--#---#---#-#---#-------------#-#-##----#--
-#-##--#-#-#--#---#----#-----#-#-#---#------#--#---###--#---##--###---##----#####--#---#-#--###-#-#-
---#----##-#----###-####-------#---#---#-###------------#----#----#---#--#-----##-#-#----------##---
#-#-------#-####----#---####---------#---##-##--##-------##-#-##-#-#------##------#-###--#---##-#-#-
--------#-#-#-------#-#------#--------#--#-#--------#-##--##----#--#---------#-#--#-##-#-#----------
##-#----#-----#--#-#--#------##--#---#-----#----#-#------#---#-##---#-#####---#-#---#--#-#----#--##-
#---#----#-#--------###-#-------#---#--#------#----#--#---##-#-#---#--#-###---------##-#-#--#---#---
---##-##---##----#-#------##------#----##--#----#-#-#-#-#----##-#-#------#----#-#-####-##--------#--
------#---------#-#---#-#--#--------##-#-#----#-##--#-##----#-------##--#-#-####---##-----##-###----
####-------#-#--#--#-----#---#----#-------------##-#-#----#-#------##--###---##-----#-----###-#-#--#
---#--------##-----#-#-------###-###--##---#---#-###-----##-------##-##--#---#--#-#----#---#-----###
---#--#--#-#-#--#--#-##-#--#-#---#-#-##-#-###---#--##-----#---#-----#-#--#---#--#--------#--#-------
--#-------##--#------#-##--#--#-----##-##-------#--#----#-#--#---##-##-#--#-##-#-#-#---##---##-#-#-#
------------###--#-#----#---#----#-------##------#--------#---##-----#--#------#---####----##---#-##
-------#------#--#----#------------##-##-#-#----#------###----#-#####----#-##----#-#-#-------#--#---
----#-#-###--#--##-#-##-----#--#-##------#---##-#-#------#-----##--#---#-#--#--##-#-#------#-#-###--
-#---###--#-#--###--#-#-----##---##-##----#-----#-#--#------#------##-#------###-##-#----------##---
------#-#-##-#---#--#--------#----##-----#-#--------#-------#--------#--#---#--##---#---------##--##
#---------#-----##----#---#------#----------#------#-#--#--#----###---#-#-----#---#------##--#-#--##
---#-#--##------#-#-------##--##--#--##-##----#-#-#-----##-###----#-------------#-#--#-##------#-#-#
###---##-###-----###-----#----##---#----#-##-#----#--#-####------#-----#---##----#--#-###-#---#-##-#
---#-#-#--#---#---#---#-#-------#-#-###----#-###-#------#--##-#-##----#-------#--##-#---#--------#--
---##--#----###--#-#-----#--##---#-#-#-#--##-#--#--#-#-------#--#------------#------#--#-----##-----
#-#-#-#---#--##-#-----##--#-#----#------#--#-#---#--##-#----####-###--#-#----#--#-#----#--#------###
--##--#-#----#--#-#------#--##-----#####----##--##------##----#----##----#-----###--#-----###--#----
#--#-#-#-#---##--#-#-#S-####--------###----##-#---#-#-#--#--##-#-----###-------------#--------------
#-#---#-----#-----#----##----##--##-##-###-##--#-###--##-----#--#---##--#---#--------##------#--#---
##-------#---#---#--#-----#-#---#---#-#----#---#----##-----------#----##-#--------##-#--#-#----#----
#----##-#--#--#------#------#---#------#----##-#--#-----#-#-----#-#-#-#-#----#---------####-#-#----#
-------#---#-#--#---#---#---#----#-----###--##---------#-#--#---##---#--###-#-#-#----------####---##
----#-###----###------------#-#--#-------#-##----#--#-#-#--#------##-#-----##----###--#-#---#---###-
-#------#-#--#-##------#--#-#--------#---------###-#-#-----#----##--#-#-##-#---#--#--#-#-##-#----#--
------#---#---#-#-##-----------##---#---#-#---#--#-##-#--#------#--#-#-##---#-#-----#--#-#---#--###-
###-#--#--#---#---##--#----##------##----##--#---#-#---##-#----#--#--#---##--###-------####-----##--
-####-#----##--#-------###-----#----##-#-----#---#----------#---#---#--------#----##------#-#--#----
-#--------------#--##-------#---##----##------#---#--------##--#-#-----#------#----#--#--------#----
--##------#--##---##---##-#-##-#---###-#-------##-#----#--#----#-#-----------#-----###-##-#--#--#--#
----#---##---####-#---------##--#-------#---------#------#--#-#-#--####-##-----##---#---##-##---###-
#----#--##-#--#---------#----------#------#---#--------#--#-----#--#---##---#------##-------#-------
-#-#-###-##--#------##--------##------###--#-----#----#-#-#-#---#--#---#-----#-#-#--#--#-#--#-#--#-#
---#-#----------#-------------####--#--#----#---##-----#---#--#------#-##--#-#---#---##--##-#-##--#-
--#--------#----###-#-#--#---#-#-#-------#-#------#-#---#-#----##--------#--#-##--#-----#---#--##--#
--#--#----###-----#-----###-#-#---###--#-#--##-####-####-#--#-------#-#----#---------#-##-##-#-#--#-
#-#-##-----##-#--#-#--#-----#-#####---#-------#----##----#-----##--#--#--#------#--#---#-##-----#--#
----#-------#-#------#-----#---#-#---##---##-###-----###--------#-------------------#-----#-#------#
--#----#----#--#---##--------##--##-#---##-#-------#----#---#-----####--------###-----#--#-#--##-#--
-----------#-----#--#----#----##--#-#-#---#---------#-#-----#---##--#--#--#-#--#--#-----------------
---####---#-###----#-#-#--#---#-#----------#-##-#--##-#-#------#--#-----##---#--#-##-#--#--#---##--#
#-------###-----#----------#-#---#--#--------#----#---#---##----##--##-----#--#-#--##---##--#-----#-
##---##--##-#---#------#-----#---#--#-#-#----#---#-------#####-#---#------#--##-##--#--##-------#--#
---#-#-####--##-#------###----------#-#--#---##---------#---##-##-#--##-#-#-#---##-#-###-#--###--##-
--#----#---#---#----#-------##--##---##-#-#--##----#-----#-----#-#------------##--##-----##-----##--
#-##------#---------##--##-#--#--##---#--#-#---#--------#-----#----#-------#----------#-#----#-----#
##-#---#-----##--#-#--##-##---#-------##----#-#---###--##-####--##---#-----#-----#--#----------#----
###--#-#-----------#------##-----##-#----#-----##-##--#-#----#----#-#--#--------####-##----##-#-##-#
-------#--#----#--#----#----#------#--#---#--##-#----#-#-------#-#--#-#-##--#-##-##-#-#-#---------##
##-#----##---#-#--------###--#---#--#-----#--#----#--###-####------#----#--#--##-#------##--#--#----
-#--#--#-#----#--#-#----###-#-##-#-#---#-#-###------------##---#--#--##--#--#----#----------------##
---#----#----##----##---#---#-#-#---------#----------###---#-----##-#------#--#-###----#-#---------#
----#-#----#--#-#-#----#--#-----###-#-#-##---#-##-#----#-------#--------##-------##----#---#-###-#-#
#-#--#----#-------------------##-----##---#---#-#-------####-------######--------#--#-#-------#-#---
-###-#-#-#####--#-------#-#--------#-------##-##-#--###------#---#--#---#--#-----#--##--##-#-#-#----
-----##-----------------#--------#-#-#-#----##--#--#--##----##---#-#--##---##-------#-#-#--------##-
-#---E#---------------#-----------##---#-----#-#-#----------#------###---#---#-----#---#-#------#---
--#--------##--#---#---##---##-#--#-#-##---------#--#----#-#---##---#----#----#--------#----##--#---
----##-##----#--#-----------#--#---##--###-#-##-####----##--###-----###-#---#-------###-#-##--#-----
--###-#-#---#-#-#-#-------##-##---------####---####----#-#--#-#----#-----##--#------##-----#----#---
----###----##---#----#--------###----##--#----#--#-----------##--##---##---##-#------------#---###-#
#--#------#-------#--#-#----#---#--------#--#--------##--#-----#--#-#---#-------##--#-#----#--#----#
--#-#----#--#--#-#-###-----#-------##----#---#----------#-----#---#--#----#----#------#-###----#--#-
---####-#--#-------#-#-##---#--#--------#---#-##-------#-##----#-#-##---------#-#----##-##--#-------
--###-#-#----#--##---##--#-#-#---##-#--#----####-#-##------##--###--#-----#---#-#----#------##---#--
-##-##---#----#---#-##-----#-#---#-#-#------#----##-#-#------------##---#####-####------#---#--#---#
-----#-----#--#-#-#--#####-#--###---###-#-###--------#-##----#------#--##--##----#----#--#-#---##---
-#--###---#-#----------#---##-#-##----------#----#--#---#--#----------#----------#--##----#--###-#-#