------------------------------
-#--#-#--#-#--#-#--#-#--#-#--#
#----#----#----#----#----#----
#--#-#--#-#--#-#--#-#--#-#--#-
#-#--#-#--#-#--#-#--#-#--#-#--
------------------------------
-#--#-#--#-#--#-#--#-#--#-#--#
#----#----#----#----#----#----
#--#-#--#-#--#-#--#-#--#-#--#-
#-#--#-#--#-#--#-#--#-#--#-#--
------E-----------------------
-#--#-#--#-#--#-#--#-#--#-#--#
#----#----#----#----#----#----
#--#-#--#-#--#-#--#-#--#-#--#-
#-#--#-#--#-#--#-#--#-#--#-#--
------------------------------
-#--#-#--#-#--#-#--#-#--#-#--#
#----#----#----#----#----#----
#--#-#--#-#--#-#--#-#--#-#--#-
#-#--#-#--#-#--#-#--#-#--#-#--
------------------------------
-#--#-#--#-#--#-#--#-#--#-#--#
#----#----#----#----#----#----
#--#-#--#-#--#-#--#-#--#-#--#-
#-#--#-#--#-#--#-#--#-#--#-#--
------------------------------
-#--#-#--#-#--#-#--#-#--#-#--#
#----#----#----#--S-#----#----
#--#-#--#-#--#-#--#-#--#-#--#-
#-#--#-#--#-#--#-#--#-#--#-#--