##--###--###--###--###--###--###--###--###--###--###--###--###--###--###--###--###--###--###--###--#
----------------------------------------------------------------------------------------------------
----------------------------------------------------------------------------------------------------
----#----#----#----#----#----#----#----#----#----#----#----#----#----#----#----#----#----#----#----#
##---##---##---##---##---##---##---##---##---##---##---##---##---##---##---##---##---##---##---##---
##--###--###--###--###--###--###--###--###--###--###--###--###--###--###--###--###--###--###--###--#
----------------------------------------------------------------------------------------------------
----------------------------------------------------------------------------------------------------
----#----#----#----#----#----#----#----#----#----#----#----#----#----#----#----#----#----#----#----#
##---##---##---##---##---##---##---##---##---##---##---##---##---##---##---##---##---##---##---##---
##--###--###--###--###--###--###--###--###--###--###--###--###--###--###--###--###--###--###--###--#
----------------------------------------------------------------------------------------------------
----------------------------------------------------------------------------------------------------
----#----#----#----#----#----#----#----#----#----#----#----#----#----#----#----#----#----#----#----#
##---##---##---##---##---##---##---##---##---##---##---##---##---##---##---##---##---##---##---##---
##--###--###--###--###--###--###--###--###--###--###--###--###--###--###--###--###--###--###--###--#
----------------------------------------------------------------------------------------------------
----------------------------------------------------------------------------------------------------
----#----#----#----#----#----#----#----#----#----#----#----#----#----#----#----#----#----#----#----#
##---##---##---##---##---##---##---##---##---##---##---##---##---##---##---##---##---##---##---##---
##--###--###--###--###--###--###--###--###--###--###--###--###--###--###--###--###--###--###--###--#
----------------------------------------------------------------------------------------------------
----------------------------------------------------------------------------------------------------
----#----#----#----#----#----#----#----#----#----#----#----#----#----#----#----#----#----#----#----#
##---##---##---##---##---##---##---##---##---##---##---##---##---##---##---##---##---##---##---##---
##--###--###--###--###--###--###--###--###--###--###--###--###--###--###--###--###--###--###--###--#
----------------------------------------------------------------------------------------------------
----------------------------------------------------------------------------------------------------
----#----#----#----#----#----#----#----#----#----#----#----#----#----#----#----#----#----#----#----#
##---##---##---##---##---##---##---##---##---##---##---##---##---##---##---##---##---##---##---##---
##--###--###--###--###--###--###--###--###--###--###--###--###--###--###--###--###--###--###--###--#
----------------------------------------------------------------------------------------------------
----------------------------------------------------------------------------------------------------
----#----#----#----#----#----#----#----#----#----#----#----#----#----#----#----#----#----#----#----#
##---##---##---##---##---##---##---##---##---##---##---##---##---##---##---##---##---##---##---##---
##--###--###--###--###--###--###--###--###--###--###--###--###--###--###--###--###--###--###--###--#
----------------------------------------------------------------------------------------------------
----------------------------------------------------------------------------------------------------
----#----#----#----#----#----#----#----#----#----#----#----#----#----#----#----#----#----#----#----#
##---##---##---##---##---##---##---##---##---##---##---##---##---##---##---##---##---##---##---##---
##--###--###--###--###--###--###--###--###--###--###--###--###--###--###--###--###--###--###--###--#
----------------------------------------------------------------------------------------------------
----------------------------------------------------------------------------------------------------
----#----#----#----#----#----#----#----#----#----#----#----#----#----#----#----#----#----#----#----#
##---##---##---##---##---##---##---##---##---##---##---##---##---##---##---##---##---##---##---##---
##--###--###--###--###--###--###--###--###--###--###--###--###--###--###--###--###--###--###--###--#
----------------------------------------------------------------------------------------------------
----------------------------------------------------------------------------------------------------
----#----#----#----#----#----#----#----#----#----#----#----#----#----#----#----#----#----#----#----#
##---##---##---##---##---##---##---##---##---##---##---##---##---##---##---##---##---##---##---##---
##--###--###--###--###--###--###--###--###--###--###--###--###--###--###--###--###--###--###--###--#
----------------------------------------------------------------------------------------------------
----------------------------------------------------------------------------------------------------
----#----#----#----#----#----#----#----#----#----#----#----#----#----#----#----#----#----#----#----#
##---##---##---##---##---##---##---##---##---##---##---##---##---##---##---##---##---##---##---##---
##--###--###--###--###--###--###--###--###--###--###--###--###--###--###--###--###--###--###--###--#
----------------------------------------------------------------------------------------------------
----------------------------------------------------------------------------------------------------
----#----#----#----#----#----#----#----#----#----#----#----#----#----#----#----#----#----#----#----#
##---##---##---##---##---##---##---##---##---##---##---##---##---##---##---##---##---##---##---##---
##--###--###--###--###--###--###--###--###--###--###--###--###--###--###--###--###--###--###--###--#
----------------------------------------------------------------------------------------------------
----------------------------------------------------------------------------------------------------
----#----#----#----#----#----#----#----#----#----#----#----#----#----#----#----#----#----#----#----#
##---##---##---##---##---##---##---##---##---##---##---##---##---##---##---##---##---##---##---##---
##--###--###--###--###--###--###--###--###--###--###--###--###--###--###--###--###--###--###--###--#
----------------------------------------------------------------------------------------------------
----------------------------------------------------------------------------------------------------
----#----#----#----#----#----#----#----#----#----#----#----#----#----#----#----#----#----#----#----#
##---##---##---##---##---##---##---##---##---##---##---##---##---##---##---##---##---##---##---##---
##--###--###--###--###--###--###--###--###--###--###--###--###--###--###--###--###--###--###--###--#
----------------------------------------------------------------------------------------------------
----------------------------------------------------------------------------------------------------
----#----#----#----#----#----#----#----#----#----#----#----#----#----#----#----#----#----#----#----#
##---##---##---##---##---##---##---##---##---##---##---##---##---##---##---##---##---##---##---##---
##--###--###--###--###--###--###--###--###--###--###--###--###--###--###--###--###--###--###--###--#
----------------------------------------------------------------------------------------------------
---S------------------------------------------------------------------------------------------------
----#----#----#----#----#----#----#----#----#----#----#----#----#----#----#----#----#----#----#----#
##---##---##---##---##---##---##---##---##---##---##---##---##---##---##---##---##---##---##---##---
##--###--###--###--###--###--###--###--###--###--###--###--###--###--###--###--###--###--###--###--#
----------------------------------------------------------------------------------------------------
----------------------------------------------------------------------------------------------------
----#----#----#----#----#----#----#----#----#----#----#----#----#----#----#----#----#----#----#----#
##---##---##---##---##---##---##---##---##---##---##---##---##---##---##---##---##---##---##---##---
##--###--###--###--###--###--###--###--###--###--###--###--###--###--###--###--###--###--###--###--#
----------------------------------------------------------------------------------------------------
----------------------------------------------------------------------------------------------------
----#----#----#----#----#----#----#----#----#----#----#----#----#----#----#----#----#----#----#----#
##---##---##---##---##---##---##---##---##---##---##---##---##---##---##---##---##---##---##---##---
##--###--###--###--###--###--###--###--###--###--###--###--###--###--###--###--###--###--###--###--#
----------------------------------------------------------------------------------------------------
----------------------------------------------------------------------------------------------------
----#----#----#----#----#----#----#----#----#----#----#----#----#----#----#----#----#----#----#----#
##---##---##---##---##---##---##---##---##---##---##---##---##---##---##---##---##---##---##---##---
##--###--###--###--###--###--###--###--###--###--###--###--###--###--###--###--###--###--###--###--#
----------------------------------------------------------------------------------------------------
----------------------------------------E-----------------------------------------------------------
----#----#----#----#----#----#----#----#----#----#----#----#----#----#----#----#----#----#----#----#
##---##---##---##---##---##---##---##---##---##---##---##---##---##---##---##---##---##---##---##---