-#----#----#----#----#----#----#----#----#----#----#----#----#----#----#----#----#----#----#----#---
---##---##---##---##---##---##---##---##---##---##---##---##---##---##---##---##---##---##---##---##
----------------------------------------------------------------------------------------------------
##--###--###--###--###--###--###--###--###--###--###--###--###--###--###--###--###--###--###--###--#
---#----#----#----#----#----#----#----#----#----#----#----#----#----#----#----#----#----#----#----#-
-#----#----#----#----#----#----#----#----#----#----#----#----#----#----#----#----#----#----#----#---
---##---##---##---##---##---##---##---##---##---##---##---##---##---##---##---##---##---##---##---##
----------------------------------------------------------------------------------------------------
##--###--###--###--###--###--###--###--###--###--###--###--###--###--###--###--###--###--###--###--#
---#----#----#----#----#----#----#----#----#----#----#----#----#----#----#----#----#----#----#----#-
-#----#----#----#----#----#----#----#----#----#----#----#----#----#----#----#----#----#----#----#---
---##---##---##---##---##---##---##---##---##---##---##---##---##---##---##---##---##---##---##---##
----------------------------------------------------------------------------------------------------
##--###--###--###--###--###--###--###--###--###--###--###--###--###--###--###--###--###--###--###--#
---#----#----#----#----#----#----#----#----#----#----#----#----#----#----#----#----#----#----#----#-
-#----#----#----#----#----#----#----#----#----#----#----#----#----#----#----#----#----#----#----#---
---##---##---##---##---##---##---##---##---##---##---##---##---##---##---##---##---##---##---##---##
----------------------------------------------------------------------------------------------------
##--###--###--###--###--###--###--###--###--###--###--###--###--###--###--###--###--###--###--###--#
---#----#----#----#----#----#----#----#----#----#----#----#----#----#----#----#----#----#----#----#-
-#----#----#----#----#----#----#----#----#----#----#----#----#----#----#----#----#----#----#----#---
---##---##---##---##---##---##---##---##---##---##---##---##---##---##---##---##---##---##---##---##
----------------------------------------------------------------------------------------------------
##--###--###--###--###--###--###--###--###--###--###--###--###--###--###--###--###--###--###--###--#
---#----#----#----#----#----#----#----#----#----#----#----#----#----#----#----#----#----#----#----#-
-#----#----#----#----#----#----#----#----#----#----#----#----#----#----#----#----#----#----#----#---
---##---##---##---##---##---##---##---##---##---##---##---##---##---##---##---##---##S--##---##---##
----------------------------------------------------------------------------------------------------
##--###--###--###--###--###--###--###--###--###--###--###--###--###--###--###--###--###--###--###--#
---#----#----#----#----#----#----#----#----#----#----#----#----#----#----#----#----#----#----#----#-
-#----#----#----#----#----#----#----#----#----#----#----#----#----#----#----#----#----#----#----#---
---##---##---##---##---##---##---##---##---##---##---##---##---##---##---##---##---##---##---##---##
----------------------------------------------------------------------------------------------------
##--###--###--###--###--###--###--###--###--###--###--###--###--###--###--###--###--###--###--###--#
---#----#----#----#----#----#----#----#----#----#----#----#----#----#----#----#----#----#----#----#-
-#----#----#----#----#----#----#----#----#----#----#----#----#----#----#----#----#----#----#----#---
---##---##---##---##---##---##---##---##---##---##---##---##---##---##---##---##---##---##---##---##
----------------------------------------------------------------------------------------------------
##--###--###--###--###--###--###--###--###--###--###--###--###--###--###--###--###--###--###--###--#
---#----#----#----#----#----#----#----#----#----#----#----#----#----#----#----#----#----#----#----#-
-#----#----#----#----#----#----#----#----#----#----#----#----#----#----#----#----#----#----#----#---
---##---##---##---##---##---##---##---##---##---##---##---##---##---##---##---##---##---##---##---##
----------------------------------------------------------------------------------------------------
##--###--###--###--###--###--###--###--###--###--###--###--###--###--###--###--###--###--###--###--#
---#----#----#----#----#----#----#----#----#----#----#----#----#----#----#----#----#----#----#----#-
-#----#----#----#----#----#----#----#----#----#----#----#----#----#----#----#----#----#----#----#---
---##---##---##---##---##---##---##---##---##---##---##---##---##---##---##-E-##---##---##---##---##
----------------------------------------------------------------------------------------------------
##--###--###--###--###--###--###--###--###--###--###--###--###--###--###--###--###--###--###--###--#
---#----#----#----#----#----#----#----#----#----#----#----#----#----#----#----#----#----#----#----#-
-#----#----#----#----#----#----#----#----#----#----#----#----#----#----#----#----#----#----#----#---
---##---##---##---##---##---##---##---##---##---##---##---##---##---##---##---##---##---##---##---##
----------------------------------------------------------------------------------------------------
##--###--###--###--###--###--###--###--###--###--###--###--###--###--###--###--###--###--###--###--#
---#----#----#----#----#----#----#----#----#----#----#----#----#----#----#----#----#----#----#----#-
-#----#----#----#----#----#----#----#----#----#----#----#----#----#----#----#----#----#----#----#---
---##---##---##---##---##---##---##---##---##---##---##---##---##---##---##---##---##---##---##---##
----------------------------------------------------------------------------------------------------
##--###--###--###--###--###--###--###--###--###--###--###--###--###--###--###--###--###--###--###--#
---#----#----#----#----#----#----#----#----#----#----#----#----#----#----#----#----#----#----#----#-
-#----#----#----#----#----#----#----#----#----#----#----#----#----#----#----#----#----#----#----#---
---##---##---##---##---##---##---##---##---##---##---##---##---##---##---##---##---##---##---##---##
----------------------------------------------------------------------------------------------------
##--###--###--###--###--###--###--###--###--###--###--###--###--###--###--###--###--###--###--###--#
---#----#----#----#----#----#----#----#----#----#----#----#----#----#----#----#----#----#----#----#-
-#----#----#----#----#----#----#----#----#----#----#----#----#----#----#----#----#----#----#----#---
---##---##---##---##---##---##---##---##---##---##---##---##---##---##---##---##---##---##---##---##
----------------------------------------------------------------------------------------------------
##--###--###--###--###--###--###--###--###--###--###--###--###--###--###--###--###--###--###--###--#
---#----#----#----#----#----#----#----#----#----#----#----#----#----#----#----#----#----#----#----#-
-#----#----#----#----#----#----#----#----#----#----#----#----#----#----#----#----#----#----#----#---
---##---##---##---##---##---##---##---##---##---##---##---##---##---##---##---##---##---##---##---##
----------------------------------------------------------------------------------------------------
##--###--###--###--###--###--###--###--###--###--###--###--###--###--###--###--###--###--###--###--#
---#----#----#----#----#----#----#----#----#----#----#----#----#----#----#----#----#----#----#----#-
-#----#----#----#----#----#----#----#----#----#----#----#----#----#----#----#----#----#----#----#---
---##---##---##---##---##---##---##---##---##---##---##---##---##---##---##---##---##---##---##---##
----------------------------------------------------------------------------------------------------
##--###--###--###--###--###--###--###--###--###--###--###--###--###--###--###--###--###--###--###--#
---#----#----#----#----#----#----#----#----#----#----#----#----#----#----#----#----#----#----#----#-
-#----#----#----#----#----#----#----#----#----#----#----#----#----#----#----#----#----#----#----#---
---##---##---##---##---##---##---##---##---##---##---##---##---##---##---##---##---##---##---##---##
----------------------------------------------------------------------------------------------------
##--###--###--###--###--###--###--###--###--###--###--###--###--###--###--###--###--###--###--###--#
---#----#----#----#----#----#----#----#----#----#----#----#----#----#----#----#----#----#----#----#-
-#----#----#----#----#----#----#----#----#----#----#----#----#----#----#----#----#----#----#----#---
---##---##---##---##---##---##---##---##---##---##---##---##---##---##---##---##---##---##---##---##
----------------------------------------------------------------------------------------------------
##--###--###--###--###--###--###--###--###--###--###--###--###--###--###--###--###--###--###--###--#
---#----#----#----#----#----#----#----#----#----#----#----#----#----#----#----#----#----#----#----#-
-#----#----#----#----#----#----#----#----#----#----#----#----#----#----#----#----#----#----#----#---
---##---##---##---##---##---##---##---##---##---##---##---##---##---##---##---##---##---##---##---##
----------------------------------------------------------------------------------------------------
##--###--###--###--###--###--###--###--###--###--###--###--###--###--###--###--###--###--###--###--#
---#----#----#----#----#----#----#----#----#----#----#----#----#----#----#----#----#----#----#----#-
-#----#----#----#----#----#----#----#----#----#----#----#----#----#----#----#----#----#----#----#---
---##---##---##---##---##---##---##---##---##---##---##---##---##---##---##---##---##---##---##---##
----------------------------------------------------------------------------------------------------
##--###--###--###--###--###--###--###--###--###--###--###--###--###--###--###--###--###--###--###--#
---#----#----#----#----#----#----#----#----#----#----#----#----#----#----#----#----#----#----#----#-