---##---##---##---##---##---##---##---##---##---##---##---##---##---##---##---##---##---##---##---##
----------------------------------------------------------------------------------------------------
-#----#----#----#----#----#----#----#----#----#----#----#----#----#----#----#----#----#----#----#---
#---##---##---##---##---##---##---##---##---##---##---##---##---##---##---##---##---##---##---##---#
--#----#----#----#----#----#----#----#----#----#----#----#----#----#----#----#----#----#----#----#--
---##---##---##---##---##---##---##---##---##---##---##---##---##---##---##---##---##---##---##---##
----------------------------------------------------------------------------------------------------
-#----#----#----#----#----#----#----#----#----#----#----#----#----#----#----#----#----#----#----#---
#---##---##---##---##---##---##---##---##---##---##---##---##---##---##---##---##---##---##---##---#
--#----#----#----#----#----#----#----#----#----#----#----#----#----#----#----#----#----#----#----#--
---##---##---##---##---##---##---##---##---##---##---##---##---##---##---##---##---##---##---##---##
----------------------------------------------------------------------------------------------------
-#----#----#----#----#----#----#----#----#----#----#----#----#----#----#----#----#----#----#----#---
#---##---##---##---##---##---##---##---##---##---##---##---##---##---##---##---##---##---##---##---#
--#----#----#----#----#----#----#----#----#----#----#----#----#----#----#----#----#----#----#----#--
---##---##---##---##---##---##---##---##---##---##---##---##---##---##---##---##---##---##---##---##
----------------------------------------------------------------------------------------------------
-#----#----#----#----#----#----#----#----#----#----#----#----#----#----#----#----#----#----#----#---
#---##---##---##---##---##---##---##---##---##---##---##---##---##---##---##---##---##---##---##---#
--#----#----#----#----#----#----#----#----#----#----#----#----#----#----#----#----#----#----#----#--
---##---##---##---##---##---##---##---##---##---##---##---##---##---##---##---##---##---##---##---##
----------------------------------------------------------------------------------------------------
-#----#----#----#----#----#----#----#----#----#----#----#----#----#----#----#----#----#----#----#---
#---##---##---##---##---##---##---##---##---##---##---##---##---##---##---##---##---##---##---##---#
--#----#----#----#----#----#----#----#----#----#----#----#----#----#----#----#----#----#----#----#--
---##---##---##---##---##---##---##---##---##---##---##---##---##---##---##---##---##---##---##---##
-------E--------------------------------------------------------------------------------------------
-#----#----#----#----#----#----#----#----#----#----#----#----#----#----#----#----#----#----#----#---
#---##---##---##---##---##---##---##---##---##---##---##---##---##---##---##---##---##---##---##---#
--#----#----#----#----#----#----#----#----#----#----#----#----#----#----#----#----#----#----#----#--
---##---##---##---##---##---##---##---##---##---##---##---##---##---##---##---##---##---##---##---##
----------------------------------------------------------------------------------------------------
-#----#----#----#----#----#----#----#----#----#----#----#----#----#----#----#----#----#----#----#---
#---##---##---##---##---##---##---##---##---##---##---##---##---##---##---##---##---##---##---##---#
--#----#----#----#----#----#----#----#----#----#----#----#----#----#----#----#----#----#----#----#--
---##---##---##---##---##---##---##---##---##---##---##---##---##---##---##---##---##---##---##---##
----------------------------------------------------------------------------------------------------
-#----#----#----#----#----#----#----#----#----#----#----#----#----#----#----#----#----#----#----#---
#---##---##---##---##---##---##---##---##---##---##---##---##---##---##---##---##---##---##---##---#
--#----#----#----#----#----#----#----#----#----#----#----#----#----#----#----#----#----#----#----#--
---##---##---##---##---##---##---##---##---##---##---##---##---##---##---##---##---##---##---##---##
----------------------------------------------------------------------------------------------------
-#----#----#----#----#----#----#----#----#----#----#----#----#----#----#----#----#----#----#----#---
#---##---##---##---##---##---##---##---##---##---##---##---##---##---##---##---##---##---##---##---#
--#----#----#----#----#----#----#----#----#----#----#----#----#----#----#----#----#----#----#----#--
---##---##---##---##---##---##---##---##---##---##---##---##---##---##---##---##---##---##---##---##
----------------------------------------------------------------------------------------------------
-#----#----#----#----#----#----#----#----#----#----#----#----#----#----#----#----#----#----#----#---
#---##---##---##---##---##---##---##---##---##---##---##---##---##---##---##---##---##---##---##---#
--#----#----#----#----#----#----#----#----#----#----#----#----#----#----#----#----#----#----#----#--
---##---##---##---##---##---##---##---##---##---##---##---##---##---##---##---##---##---##---##---##
----------------------------------------------------------------------------------------------------
-#----#----#----#----#----#----#----#----#----#----#----#----#----#----#----#----#----#----#----#---
#---##---##---##---##---##---##---##---##---##---##---##---##---##---##---##---##---##---##---##---#
--#----#----#----#----#----#----#----#----#----#----#----#----#----#--S-#----#----#----#----#----#--
---##---##---##---##---##---##---##---##---##---##---##---##---##---##---##---##---##---##---##---##
----------------------------------------------------------------------------------------------------
-#----#----#----#----#----#----#----#----#----#----#----#----#----#----#----#----#----#----#----#---
#---##---##---##---##---##---##---##---##---##---##---##---##---##---##---##---##---##---##---##---#
--#----#----#----#----#----#----#----#----#----#----#----#----#----#----#----#----#----#----#----#--
---##---##---##---##---##---##---##---##---##---##---##---##---##---##---##---##---##---##---##---##
----------------------------------------------------------------------------------------------------
-#----#----#----#----#----#----#----#----#----#----#----#----#----#----#----#----#----#----#----#---
#---##---##---##---##---##---##---##---##---##---##---##---##---##---##---##---##---##---##---##---#
--#----#----#----#----#----#----#----#----#----#----#----#----#----#----#----#----#----#----#----#--
---##---##---##---##---##---##---##---##---##---##---##---##---##---##---##---##---##---##---##---##
----------------------------------------------------------------------------------------------------
-#----#----#----#----#----#----#----#----#----#----#----#----#----#----#----#----#----#----#----#---
#---##---##---##---##---##---##---##---##---##---##---##---##---##---##---##---##---##---##---##---#
--#----#----#----#----#----#----#----#----#----#----#----#----#----#----#----#----#----#----#----#--
---##---##---##---##---##---##---##---##---##---##---##---##---##---##---##---##---##---##---##---##
----------------------------------------------------------------------------------------------------
-#----#----#----#----#----#----#----#----#----#----#----#----#----#----#----#----#----#----#----#---
#---##---##---##---##---##---##---##---##---##---##---##---##---##---##---##---##---##---##---##---#
--#----#----#----#----#----#----#----#----#----#----#----#----#----#----#----#----#----#----#----#--
---##---##---##---##---##---##---##---##---##---##---##---##---##---##---##---##---##---##---##---##
----------------------------------------------------------------------------------------------------
-#----#----#----#----#----#----#----#----#----#----#----#----#----#----#----#----#----#----#----#---
#---##---##---##---##---##---##---##---##---##---##---##---##---##---##---##---##---##---##---##---#
--#----#----#----#----#----#----#----#----#----#----#----#----#----#----#----#----#----#----#----#--
---##---##---##---##---##---##---##---##---##---##---##---##---##---##---##---##---##---##---##---##
----------------------------------------------------------------------------------------------------
-#----#----#----#----#----#----#----#----#----#----#----#----#----#----#----#----#----#----#----#---
#---##---##---##---##---##---##---##---##---##---##---##---##---##---##---##---##---##---##---##---#
--#----#----#----#----#----#----#----#----#----#----#----#----#----#----#----#----#----#----#----#--
---##---##---##---##---##---##---##---##---##---##---##---##---##---##---##---##---##---##---##---##
----------------------------------------------------------------------------------------------------
-#----#----#----#----#----#----#----#----#----#----#----#----#----#----#----#----#----#----#----#---
#---##---##---##---##---##---##---##---##---##---##---##---##---##---##---##---##---##---##---##---#
--#----#----#----#----#----#----#----#----#----#----#----#----#----#----#----#----#----#----#----#--
---##---##---##---##---##---##---##---##---##---##---##---##---##---##---##---##---##---##---##---##
----------------------------------------------------------------------------------------------------
-#----#----#----#----#----#----#----#----#----#----#----#----#----#----#----#----#----#----#----#---
#---##---##---##---##---##---##---##---##---##---##---##---##---##---##---##---##---##---##---##---#
--#----#----#----#----#----#----#----#----#----#----#----#----#----#----#----#----#----#----#----#--
---##---##---##---##---##---##---##---##---##---##---##---##---##---##---##---##---##---##---##---##
----------------------------------------------------------------------------------------------------
-#----#----#----#----#----#----#----#----#----#----#----#----#----#----#----#----#----#----#----#---
#---##---##---##---##---##---##---##---##---##---##---##---##---##---##---##---##---##---##---##---#
--#----#----#----#----#----#----#----#----#----#----#----#----#----#----#----#----#----#----#----#--