-##----#---##--#---#-##--#-##-----#----##--#-#-##-------#----#--##--###-#--#-#---##-###---#---#----#
##-#----#---#--#---##-----#---#-###--##-#--##--#---------#-#----##----#--##-------##-#--#-#-#-#-----
##---##--#-#----#----------#----------------------#--##-##-##----#-###-#--#------#-#---#-----#-##--#
--###----#-#--#-##----###---##------#----#----##-#-####-#-#--#-#---###-##--#-------#--#---##-#--##-#
----##--#--#-----#---------###--###--#-----#--#------#-------##-#---#---##-#-------#--###-#---------
-----#--#-----#------##--#-----#---------#---#--#-#-----#----##-###-----------#--#-#-#----------#--#
-##-##---------#-#--------#-###----#--#--------##-----------#---##--#----##-----##---#----#----#-#--
##-#####-#-####-#----#------#---#-------##-#-#--#-#---#-------#-###--##--#-#----------#--#-----#-#--
#----##-#---#--#-##-#----#-#--#----#-##----------#------------#######----#--##-####-##------------#-
##---##-#-#------#-#-####----###--#----#-----#---#---##--#---#-#---#----#---#-##-#-#--#####----##---
#-----#---#----#----#------#--##-#--#---##-----#----#--##----###---##---##-----##--#----##-----#----
---#-#----#-#-----#--------##----#----#-#--###---#--#--#----#---#-#-#--##----###----#---###-#-#-----
--###-###-##---###--##----##-----#-###-----#--##--#---###-#---###---##--#----##---#--#-#-##-#--#----
#-------####-#-#------#----------###-#-------##-#--#---#---#---#-------#------------#-#-#-#--#-#----
-#-----###---#----#-##------##--#--#---#-----##-##---------##----#--#-#--------------#-----#--------
------###-----#--###-#--#-#-#-###----###-##---#-##-#---------#----##-##-----#----#-#---#-#---#----##
-####-----------##-----#------##------#-#-#--#-----###-#--#--##-###---###----#-#--#----#--#------#-#
#-#---#------#-#------------##--#-#-####-##---##-------#-##----##----------#-----#---#--------#---#-
--#-#-#---#------#------------##--#--#-#--#--#---#--#----#-#------#---####-###-------------#--#--#-#
---------###----#--#--#----#-#-#--#---#----##--------#--##----##-#-----#-----#---#---#-#-#----#--#-#
##-##---#--##------##--##-#-###--#-----#---E#---#-#--------#---#--#-------###-----#--##----#-#-###-#
#----------#-#-#--####----##-------##----#----#---#-#--#-##------##-#-#------#--#-##-#-#---#--#--#--
#-#--------#-#------#-#-----#--###------#-##---------##-#--#---##--#------#--#-#--#---#-#---#-#--#-#
##--##-----------##---#-----#-##--#---#-##---#------------#-#-#-#####--##--#----#--#---#------#-#-#-
-----#####-#--------#--#####-----#----#----##---#-----------#---#-#-##-----#----#----#-------#---#-#
#--#----#-#-----#--#--#-#---#--#-#--###--##-#-#------#-###-#----#--##-##-#-------#---##-#-#-#-#-#---
##-#---#-#-----#-#----##-#------#---#----####---#---##----##--###----#--#--##--##---##-#---##---#-#-
--#--#-----#----#--###---#-#-#------#-#-#--###--#--#---#-#---#-##-#--#--#-------##---#------#---#--#
#--#----#----#------###-------##---#---#---##-----##-#--#--###--###--#-----#-#-#--##-#-#----##-#--#-
------###-#-------#--####--#----#-#-------#----#--######------##--#--##----##----###--------#--#----
---#--#----##-------------#-#-#-##-#-----#--#----##---#-#-----#-----#---#----#---#--#----#----##--#-
--#-----##--##----#-----#--#------##----------##-----------#--#-#-#---------#--#-------#---#-------#
---#--#--#-#---#----#-------#-#------#---#--#-------##-#----##-----------#-#--#-###-----#-----#-#-#-
---#-#----#------#-------#-##----#-----##--#--###--###--------#---###--#--------#--#-#--#--#-#-###--
###----#-----#--#---------#-----####--#-#----#-#-#--#--#---------#--#-#-----------------#-#-#--##---
-#--##--#--##----#-#-##-#-#-------#-##-----##-#---#----#------#-###-#-----#--#------##-----#---#----
---####-#--#------##-----#-##-#-###-----#--#--#----#-##--#--####-#----###------#----------#---#--#--
#---------------##---######--#---#-##-----------#------#--------------------#----#-#--#---#-#--#----
#----#--------#---###-#---#-####--------#-#-####-#---##----##----##-#--#-----#-#--###---------------
-###-#---####----#---#------#---#---#---#-----###--#--#####------#---#-#-#-----#--------#---------#-
---------#-#--###---#----###----#----#----##----##--------###-#--#####-------#-----#-#----#-------#-
#-------#---#--#------#-#-##------#----######-#---##------##---#------#-##-###---#----#-#--#-###----
#--#----#--##----#--#-#-##-----###-#--#-#-#-###-----#--#--#------#---##----#-----#----##---#----#---
#---#-------#--#------##---#------------##---#---#-#------------##-#--------###--------#-#-#--##----
----#-#--#--#-----##-##--#----#-###-#------#-##--##---##-#-#-------#-----#--------#-----#--#--##----
------#-#-#-------#-###-----###----#-#-----#-#-##-#-#-##------##---#-#-#---##-#-----------------##-#
-##---#-#-#-------------##-----#---#---------#--#-#-----#--#-#-#---#--##------#----#-#-------#--#-#-
--------#-##--------#-#--#----####------#-#--#--#--##----#---#---#-###----#--#-#---#--##---#-#-#--#-
----##--------#-#---##---##---------#---##--###-----##-#--###--#-----#-#---#-#-###--#-------###--#-#
##-#--------#--------#--#---#--#----##--###-#-#---###-##--##-----------#####---#--#-#-------#-------
#------#-#--##-##-#-#--#-----#-----------##----##------#-----#--##--#-##------#-##----##---#-----##-
-----------#-------##---#-#-----##----#-##-##S------##-##---#--#---#----##------#---#-#----#-#---#-#
----#------------#--#---#-----##--------#-#-#---##-----------###---#-#--#---###------------#----#-#-
--#--##-##-###--#--###-#----###---#----#-##--#----#---##---#--####-#-###----##---#--#-----#-----#-##
-----#--#-#-----###---#---#--#--#-----##-------#--#----#-#---#--------#-------------##-----------#--
#--##----##----------#-------##---#-#-#-----------###-#--#-#-#--#---###---#------###-#-----##--##---
-------###--------###----#-#-#-#----#----##-#-------##-#---##-#-#-#---##--#-#--#-###------###----#--
#---##--#-#----#---#---#-##-#-----#--#-#----#-#--#--##-#--#-##--###---###-#-------#-#------#---#----
----#-#---##----#-#--#--#-#------#---------#---#-#-#---#-------#-----##--###------##----#------##---
--------#--#-----###---------#-####-#----#-#-------##------#---------##--##-----------#-#---##-##---
#--##--#--##------#--#-###-----#--------------#---------###------#---#--#---#----------#--#----#--#-
###--#---##-#-----##---##-##-------#----##-##-----------#---#--#-#-----##---#--##----##-#-#----##-#-
--#---#----##--#--------###-----------#---#-----#---##----#-#--------#--------###--##-####----#-#---
----#------#-#---------------#-----####---#--##---#-----#####----#-----##--#--#-#---#-#--#-#------##
--#----------#-##-##--##------##----##-----------#-##--#--##-----##-----#----------#-#---#-------#--
----------#-#-#---#---------#---#----#-##-###----#-##--#--#--------##-#-#---#---#-#---#-------#-##--
-----#-##-----#--#-#-#-----#----#----------#----##----#------#----#-##-####-#-----#---###--##--##-#-
#-#---#--#-#-#-#---#---#--#---###----#-#-##--#-----#------#--------##-##--#------#----#--#----------
-#----#-#####------###-#--#---###--#----#-----#-#---#----#-#--###-#--------#--##--#--#-#--#-----##-#
#---##--#####-#-#------#---##--#----##-----------#--------#-#---###-----#-#-##-##-#----#-#-#---#-#--
----#---#---#------#-##--#-----#------#----#-----#-#--#---#----#####---#---#-#--------#-###-----#-#-
--##-##-#-##----#-----#-#-##-#-#--#####----#--###---#---------##---##----##-------#-##-----#------##
----#------#---------#---#---##-#------#-#----##----#-#----#---##----#----#-----##-###------#----#--
--#-##---#-#-#-#---#---#--#----#--###-#--##--#---#--#--------##---##--#------#-----#--#-----------##
---#---#--##-#--#-#--#---#-#-#-#-##-##-##-#---#-#--#--#----#----#--#---------#-#----#-#---#----##--#
--##---#-#--------------#---#---##------##-------------#----##---#----#------------#--##--####------
#--------------------------##-#-----#-#----#---##-#-------##----#--###--#---#--#--##------#-###-#---
-##-#-#--#-#-------#--#-------##---#----#-#---------------#-#--#-##----#---#-#---##--#-#-#--#-#---#-
------#--#-#-----#--###-##---##-#-#-##--#----#----#-#--#-----#-#---#-#---#-##--#-#-------#---#----#-
--#------##--##------#-#---#-------#------#-#--------------###--#----###--#---##-##----------###-#--
--#--------#--#--------#---#-#-#-#-#--#--#-#------#---###-#--##--#-#--------##-###-----#--------##-#
-------------#----##----#-----#--#---------###-#-----#----##--#-#-##-#--------#---#-#----##----##-#-
--#-####-----#-###----##-#---##--#--###--#-------##---#----------#---#--#--------###---#--#-------##
#--##-#----#--#---##-#--##--#----------#--##-#-----#--#----##-----###-----#-#---------##----------#-
--#-#--#---##-##-#-##--------##-#--##--#-#--####-#---#-----##--##---#---###-#####-#------#-#--##----
----#-###-#-------#-#---#-----###-#-------#------#------#-#---------###--------#------#-#---#-#-----
---####-----##--#-----#-----#---#-###---#--#-#--##-#-#---#-------------#-#---#---#------#-#-#------#
----#--#--#-#---#--#---#-#-##-#--#-------#-----#-#---##---#-#----------------#-##--#-#--#--###-##---
#------#------#---##--#--#----#--#-------#-----#--#----#---###--#--#--#-#--#-###------#------#-#-#--
----##--#---###--#--#--#--#-----##-#--#----#-----#--#--##----#---#----#------##-##------##-#--------
#--###-#-#-#---------#-#-#-###------#---#------##-#-----#----#-#--------#----------#-----##-#-##---#
------#-#----#-#-------------#-#--#----#---#---#------##-##-##-#-#---###----------#----##-###-#-----
--#------------#-#-#----#-------#-#----------#------------#-##-#-----#------#--#----###--#----#-----
--#-----###---#---#-#-------#----------#-#----###-####-##-#----#-#-------##---##---------------##--#
#-#----#----#---#---------#----##-#--#--------#-##-###----###--#-##--#---#--------##-#----------#--#
#--#---#-#----#-###--##--#---##-#---#-#----#----#---###-#-####--##---#-----#--#--#--#--##-##---#####
-###-----#--####---#--#-----##-#--##-----#------#--#---#-##--##-##---###----#-----#-------#----#----
---#--##-#----#-#---#----#----------------------#-----------#####-#------#-----##---#----##--##-####
----##-##---#----##--#--#-------------#-#--##-##-----#-##-#-#----------#----#--#--------#----#-#-#--
-#----#---#-#--#-#-------------#-##--------#-#---#---#-#-#----#-#-----##--###-----#--#-##-----#-----