#----#----#----#----#----#----#----#----#----#----#----#----#----#----#----#----#----#----#----#----
-#----#----#----#----#----#----#----#----#----#----#----#----#----#----#----#----#----#----#----#---
-###--###--###--###--###--###--###--###--###--###--###--###--###--###--###--###--###--###--###--###-
----------------------------------------------------------------------------------------------------
#--#-#--#-#--#-#--#-#--#-#--#-#--#-#--#-#--#-#--#-#--#-#--#-#--#-#--#-#--#-#--#-#--#-#--#-#--#-#--#-
#----#----#----#----#----#----#----#----#----#----#----#----#----#----#----#----#----#----#----#----
-#----#----#----#----#----#----#----#----#----#----#----#----#----#----#----#----#----#----#----#---
-###--###--###--###--###--###--###--###--###--###--###--###--###--###--###--###--###--###--###--###-
----------------------------------------------------------------------------------------------------
#--#-#--#-#--#-#--#-#--#-#--#-#--#-#--#-#--#-#--#-#--#-#--#-#--#-#--#-#--#-#--#-#--#-#--#-#--#-#--#-
#----#----#----#----#----#----#----#----#----#----#----#----#----#----#----#----#----#----#----#----
-#----#----#----#----#----#----#----#----#----#----#----#----#----#----#----#----#----#----#----#---
-###--###--###--###--###--###--###--###--###--###--###--###--###--###--###--###--###--###--###--###-
----------------------------------------------------------------------------------------------------
#--#-#--#-#--#-#--#-#--#-#--#-#--#-#--#-#--#-#--#-#--#-#--#-#--#-#--#-#--#-#--#-#--#-#--#-#--#-#--#-
#----#----#----#----#----#----#----#----#----#----#----#----#----#----#----#----#----#----#----#----
-#----#----#----#----#----#----#----#----#----#----#----#----#----#----#----#----#----#----#----#---
-###--###--###--###--###--###--###--###--###--###--###--###--###--###--###--###--###--###--###--###-
----------------------------------------------------------------------------------------------------
#--#-#--#-#--#-#--#-#--#-#--#-#--#-#--#-#--#-#--#-#--#-#--#-#--#-#--#-#--#-#--#-#--#-#--#-#--#-#--#-
#----#----#----#----#----#----#----#----#----#----#----#----#----#----#----#----#----#----#----#----
-#----#----#----#----#----#----#----#----#----#----#----#----#----#----#----#----#----#----#----#---
-###--###--###--###--###--###--###--###--###--###--###--###--###--###--###--###--###--###--###--###-
----------------------------------------------------------------------------------------------------
#--#-#--#-#--#-#--#-#--#-#--#-#--#-#--#-#--#-#--#-#--#-#--#-#--#-#--#-#--#-#--#-#--#-#--#-#--#-#--#-
#----#----#----#----#----#----#----#----#----#----#----#----#----#----#----#----#----#----#----#----
-#----#----#----#----#----#----#----#----#----#----#----#----#----#----#----#----#----#----#----#---
-###--###--###--###--###--###--###--###--###--###--###--###--###--###--###--###--###--###--###--###-
----------------------------------------------------------------------------------------------------
#--#-#--#-#--#-#--#-#--#-#--#-#--#-#--#-#--#-#--#-#--#-#--#-#--#-#--#-#--#-#--#-#--#-#--#-#--#-#--#-
#----#----#----#----#----#----#----#----#----#----#----#----#----#----#----#----#----#----#----#----
-#----#----#----#----#----#----#----#----#----#----#----#----#----#----#----#----#----#----#----#---
-###--###--###--###--###--###--###--###--###--###--###--###--###--###--###--###--###--###--###--###-
----------------------------------------------------------------------------------------------------
#--#-#--#-#--#-#--#-#--#-#--#-#--#-#--#-#--#-#--#-#--#-#--#-#--#-#--#-#--#-#--#-#--#-#--#-#--#-#--#-
#----#----#----#----#----#----#----#----#----#----#----#----#----#----#----#----#----#----#----#----
-#----#----#----#----#----#----#----#----#----#----#----#----#----#----#----#----#----#----#----#---
-###--###--###--###--###--###--###--###--###--###--###--###--###--###--###--###--###--###--###--###-
----------------------------------------------------------------------------------------------------
#--#-#--#-#--#-#--#-#--#-#--#-#--#-#--#-#--#-#--#-#--#-#--#-#--#-#--#-#--#-#--#-#--#-#--#-#--#-#--#-
#----#----#----#----#----#----#----#----#----#----#----#----#----#----#----#----#----#----#----#----
-#----#----#----#----#----#----#----#----#----#----#----#----#----#----#----#----#----#----#----#---
-###--###--###--###--###--###--###--###--###--###--###--###--###--###--###--###--###--###--###--###-
----------------------------------------------------------------------------------------------------
#--#-#--#-#--#-#--#-#--#-#--#-#--#-#--#-#--#-#--#-#--#-#--#-#--#-#--#-#--#-#--#-#--#-#--#-#--#-#--#-
#----#----#----#----#----#----#----#----#----#----#----#----#----#----#----#----#----#----#----#----
-#----#----#----#----#----#----#----#----#----#----#----#----#----#----#----#----#----#----#----#---
-###--###--###--###--###--###--###--###--###--###--###--###--###--###--###--###--###--###--###--###-
----------------------------------------------------------------------------------------------------
#--#-#--#-#--#-#--#-#--#-#--#-#--#-#--#-#--#-#--#-#--#-#--#-#--#-#--#-#--#-#--#-#--#-#--#-#--#-#--#-
#----#----#----#----#----#----#----#----#----#----#----#----#----#----#----#----#----#----#----#----
-#----#----#----#----#----#----#----#----#----#----#----#----#----#----#----#----#----#----#----#---
-###--###--###--###--###--###--###--###--###--###--###--###--###--###--###--###--###--###--###--###-
----------------------------------------------------------------------------------------------------
#--#-#--#-#--#-#--#-#--#-#--#-#--#-#--#-#--#-#--#-#--#-#--#-#--#-#--#-#--#-#--#-#--#-#--#-#--#-#--#-
#----#----#----#----#----#----#----#----#----#----#----#----#----#----#----#----#----#----#----#----
-#----#----#----#----#----#----#----#----#----#----#----#----#----#----#----#----#----#----#----#---
-###--###--###--###--###--###--###--###--###--###--###--###--###--###--###--###--###--###--###--###-
----------------------------------------------------------------------------------------------------
#--#-#--#-#--#-#--#-#--#-#--#-#--#-#--#-#--#-#--#-#--#-#--#-#--#-#--#-#--#-#--#-#--#-#--#-#--#-#--#-
#----#----#----#----#----#----#----#----#----#----#----#----#----#----#----#----#----#----#----#----
-#----#---E#----#----#----#----#----#----#---S#----#----#----#----#----#----#----#----#----#----#---
-###--###--###--###--###--###--###--###--###--###--###--###--###--###--###--###--###--###--###--###-
----------------------------------------------------------------------------------------------------
#--#-#--#-#--#-#--#-#--#-#--#-#--#-#--#-#--#-#--#-#--#-#--#-#--#-#--#-#--#-#--#-#--#-#--#-#--#-#--#-
#----#----#----#----#----#----#----#----#----#----#----#----#----#----#----#----#----#----#----#----
-#----#----#----#----#----#----#----#----#----#----#----#----#----#----#----#----#----#----#----#---
-###--###--###--###--###--###--###--###--###--###--###--###--###--###--###--###--###--###--###--###-
----------------------------------------------------------------------------------------------------
#--#-#--#-#--#-#--#-#--#-#--#-#--#-#--#-#--#-#--#-#--#-#--#-#--#-#--#-#--#-#--#-#--#-#--#-#--#-#--#-
#----#----#----#----#----#----#----#----#----#----#----#----#----#----#----#----#----#----#----#----
-#----#----#----#----#----#----#----#----#----#----#----#----#----#----#----#----#----#----#----#---
-###--###--###--###--###--###--###--###--###--###--###--###--###--###--###--###--###--###--###--###-
----------------------------------------------------------------------------------------------------
#--#-#--#-#--#-#--#-#--#-#--#-#--#-#--#-#--#-#--#-#--#-#--#-#--#-#--#-#--#-#--#-#--#-#--#-#--#-#--#-
#----#----#----#----#----#----#----#----#----#----#----#----#----#----#----#----#----#----#----#----
-#----#----#----#----#----#----#----#----#----#----#----#----#----#----#----#----#----#----#----#---
-###--###--###--###--###--###--###--###--###--###--###--###--###--###--###--###--###--###--###--###-
----------------------------------------------------------------------------------------------------
#--#-#--#-#--#-#--#-#--#-#--#-#--#-#--#-#--#-#--#-#--#-#--#-#--#-#--#-#--#-#--#-#--#-#--#-#--#-#--#-
#----#----#----#----#----#----#----#----#----#----#----#----#----#----#----#----#----#----#----#----
-#----#----#----#----#----#----#----#----#----#----#----#----#----#----#----#----#----#----#----#---
-###--###--###--###--###--###--###--###--###--###--###--###--###--###--###--###--###--###--###--###-
----------------------------------------------------------------------------------------------------
#--#-#--#-#--#-#--#-#--#-#--#-#--#-#--#-#--#-#--#-#--#-#--#-#--#-#--#-#--#-#--#-#--#-#--#-#--#-#--#-
#----#----#----#----#----#----#----#----#----#----#----#----#----#----#----#----#----#----#----#----
-#----#----#----#----#----#----#----#----#----#----#----#----#----#----#----#----#----#----#----#---
-###--###--###--###--###--###--###--###--###--###--###--###--###--###--###--###--###--###--###--###-
----------------------------------------------------------------------------------------------------
#--#-#--#-#--#-#--#-#--#-#--#-#--#-#--#-#--#-#--#-#--#-#--#-#--#-#--#-#--#-#--#-#--#-#--#-#--#-#--#-
#----#----#----#----#----#----#----#----#----#----#----#----#----#----#----#----#----#----#----#----
-#----#----#----#----#----#----#----#----#----#----#----#----#----#----#----#----#----#----#----#---
-###--###--###--###--###--###--###--###--###--###--###--###--###--###--###--###--###--###--###--###-
----------------------------------------------------------------------------------------------------
#--#-#--#-#--#-#--#-#--#-#--#-#--#-#--#-#--#-#--#-#--#-#--#-#--#-#--#-#--#-#--#-#--#-#--#-#--#-#--#-
#----#----#----#----#----#----#----#----#----#----#----#----#----#----#----#----#----#----#----#----
-#----#----#----#----#----#----#----#----#----#----#----#----#----#----#----#----#----#----#----#---
-###--###--###--###--###--###--###--###--###--###--###--###--###--###--###--###--###--###--###--###-
----------------------------------------------------------------------------------------------------
#--#-#--#-#--#-#--#-#--#-#--#-#--#-#--#-#--#-#--#-#--#-#--#-#--#-#--#-#--#-#--#-#--#-#--#-#--#-#--#-