-#----#----#S---#----#----#----#----#----#----#----#----#----#----#----#----#----#----#----#----#---
#----#----#----#----#----#----#----#----#----#----#----#----#----#----#----#----#----#----#----#----
--##---##---##---##---##---##---##---##---##---##---##---##---##---##---##---##---##---##---##---##-
--#----#----#----#----#----#----#----#----#----#----#----#----#----#----#----#----#----#----#----#--
----#----#----#----#----#----#----#----#----#----#----#----#----#----#----#----#----#----#----#----#
-#----#----#----#----#----#----#----#----#----#----#----#----#----#----#----#----#----#----#----#---
#----#----#----#----#----#----#----#----#----#----#----#----#----#----#----#----#----#----#----#----
--##---##---##---##---##---##---##---##---##---##---##---##---##---##---##---##---##---##---##---##-
--#----#----#----#----#----#----#----#----#----#----#----#----#----#----#----#----#----#----#----#--
----#----#----#----#----#----#----#----#----#----#----#----#----#----#----#----#----#----#----#----#
-#----#----#----#----#----#----#----#----#----#----#----#----#----#----#----#----#----#----#----#---
#----#----#----#----#----#----#----#----#----#----#----#----#----#----#----#----#----#----#----#----
--##---##---##---##---##---##---##---##---##---##---##---##---##---##---##---##---##---##---##---##-
--#----#----#----#----#----#----#----#----#----#----#----#----#----#----#----#----#----#----#----#--
----#----#----#----#----#----#----#----#----#----#----#----#----#----#----#----#----#----#----#----#
-#----#----#----#----#----#----#----#----#----#----#----#----#----#----#----#----#----#----#----#---
#----#----#----#----#----#----#----#----#----#----#----#----#----#----#----#----#----#----#----#----
--##---##---##---##---##---##---##---##---##---##---##---##---##---##---##---##---##---##---##---##-
--#----#----#----#----#----#----#----#----#----#----#----#----#----#----#----#----#----#----#----#--
----#----#----#----#----#----#----#----#----#----#----#----#----#----#----#----#----#----#----#----#
-#----#----#----#----#----#----#----#----#----#----#----#----#----#----#----#----#----#----#----#---
#----#----#----#----#----#----#----#----#----#----#----#----#----#----#----#----#----#----#----#----
--##---##---##---##---##---##---##---##---##---##---##---##---##---##---##---##---##---##---##---##-
--#----#----#----#----#----#----#----#----#----#----#----#----#----#----#----#----#----#----#----#--
----#----#----#----#----#----#----#----#----#----#----#----#----#----#----#----#----#----#----#----#
-#----#----#----#----#----#----#----#----#----#----#----#----#----#----#----#----#----#----#----#---
#----#----#----#----#----#----#----#----#----#----#----#----#----#----#----#----#----#----#----#----
--##---##---##---##---##---##---##---##---##---##---##---##---##---##---##---##---##---##---##---##-
--#----#----#----#----#----#----#----#----#----#----#----#----#----#----#----#----#----#----#----#--
----#----#----#----#----#----#----#----#----#----#----#----#----#----#----#----#----#----#----#----#
-#----#----#----#----#----#----#----#----#----#----#----#----#----#----#----#----#----#----#----#---
#----#----#----#----#----#----#----#----#----#----#----#----#----#----#----#----#----#----#----#----
--##---##---##---##---##---##---##---##---##---##---##---##---##---##---##---##E--##---##---##---##-
--#----#----#----#----#----#----#----#----#----#----#----#----#----#----#----#----#----#----#----#--
----#----#----#----#----#----#----#----#----#----#----#----#----#----#----#----#----#----#----#----#
-#----#----#----#----#----#----#----#----#----#----#----#----#----#----#----#----#----#----#----#---
#----#----#----#----#----#----#----#----#----#----#----#----#----#----#----#----#----#----#----#----
--##---##---##---##---##---##---##---##---##---##---##---##---##---##---##---##---##---##---##---##-
--#----#----#----#----#----#----#----#----#----#----#----#----#----#----#----#----#----#----#----#--
----#----#----#----#----#----#----#----#----#----#----#----#----#----#----#----#----#----#----#----#
-#----#----#----#----#----#----#----#----#----#----#----#----#----#----#----#----#----#----#----#---
#----#----#----#----#----#----#----#----#----#----#----#----#----#----#----#----#----#----#----#----
--##---##---##---##---##---##---##---##---##---##---##---##---##---##---##---##---##---##---##---##-
--#----#----#----#----#----#----#----#----#----#----#----#----#----#----#----#----#----#----#----#--
----#----#----#----#----#----#----#----#----#----#----#----#----#----#----#----#----#----#----#----#
-#----#----#----#----#----#----#----#----#----#----#----#----#----#----#----#----#----#----#----#---
#----#----#----#----#----#----#----#----#----#----#----#----#----#----#----#----#----#----#----#----
--##---##---##---##---##---##---##---##---##---##---##---##---##---##---##---##---##---##---##---##-
--#----#----#----#----#----#----#----#----#----#----#----#----#----#----#----#----#----#----#----#--
----#----#----#----#----#----#----#----#----#----#----#----#----#----#----#----#----#----#----#----#
-#----#----#----#----#----#----#----#----#----#----#----#----#----#----#----#----#----#----#----#---
#----#----#----#----#----#----#----#----#----#----#----#----#----#----#----#----#----#----#----#----
--##---##---##---##---##---##---##---##---##---##---##---##---##---##---##---##---##---##---##---##-
--#----#----#----#----#----#----#----#----#----#----#----#----#----#----#----#----#----#----#----#--
----#----#----#----#----#----#----#----#----#----#----#----#----#----#----#----#----#----#----#----#
-#----#----#----#----#----#----#----#----#----#----#----#----#----#----#----#----#----#----#----#---
#----#----#----#----#----#----#----#----#----#----#----#----#----#----#----#----#----#----#----#----
--##---##---##---##---##---##---##---##---##---##---##---##---##---##---##---##---##---##---##---##-
--#----#----#----#----#----#----#----#----#----#----#----#----#----#----#----#----#----#----#----#--
----#----#----#----#----#----#----#----#----#----#----#----#----#----#----#----#----#----#----#----#
-#----#----#----#----#----#----#----#----#----#----#----#----#----#----#----#----#----#----#----#---
#----#----#----#----#----#----#----#----#----#----#----#----#----#----#----#----#----#----#----#----
--##---##---##---##---##---##---##---##---##---##---##---##---##---##---##---##---##---##---##---##-
--#----#----#----#----#----#----#----#----#----#----#----#----#----#----#----#----#----#----#----#--
----#----#----#----#----#----#----#----#----#----#----#----#----#----#----#----#----#----#----#----#
-#----#----#----#----#----#----#----#----#----#----#----#----#----#----#----#----#----#----#----#---
#----#----#----#----#----#----#----#----#----#----#----#----#----#----#----#----#----#----#----#----
--##---##---##---##---##---##---##---##---##---##---##---##---##---##---##---##---##---##---##---##-
--#----#----#----#----#----#----#----#----#----#----#----#----#----#----#----#----#----#----#----#--
----#----#----#----#----#----#----#----#----#----#----#----#----#----#----#----#----#----#----#----#
-#----#----#----#----#----#----#----#----#----#----#----#----#----#----#----#----#----#----#----#---
#----#----#----#----#----#----#----#----#----#----#----#----#----#----#----#----#----#----#----#----
--##---##---##---##---##---##---##---##---##---##---##---##---##---##---##---##---##---##---##---##-
--#----#----#----#----#----#----#----#----#----#----#----#----#----#----#----#----#----#----#----#--
----#----#----#----#----#----#----#----#----#----#----#----#----#----#----#----#----#----#----#----#
-#----#----#----#----#----#----#----#----#----#----#----#----#----#----#----#----#----#----#----#---
#----#----#----#----#----#----#----#----#----#----#----#----#----#----#----#----#----#----#----#----
--##---##---##---##---##---##---##---##---##---##---##---##---##---##---##---##---##---##---##---##-
--#----#----#----#----#----#----#----#----#----#----#----#----#----#----#----#----#----#----#----#--
----#----#----#----#----#----#----#----#----#----#----#----#----#----#----#----#----#----#----#----#
-#----#----#----#----#----#----#----#----#----#----#----#----#----#----#----#----#----#----#----#---
#----#----#----#----#----#----#----#----#----#----#----#----#----#----#----#----#----#----#----#----
--##---##---##---##---##---##---##---##---##---##---##---##---##---##---##---##---##---##---##---##-
--#----#----#----#----#----#----#----#----#----#----#----#----#----#----#----#----#----#----#----#--
----#----#----#----#----#----#----#----#----#----#----#----#----#----#----#----#----#----#----#----#
-#----#----#----#----#----#----#----#----#----#----#----#----#----#----#----#----#----#----#----#---
#----#----#----#----#----#----#----#----#----#----#----#----#----#----#----#----#----#----#----#----
--##---##---##---##---##---##---##---##---##---##---##---##---##---##---##---##---##---##---##---##-
--#----#----#----#----#----#----#----#----#----#----#----#----#----#----#----#----#----#----#----#--
----#----#----#----#----#----#----#----#----#----#----#----#----#----#----#----#----#----#----#----#
-#----#----#----#----#----#----#----#----#----#----#----#----#----#----#----#----#----#----#----#---
#----#----#----#----#----#----#----#----#----#----#----#----#----#----#----#----#----#----#----#----
--##---##---##---##---##---##---##---##---##---##---##---##---##---##---##---##---##---##---##---##-
--#----#----#----#----#----#----#----#----#----#----#----#----#----#----#----#----#----#----#----#--
----#----#----#----#----#----#----#----#----#----#----#----#----#----#----#----#----#----#----#----#
-#----#----#----#----#----#----#----#----#----#----#----#----#----#----#----#----#----#----#----#---
#----#----#----#----#----#----#----#----#----#----#----#----#----#----#----#----#----#----#----#----
--##---##---##---##---##---##---##---##---##---##---##---##---##---##---##---##---##---##---##---##-
--#----#----#----#----#----#----#----#----#----#----#----#----#----#----#----#----#----#----#----#--
----#----#----#----#----#----#----#----#----#----#----#----#----#----#----#----#----#----#----#----#