----#------#--##----##--------##-----#-#-#----#-#-----#-##-##-#---##-#--#--#-##-----#----#----------
--#-----#--#---###-#-#--#---#--##--#-#-#-#-##---#---------#-#-#-------#-###-#--##--#-#-#----#--#-#-#
#--##----#---#-----#----------#-#--##------##-##-----###----##-##-----#------#--#-----#---##-#----#-
-----##-----#----#---------#-#--##--------##--#--#-----#-----#-----#-----###---#---------#--##-#-##-
--#----#-------#---#--##-##-#-----------##--#------#--###-#---##---------#------------##------#--##-
--#-#-#----##-##----------####---#--#-------##----#-##-#-------#--#--#-----#---#------###-#-#--#----
-####------####--#---#-------------#--##--###----#--#-------###--#####-#---------#-#------#---------
#--#-##-#-#---#----##------##-----------#---###-###-#----------##--##-#--##--#------------#--##--#--
--#----#-----##-----#----##-#---##-#--#--------#-#----#--#-----#-----#-#------#-#---#-----#----#-##-
#-----##------#-#-----#####---#-##------##-##--#-----#---#-#--#--#-#-#--##-------#-##---####------#-
-#---#--##---#--#-#--#-----#--#--###-#-####----#-------#----###----##--#---##--#------#-------------
-##---#-----------------#----#--##--#-#--#--####---##----#-#-#---#--#------##------##---------#-#---
--#----##--#-----#---#---##-##--#---#---#-#--#----##-#----#-##-######---#-##-#--#-#------------##---
---#-##--#-#--#--------#-##-##-#--#-#-----------####-##--###------#---##-##--------#-#-#--##--#-#--#
#-#----#--------#------#-----#-#--#-##--#---#---##---##-#----#-#---##---#---------#---#-#--#--###---
-----##---------#-----#--##--##----#-----##-------####-#-----##------##---------####----##-----#----
----##----##------#-#--------#----------#-#-#-------##-##---#--#--###-####-##---##---------#-#-#--##
-#--------#--#------#-------##--####-----##-#---#--------#--##--#---###--#-#-#--------#-----#####-#-
#-----##--#-#--##-#---##--##-#---#-#----#---#--#------#---#-----#--#-#--------#--##--#---#--##-#--##
----#-#----#--------#-#-#-#---##-------#-###---#--#-----#-#-#--#-#--#-#---##---###-----#----#------#
#####------##--#-#--------------#----##--#------#---#--#---#--##-#-#-#-#-##--#-----#-#-#--#----#--#-
#--##-----#----#----###-#-----#-##-#---#---#-------#--------##-###-##-----------#-#--------#------##
#-#------###-#----#-------------##---------####-#--#----#--#-##-#-----#-#-#--#-#----##-#----#--#----
--##-----##--##-------#---#---#-#-#---------#-#--#--#-##---#----------#-#----###------###-#-----#---
---#----##-----##------##--#-#--#-------#--------#--#-#----####----------#--##-###--#-#-#--#--###-#-
------#----------#---#--#-#-#-----#-##-----#-#---#--##----##---##-----###------#---#--------####-#--
-#-#-------#-#---##-#-#--##--#-------#----------#---##----#---##----#-##---#--###---#----#-#-#------
###-----#--##-#-#--------#-#----#----#---##-#-#--#----#---#-#---###--#----#---#--#-#----#---#---###-
##--#-##-##-#----#--#-------#--##-#--#-#-------#-------#-#-#--#-#--------###---------#-#-#----------
-#---##---#-----#--------#----#---#----------#----##-#---#-------#-#----###-#-#------#-----#--#--##-
-----##---##-#--#------#-#-----#-#---##-##--#---#------#-#------#####-#-#-##--#----#--#-----#-#--##-
##---#---##--#-#---#--------#----###--#---##------#--#----#---#--###--#-#--#---#--#---##---#--#-----
#---------#---##--#---#--#--#-#---#----###------#-####----#--#---#-----##---#---#----#----##-#-----#
---#-----------#-----#-####---###-#----##-##--------#-----##----#----#----###--#----------#------#--
--##----#--##--#-###--#-##-#----#-#-----#---------#-------##-#####-------#--#----#-----#-#-####-#--#
####-####------#-#--###-------------#--#---##--##-#---###--#-------------#--##---###--#--#-##----#-#
-#------#--------------#-#--#-##-#----##-#----##---#-----##-###---##-#---#----#---#-##-----#--#-#---
--------#-#-##-#----#-####--##---##-----#-##----###-----#------##--##-#---------##-----####-#-#-----
-#----##------#------#--##-----##-----#-----#---#-#--##--#--#-##---#-##--##----#-------------#--#---
-#---------#---##--#-#------##-#------##------#------#-##--#--#------#---##-#-#----------#-----#-#--
-#----#--#--#----#---#-####---#-###--#-#--#####---#------##-----###---#-##-#--------------##-#------
--#---#------#-#-##-----##-#--##----#---#-#---------#-#--#---#-#---##---####--#--#---#---#--###-#---
-#--##------#--------#------#-------#--#---#------#------#-#-#-#---##-#---###---#--##--#--##-#-----#
#-----#####--#-#-#--##-#--##---##-----#---#---#--##--#----#--#--#-------##---##--##-#-------#----#-#
#-#-##---##----#-#---#----#-----##-#-#------#----#--#-#-----#--###-#-##----#-------#----#-#------##-
-----#-##------#--##------#--#-#-##-##----#--##-----##---#--#-#--###---#---#-##-#--#----#---------#-
---#-#-#--#--#-----#-----#----#------------#--#-#-#---#-#------------#-------#-#----#--#-#--#-#--##-
-#-----#-###--#----#--##--#---#-#-#---#--##---##-##----------##-#-#----#-##-#-#-##----#----#-#------
--##----#------#--#--#-#---#----##-##---#---#-----##---#----##-#---##---#--##----#----##---##-##-#--
#--#---###---#---##--#-----#-----#---#---------#--#-#-#---#----#-----#----#----------###---#----#---
----#---#---#---##---------#####--#--#--#---#####------#--#-##----#-####-#--#------#-##-#-#-----#--#
--------#-#---###----###--#---#------#---#-#-#--##----#-#------------#---#-----##--####-##---#-#---#
--#----------#---#----#-------#--###--####----##-##--#--#-----#------#----#---------#------##-------
--##--###-----#----##--#-##----#-----------#-#--#-#------------#--#--------##---#---#----#----------
--###---------#-####---##-##--####------#--#-###-----##-----##-##-#-#----#---###---##-#-#-----##----
---#-------------#-#--##---#---#-------#----###----###--------#-----#------##--#----#-#-#-#----##--#
#---#-#--#----#-#----#---#---------#---#-------##--##--#---#--##--#--#-#---#-#-#-#-#-#---##---#---##
#----####--#-#-#------#---##-#---------#-#---#-----#---###-##------#--------#---#-#-#-##--#--###----
---#--###----#-##----#-----###-#-E-#-##-----#------#-#-#-##-----##-----#---##--------###-#-#-###----
----#---###----#-#-#-##-#------#--###-#-#-----##------#----------#--#----##--#--#-###-#-##-#-#------
-----#------#----##------------#-#---------#-#-#--#--#-------#--####-----#---------###----------#--#
#-#-#---#---##-#-#-----##-----#-#-#--#--#--#----------##--#------#--##--#----###-##------###---#--#-
---###-------#-----#-#-#-------###------###------#--#-------#--#-----#---#--#--#---#---###-#-#------
-#------#--#-----------------#------###-#-##-------##-------#---#---#--#-#--#-##-----------#---##-##
--#----##--##---#---------#-#---------#---#---#-#---#---##---#-----#---#----##-#-#--------#-#----#--
#----#####-----##--##-#--------#-----##--##--#--#---#----#-#-------#---#----##-#-------####-###-###-
----##----#-------#---#-#----#-##----#-----#----#-#--------#--#---#-#------------#---#-#------#-----
#--------#---#-----##--###--##----###--#---##-#-------#-#-##-#---#----#---------#--#-#------###-----
###---##-------##--##-------##------#-----#------#-#-#------#-##-##--#---#---------#------#-##-#---#
--------#----#-#-###-----------#---#---##---##-#-----#-------##-#--#---#---#--####-#--##-#--#----#--
-##-------#--#-#----##-##---###--#-#--##-#------#-#--##---###---#-###------------------##-#-------##
-#-#---#-----#-#----------#------###--#----#----#-#--#----S----#------#----##-#--#-#-#---#---#-----#
##------#---#--##--#-------#------#--------#-##-----------#-----#-##--#--##--##-#----##--###--##-##-
----#-----#-##-###---#-#-##-----#----##-------------#-----##---------#----#-#-----#-----------#--##-
-------#-#-#---#------#--------##--##--#---####----#--------#-#--------------#---#--#--#----#-------
----##--#-##---#-##-------##---##----------#--#---##------##-#---#-#---#--###--#--------------------
##--#---###--##-----#-#-#-#-#-#---#---#-----#---#--##-#-#-----------------#---##-------------#---###
-----###-##-#-------##--#-------#-##---#-----------#-#-#-#--#-----#---###------###--##----###---#-#-
--#-----#---#-#----------#--#---#----------#--#-----#------#-#-----#--###----#----#---#-#-----#-##--
-------##------#-##-#------##---###-#-----#----#-#----#-#-#----#-------####---#-----#--##---#-###--#
---#------#----##-----------#--##--#-##---#---#-----#-----###---------#--------#----#-#--#-#-#------
##----###----##-#--##---#-#----#-##--------###-#-##---#--##-#--#--#-#--#---##--#----#---#-------#--#
---##---#-----#-------#-##---##---##-------#-------#---------#--#----#-#---##------#--#------##-----
---#-###---##-----#--####---#-#---#---#-------#-------###------#----------#-------#---#-----------##
---#---##---##-#----##-##-----##------#-##-#----#--#-----###---#-----------####---###---#--#--------
-#---#--##------#-#--#-#--#----------#--------#--#---------#--#---#---#-###----####-------###-----#-
-#-----##-#-#-----------##--###---##---##-#---###----#--#--#-#------#---##----#-##-#-#-------#--#-#-
--##-----------###--#-#---#-#---#-###-##-#---------###--------#-----##----#-------------#----------#
-####--#---##-#-------#-----#---#--#--##-#-------#----##------##-#-####--#-#--#--#-##----#-#---#--##
-#-#--##--##--------#--##-##--##--##-----####----#--------#-###-##--#---------#---##---##-------#--#
-#--#--##----#---#------#--#----#--#-------#-#-------#----#-#---##-#----#--##-####----#-#-#---#-----
--#---#-----#-#---------###------#------#-------#----------#--------#----#-###-----------#----#--##-
#----------#-#---#---##-##--#---####--##----#---#-#-#--#-#---##--###---#-------------##--#--#----#--
--###-##---#-------#--#-#--------##-#--#----##----#--#----#---#----#--#-#--#---#--#---#---#--#---#-#
-#-#--#--####--------#-#-----##--#-#--#--#-#-##--------#-#-##--####--#-----------#-----#-#----------
-#----##--##-##--###--#-#--#---#---#----#-------#--##--#-#-#-#-##---###---#--#-##--###-#---#-#------
-----#----###---#---##--#--#---##-#######--#-#-#-#--#------#----#-#--####-##---##-#--#-#-##--##--#--
---#-####--##---#-####-#--##---##---##-###-#-#-#----#----#--#---#-####---#--##-----###-#---##-#-----
-#-#-----###---#--#-####---##--#--#-###-#---#----#####-#-----------#----#---#-##-----------#---#---#
---#--#-#--###--#---------#------#------#--#--#-------#-------#-##---#-#----#--##---#---###--###---#