-#-------#####-----###------####--#----###-----#-#------###---#-#--#----#-------#--#---#--#-#-#-##--
##--###-#---#--#--#-#----#----------------#------##--#-##--#---#--#--#---#-#---------###-##---#--#-#
##----#-##-###---##----###-#--#-##----##--------#------#----#--####------#--#---##---------##-#-##-#
--#-E------#------#--#------#------#-#-##-------#--------##-----##-----------##-------#--#####-##---
-----###-#---#------###---#-----##------------#-#-#######---##---#--#--#-----#------##--#####--##-##
-##--#-----#-----#----##-##--#-#-------#-#---#####-#--##-------#--#-###------##----#-#--#-----#-#-#-
-####-#--#-#---###--#-#-##-----#---#--#-#---##---------#-----##---##------#---#-##----#--------#----
---------#-------#--##--#-##-----##-#-#--#-#----##-#---------#-#----#---------#-###--#-#------#-----
-#----#--#--#-##-##--###-##---#-#-#---#-###-##-#---#--###----#------#-#-##-#--#-------#-###---#-----
-----#----#--##-#-----##-------##------#-------#--------#-######-#-#-----#----------#--#---#--------
#-#---------#--##-#-##--#--------##---##-##-##-##-----#---#-----#-####-#-#--------#-#-#------###---#
--------#---#--#---###-#-##--#-#--------##-#------#-#----#---#---#--#--#------#-##----##----#-#-#---
#-#--#-###--##--#--##-#--#---#--##-----#-----#-------------#-------##----###-----##---#---##--##----
-#--#-----------#--#-###----#------------#-#-#-----#-##----##---#-------#------#-------##--##---#-#-
####--#-----#---------##---##--##--#---#------#-#####---###---#----##-#-###----###---###--------##-#
#-#-##------#---#---##--#-#-#--#---##--#---------------##----------###---#----#-#--####--##---------
#---------##--#--#--###--#------#-----#---#-###-----#---#----#-##-##-##-----#-##--#-###---#------##-
--#-#------#---#---#---#---#-#-#-------#-#-###-----###--#----#-#---#-#-#####-#--------#----#-#------
--##-----##-##-----#---##-------------#--###------##----#--####-#-#-#--#-----------###---#---#------
-####-#--#-#-#-#------#-------#--#----------#---------##----#-----#---##----###-------#-----#---#---
---------------##---##-##-#-------#-#-------#---#---#----#---#---#-#---#-------#---###---#--##----#-
-------#------#---#---#----#------####---#--###--#-----#--#-#-----#------#------##------##-----#-##-
-------------------#-#--#--------#-----------#-----#-#-----#-#-###---###----------#----#-#---------#
---------#--#------###-----#-#----##-#--------#--------#--------##-----#--#-----#-#----#-------#---#
----------#----#---##---#-----##-##--#------#----#---#-------#--#-#------#-----###-#-##---------##--
------#----###-------#--#----##--#-----#-#-----#---##---------#---#--#---#-###---##---#--#---------#
-#-#-------#-##-##-#----------------#------##-------###--#---##---#-#-##-###-##-#--------##-#---#---
-##---#-----##---#-----###--##-#-#-------------#-###--##--#--#-#-#----------#---#-#----------#-#---#
-##-#-##---------##--------#--##-#----#---#-----#--#---#-#----#---------##--------#-#--#-----##-###-
#--#######---##-##-#-#-----#-------###-----#-----##--##-----#-##----####-##--#####-####--###----##--
--#--#----###-#-#-----#----#--#------###---#-#---------------##-#-----#-------#-#-#---#-#-----------
#-#---#---#------##-#--------#-##--#---#--#---##--#----------#-#-----#--#---#-#-##-#----##-#---#-#--
----#--#--##---###----##--#-----------#---####----#-##-------#-#---#--##---####----##---#--##--###--
---------#-----#-------#-##-##---#---#-------------##----#---#-----##------#-#---#--#---#--#-##-##--
##-----#-##-#-#-----##--#-------#-----#-#--#-#-------#-----#####-#-#---##-###----#---###-##--#---##-
-#-#---#---#----#------##---------#-#-##--#-##-##-#---#-#--#--#-#--#-#-------##----##-####-----###--
##---#-#---#-#---------#-#--###---##-##---##-#---------------#-#----#------#-#----#-----#--#----#--#
-#--#-------#-#----##---##--##--##--#------#---##------#--#---#----#---#-##---##---#----#-----#--#--
#--#---#--#------#####--------#----##-#------#-#----#----#-#-#----#--#--#-#----#--##-#---#-#--#-#---
--#-#------##-#-##---#-----##-#-#-----#---###--##-#--#-#-#---#----#-----#---#--#-#-#----#----#-#---#
#--#-#-#-------#-#------#---#-##--#------##-------------#-#-#--#---#------##-##--###----------#-----
#--#-----##---#---#-###-------#-#-------#---#----#S---#-##------#--##----####----#--#--#-#----#-----
#----#-#-##--#-#-#--#-#--#---#--#--#-------#---#-#-----###---#---#-#-##-#--#---##----##--###--------
#-#--##------#--#----##-###-----------#----#----#---#--------#-------###-##---#-----#-#--#-##--#-##-
-#-#----------------#---#---#----#-#-------#---#--#---#-#-#--##--#-----#----#-#---#----###--#-----#-
------#---------##-#-------------#-------##-##-#----#---#--#--#--#-----##-###--#--##--#--##---#-----
----#----#----#----#--#---#--#-----#-###---#---#-#------#-##------#--#-#----#--#-#-----#---#-##-----
------#--------#--#-------##-#--#-#-#----------#-#---------##----##---#--##--##---------------#-#-##
#----#-----------------#-#--#-#-#-#--------#-###------##---##-----------###--##---#--#--#--#--------
#---#####---#---#-----------##-#----#---##---#-----#---#----------#----#---#--#---------#-------##-#
-#-----#---##-#--------#--#--------#-#--#-#----###----#-#-##-#-#--#---##-###---#-##-#----#---##----#
##-#-##--#----#-----#---#-----#--#-##--#------------#-##---#---##--#----#---#----#--#-------#-#-----
#-----#-#--------------###-#----#--#-##-#--#-#---------#-------#---####-###--###-#--#------##-#--##-
#-#-#-#-##--##-###----##-#-###----#-#--#--#---##-##-------#-##-----#-#--#-#-##--#---##-----#-##-----
##---#--##-#-###----#----#--#--#------#-#--#-#----#------#--------##---------#--------#--------#--#-
------#-#------#-##-####--##-#---#--------#-#-------#---#--#--##-----###-#-#--#----#----#-----#-#-##
-------###---##---#--##-#------#---#-#--#----#-#-#----------##-#--#-#---#---#----#-###--#--#-#--#-#-
--#-##-#---#--##---#-#-##-#--#--#----##-#--#-#----##--------#--#----##---##-----#----#------------#-
------------#---##-##-#----#----#-#----#-#---#-##----###-#-#####--###--#-###---##--#--####----###-#-
#-##---#--#--#--#---#---------##--#-------------#------###--##--#----#--#-------####-#--------#--##-
-------#--###--#---------##---##---##-#------#----#--#-#---------------#---------##---#-###-------##
###-------#----#------#---#-#---#-#--#-----##-------#---###---#---##--###---#--#-----#-----##--#-#--
----#---#----###----##----#-#-----####-------#--#-------#-##--#-##---##---#-##-#####---#-##----##--#
--#-##--#---##---------#----------##---#---#-#-------#-----#-##---------###----#-----#--###-#-##----
-------#--#---##---##-##-####------#-------#-#----#---------#-#----#----------#------------##-#--#--
###-----##----##--#-#-#----#--#-----#--##--#-#---#-##-----------##-----##--###---#--#------#--#-#---
--#----#----##-#--#-###-####--##-----#-#--#-----#----##--#------##--##----###----##-#------##----#-#
---#--#----#--##-#---------#--##--#--------#-##--#---#--#---##--#-#--#-#-##---#----------#--#----##-
##-#--#--#-#----##------#------###------#-##--##----------#-#----##-#-##------#---##--#--#---#---#--
---#--#--#----#------#-##-----#---##--#---###-#-#---#--#-#--#-#--------#-----##---#-##--#----#-#----
--#--##-###-###-#----#------#---#---------#-##------#------------##-#---#-#----#-----#------###-----
#---------#-##-#-#--#----#-#-#---###---#--#---##---###--#----####-#----#-----------#--#---##--#-#---
-#--##------##-#-##--#-#----#---#--------#---#----#---#--#-#---#---#--#--#-----###----#--#--##----#-
-#--#-#---#-##-------#-#-------#--##-----##-#--#------##---#---#--###---#-#----#--------#####--#-#-#
--#----------------------#----#-#-##---#-----##-#---#-##----#-#---##------------#---#-#-----#-#-----
#-##-###--#-#--#-----#--##--#-#--###-----#-##--------#--#--#-#--#---##-##--#---##---#--#------##-#--
#--#----##------#-#-#-----#--##-----------#--#---###--##--###-#-#--###------#-#-----###-----#---#---
----###---#--#---#-#------#----#----#-##-#--#--#--#-##--#--##-#-#---#---#--#-#-##-#------#-----#----
#----#-------#----------#--##---------#-###------#-----#-#####---------#-#-#------#-###---##--##-#-#
---#--#---#-#---###--------#---#-------##-####--#-#---#---###-----#--#-##-----------------#-#---#-#-
--##--###-#----#-#--####------#-------#--------#--#####----##--#-------#-#-##-----#-----##--##-#-##-
###---#-------#------##---##-#-#-#---#--#------#--#----#------#--#-----####--------#-##---####------
----#----##--###------------#---#-##-------#---##--##-##--#---##-#--#---##-----#-#---##-#--###------
----#--------#------#-----#---#---#--------#-#---#-###------------#---#-#-#---##-----#----#-#-##----
----###--------####-##--#-------#-#---#-#--##------------#-------#---##-------#-#-----------#---#---
#-#--#-------------#---#--#----------#-#---##--#---------------#-#-##-----##-#---#-##---#----#------
----------##-----#---#---#---#---##-----------#-###-#-#--------#-------#-#-#--#---#---#-##------#--#
--#-----#-#-###---###--#-------#-#----#----#-#---###-##--##--------#-#-----##---#--#-------##------#
--#-##---###-#-###---------#--#-#-----------#-------#-#-#--#--#-###-----####-#--#-#--#-#-#-#------#-
----#--#--#-----#-####--#---#-------#-###-----#----------##----#----------#----#--###-#--#-#--#-#---
#----###-##----##--##-----#-----#---#-------##------#-------#--#-----#----#------#--##-#-#-#--###---
##---------#--#-##--##------#---#----#--#-#-----------#----#------------#-#--#--#---#----#-#---###--
-#----#-#-#--#----#-----#-----------#---##--#--#-#-#####--------###-##-##---#------##-------##-#-##-
----#--#--###-#--------------------##----###----#-#---#-#----##--##----#-----#-----#---#----#-#-#-##
---#---#----##-------#-#-##--##---#-#-#--#-#----#-----###---##---#-#----#-------###---##----------##
-------#--#-------#-----###---#---##-###--##-#--#------#-#-##-##-#--------#--#-#---##---###--#-##-#-
#--##----------#--##------##-##----#---#---#-####---####---###----#--#-#----##----#--#--#####--#-##-
-----#--------###--#-#-#---###---#-#------#---#####-#-------#-------##-----##-----------#-##---##-#-
--#---#--#---#-#-#-----#--#----##-##---#-#-##----#-##-#---#-#--##--#-#-#--####--###----------#------
#---#------#------#--##----#--#-------###---#-#-----#-#--#----#-##-#-#-----------#----------#-#-----