------------------------------
------------------------------
-###--###--###--###--###--###-
###--###--###--###--###--###--
-#----#----#----#----#----#---
------------------------------
-------------S----------------
-###--###--###--###--###--###-
###--###--###--###--###--###--
-#----#----#----#----#----#---
------------------------------
------------------------------
-###--###--###--###--###--###-
###--###--###--###--###--###--
-#E---#----#----#----#----#---
------------------------------
------------------------------
-###--###--###--###--###--###-
###--###--###--###--###--###--
-#----#----#----#----#----#---
------------------------------
------------------------------
-###--###--###--###--###--###-
###--###--###--###--###--###--
-#----#----#----#----#----#---
------------------------------
------------------------------
-###--###--###--###--###--###-
###--###--###--###--###--###--
-#----#----#----#----#----#---